"Date","Class","LinesAdded","LinesDeleted","LinesTouched","Index","Sum"
"2017-03-28 22:35","ClientConfiguration.java","167","4419","4586","","9172"
"2017-04-15 13:58","ClientConfiguration.java","547","5899","6446","","12892"
"2017-05-15 19:52","ClientConfiguration.java","2089","10095","12184","","24368"
"2017-06-21 19:58","ClientConfiguration.java","3872","17201","21073","","42146"
"2017-06-05 21:48","ClientConfiguration.java","3540","15481","19021","","38042"
"2017-06-21 19:50","ClientConfiguration.java","3866","17085","20951","","41902"
"2017-08-02 00:49","ClientConfiguration.java","9191","45831","55022","","110044"
"2017-08-01 08:34","ClientConfiguration.java","8424","42479","50903","","101806"
"2017-06-30 00:12","ClientConfiguration.java","4267","20740","25007","","50014"
"2017-07-04 06:27","ClientConfiguration.java","4538","22972","27510","","55020"
"2017-08-02 00:49","BKException.java","3657","17269","20926","","41852"
"2014-06-02 11:54","AuditorLedgerCheckerTest.java","9460","82534","91994","7","183988"
"2014-07-24 01:41","AuditorLedgerCheckerTest.java","9742","83301","93043","","186086"
"2012-12-14 20:26","AuditorLedgerCheckerTest.java","3225","22325","25550","2","51100"
"2012-10-26 16:25","AuditorLedgerCheckerTest.java","1673","8110","9783","2","19566"
"2016-03-08 07:18","AuditorLedgerCheckerTest.java","11008","101099","112107","","224214"
"2012-12-18 12:00","AuditorLedgerCheckerTest.java","3466","23073","26539","2","53078"
"2016-12-17 02:44","AuditorLedgerCheckerTest.java","70312","74767","145079","","290158"
"2017-07-07 05:11","AuditorLedgerCheckerTest.java","71991","103733","175724","","351448"
"2014-02-05 22:43","AuditorLedgerCheckerTest.java","9175","76976","86151","7","172302"
"2013-08-21 13:19","AuditorLedgerCheckerTest.java","7279","68782","76061","5","152122"
"2017-10-17 09:32","AuditorLedgerCheckerTest.java","79209","125488","204697","","409394"
"2017-05-12 15:20","AuditorLedgerCheckerTest.java","70804","89633","160437","","320874"
"2013-06-15 19:05","AuditorLedgerCheckerTest.java","7172","66999","74171","5","148342"
"2013-05-31 12:02","AuditorLedgerCheckerTest.java","7094","62821","69915","5","139830"
"2013-05-31 12:02","LedgerDeleteTest.java","276","705","981","5","1962"
"2014-01-22 14:35","LedgerDeleteTest.java","2909","15278","18187","6","36374"
"2016-03-08 06:49","LedgerDeleteTest.java","6272","40400","46672","","93344"
"2014-07-24 01:41","LedgerDeleteTest.java","4463","22724","27187","","54374"
"2013-10-12 05:42","JournalChannel.java","1476","3849","5325","6","10650"
"2013-07-20 19:59","JournalChannel.java","36","273","309","5","618"
"2014-04-29 22:07","JournalChannel.java","3801","14956","18757","7","37514"
"2014-03-07 13:30","JournalChannel.java","3619","12462","16081","7","32162"
"2017-06-12 17:20","LedgerManagerTestCase.java","113001","82863","195864","","391728"
"2017-05-16 00:31","LedgerManagerTestCase.java","112069","77379","189448","","378896"
"2016-11-18 00:18","LedgerManagerTestCase.java","111057","54502","165559","","331118"
"2017-01-31 04:01","LedgerManagerTestCase.java","111104","67650","178754","","357508"
"2017-03-28 22:37","LedgerManagerTestCase.java","111195","72548","183743","","367486"
"2015-09-15 10:38","LedgerManagerTestCase.java","6053","37440","43493","","86986"
"2016-04-27 09:55","LedgerManagerTestCase.java","109476","44046","153522","","307044"
"2017-07-04 06:27","LedgerManagerTestCase.java","113323","88643","201966","","403932"
"2016-02-09 08:28","BookieShell.java","9055","78493","87548","","175096"
"2016-03-16 05:03","BookieShell.java","78870","45575","124445","","248890"
"2014-12-06 07:47","BookieShell.java","8050","71768","79818","","159636"
"2014-12-06 08:03","BookieShell.java","8056","71978","80034","","160068"
"2014-09-29 16:29","BookieShell.java","8006","71371","79377","","158754"
"2014-06-03 12:35","BookieShell.java","7381","61823","69204","7","138408"
"2014-02-05 22:43","BookieShell.java","6998","55699","62697","7","125394"
"2013-10-02 06:54","BookieShell.java","4896","47513","52409","5","104818"
"2015-01-13 13:06","BookieShell.java","8310","74077","82387","","164774"
"2017-06-01 23:58","BookieShell.java","81969","85696","167665","","335330"
"2017-07-07 05:11","BookieShell.java","82301","94943","177244","","354488"
"2013-02-26 04:12","BookieShell.java","3726","38433","42159","4","84318"
"2017-01-11 07:37","BookieShell.java","80452","66326","146778","","293556"
"2016-12-21 01:42","BookieShell.java","80449","65965","146414","","292828"
"2017-01-11 07:34","BookieShell.java","80452","66202","146654","","293308"
"2016-11-30 00:02","BookieShell.java","80429","60046","140475","","280950"
"2017-01-30 23:25","BookieShell.java","80453","66502","146955","","293910"
"2017-03-28 22:35","BookieShell.java","80536","77316","157852","","315704"
"2017-01-30 21:31","BookieShell.java","80452","66393","146845","","293690"
"2017-03-22 22:54","BookieShell.java","80538","73014","153552","","307104"
"2017-01-31 04:01","Bookie.java","79048","74791","153839","","307678"
"2017-03-28 22:37","Bookie.java","79137","79687","158824","","317648"
"2016-01-26 22:11","Bookie.java","8851","81718","90569","","181138"
"2015-03-18 07:38","Bookie.java","8287","77902","86189","","172378"
"2015-04-21 09:17","Bookie.java","8288","78005","86293","","172586"
"2013-06-21 19:26","Bookie.java","4752","49161","53913","5","107826"
"2014-09-23 17:53","Bookie.java","7960","74518","82478","","164956"
"2017-07-04 06:27","Bookie.java","80820","95337","176157","","352314"
"2017-06-05 22:25","Bookie.java","80598","89329","169927","","339854"
"2014-02-06 09:25","Bookie.java","7031","59295","66326","7","132652"
"2014-04-29 22:07","Bookie.java","7205","62974","70179","7","140358"
"2013-12-06 07:39","Bookie.java","6120","56129","62249","6","124498"
"2014-08-02 20:02","Bookie.java","7827","72293","80120","","160240"
"2013-10-02 07:01","Bookie.java","5025","51279","56304","5","112608"
"2017-06-28 23:24","Bookie.java","80634","91318","171952","","343904"
"2017-07-07 08:19","Bookie.java","80810","97290","178100","","356200"
"2013-09-11 00:34","Bookie.java","4992","51045","56037","5","112074"
"2014-01-21 17:26","Bookie.java","6371","58117","64488","6","128976"
"2013-10-12 05:42","Bookie.java","5881","52868","58749","6","117498"
"2013-10-22 16:21","Bookie.java","6056","53810","59866","6","119732"
"2017-05-16 00:31","Bookie.java","79806","84313","164119","","328238"
"2013-07-24 16:55","Bookie.java","4852","50319","55171","5","110342"
"2014-02-05 22:43","Bookie.java","7029","59285","66314","7","132628"
"2014-08-18 23:03","Bookie.java","7840","73774","81614","","163228"
"2014-05-09 14:04","Bookie.java","7219","63629","70848","7","141696"
"2013-06-15 19:05","Bookie.java","4735","49017","53752","5","107504"
"2017-06-01 23:58","Bookie.java","80523","87805","168328","","336656"
"2017-08-02 00:49","Bookie.java","83817","116540","200357","","400714"
"2013-12-02 18:45","Bookie.java","6106","55963","62069","6","124138"
"2013-05-04 14:22","Bookie.java","4488","44241","48729","5","97458"
"2012-12-18 13:04","Bookie.java","647","4999","5646","2","11292"
"2016-11-18 00:18","Bookie.java","78994","61636","140630","","281260"
"2017-03-28 22:35","Bookie.java","79119","79454","158573","","317146"
"2016-07-14 23:02","Bookie.java","77841","52593","130434","","260868"
"2017-06-05 20:30","Bookie.java","80576","88216","168792","","337584"
"2016-11-30 00:02","Bookie.java","79012","62184","141196","","282392"
"2012-12-24 05:50","Bookie.java","1287","5747","7034","2","14068"
"2017-03-22 22:54","Bookie.java","79121","75152","154273","","308546"
"2012-12-24 06:23","Bookie.java","1361","6043","7404","2","14808"
"2011-11-16 17:05","LedgerRecoveryOp.java","2735","4433","7168","","14336"
"2011-11-17 11:16","LedgerRecoveryOp.java","2969","5310","8279","","16558"
"2012-05-25 17:13","LedgerRecoveryOp.java","12570","35414","47984","1","95968"
"2012-05-10 14:47","LedgerRecoveryOp.java","12253","33843","46096","1","92192"
"2013-10-14 17:38","LedgerRecoveryOp.java","18917","139589","158506","6","317012"
"2017-06-21 19:58","LedgerRecoveryOp.java","40535","123573","164108","","328216"
"2017-06-21 21:00","LedgerRecoveryOp.java","40535","124246","164781","","329562"
"2017-06-21 19:50","LedgerRecoveryOp.java","40534","123462","163996","","327992"
"2012-02-13 15:46","LedgerRecoveryOp.java","4625","16631","21256","1","42512"
"2013-03-25 18:02","LedgerRecoveryOp.java","18737","131393","150130","4","300260"
"2016-04-27 21:11","ZkLedgerUnderreplicationManager.java","78963","48668","127631","","255262"
"2016-07-14 23:02","ZkLedgerUnderreplicationManager.java","79153","49843","128996","","257992"
"2017-07-07 05:11","ZkLedgerUnderreplicationManager.java","82359","94494","176853","","353706"
"2013-08-22 16:40","ZkLedgerUnderreplicationManager.java","4593","46503","51096","5","102192"
"2017-06-28 23:28","ZkLedgerUnderreplicationManager.java","82164","89278","171442","","342884"
"2013-06-15 19:05","ZkLedgerUnderreplicationManager.java","4352","44572","48924","5","97848"
"2017-06-01 23:58","ZkLedgerUnderreplicationManager.java","82008","85228","167236","","334472"
"2014-08-18 23:03","ZkLedgerUnderreplicationManager.java","7743","69615","77358","","154716"
"2013-01-04 11:32","ZkLedgerUnderreplicationManager.java","1657","3668","5325","2","10650"
"2014-06-03 12:35","ZkLedgerUnderreplicationManager.java","7239","61174","68413","7","136826"
"2014-06-02 11:54","ZkLedgerUnderreplicationManager.java","7219","60686","67905","7","135810"
"2017-03-28 22:40","ZkLedgerUnderreplicationManager.java","80657","77373","158030","","316060"
"2016-04-27 09:55","ZkLedgerUnderreplicationManager.java","78963","48668","127631","","255262"
"2017-10-17 09:32","BookKeeperAdmin.java","125918","110694","236612","","473224"
"2017-06-01 23:58","BookKeeperAdmin.java","114501","75825","190326","","380652"
"2017-04-11 20:19","BookKeeperAdmin.java","112881","67720","180601","","361202"
"2014-02-21 19:01","BookKeeperAdmin.java","3360","10821","14181","7","28362"
"2014-02-05 22:43","BookKeeperAdmin.java","3185","9483","12668","7","25336"
"2017-07-07 05:11","BookKeeperAdmin.java","114996","85235","200231","","400462"
"2016-11-09 03:05","BookKeeperAdmin.java","112623","49172","161795","","323590"
"2016-11-30 00:07","BookKeeperAdmin.java","112649","49862","162511","","325022"
"2016-09-10 21:01","BookKeeperAdmin.java","111170","44034","155204","","310408"
"2016-07-14 23:02","BookKeeperAdmin.java","109954","38748","148702","","297404"
"2016-10-13 09:27","BookKeeperAdmin.java","112620","48835","161455","","322910"
"2016-03-16 05:03","BookKeeperAdmin.java","109617","33919","143536","","287072"
"2016-03-08 07:18","BookKeeperAdmin.java","6344","34932","41276","","82552"
"2014-12-06 08:03","BookKeeperAdmin.java","5030","26549","31579","","63158"
"2014-04-24 10:43","BookKeeperAdmin.java","3560","12993","16553","7","33106"
"2014-09-06 07:51","BookKeeperAdmin.java","4838","25220","30058","","60116"
"2017-11-08 12:27","EntryLogger.java","35771","69243","105014","","210028"
"2015-10-06 10:05","ReadEntryProcessor.java","2272","8714","10986","","21972"
"2017-05-15 19:52","ReadEntryProcessor.java","114187","53810","167997","","335994"
"2017-06-01 23:58","ReadEntryProcessor.java","115213","58029","173242","","346484"
"2017-05-16 00:31","ReadEntryProcessor.java","114344","54385","168729","","337458"
"2017-06-30 00:12","PerChannelBookieClient.java","114143","75246","189389","","378778"
"2014-05-27 13:56","PerChannelBookieClient.java","1865","7383","9248","7","18496"
"2017-07-04 06:27","PerChannelBookieClient.java","114273","77337","191610","","383220"
"2017-01-31 04:01","PerChannelBookieClient.java","111696","55986","167682","","335364"
"2015-10-06 10:05","PerChannelBookieClient.java","4836","24291","29127","","58254"
"2016-04-05 18:47","PerChannelBookieClient.java","108544","30296","138840","","277680"
"2017-04-15 13:58","PerChannelBookieClient.java","111944","61926","173870","","347740"
"2017-05-15 19:52","PerChannelBookieClient.java","112723","65359","178082","","356164"
"2016-04-05 08:45","PerChannelBookieClient.java","108536","30046","138582","","277164"
"2017-07-28 20:12","PerChannelBookieClient.java","115195","82853","198048","","396096"
"2017-01-31 02:14","PerChannelBookieClient.java","111683","50504","162187","","324374"
"2017-03-28 22:35","PerChannelBookieClient.java","111796","60678","172474","","344948"
"2017-03-23 00:48","PerChannelBookieClient.java","111796","56426","168222","","336444"
"2014-07-25 00:34","PerChannelBookieClient.java","2864","15247","18111","","36222"
"2017-08-02 00:49","PerChannelBookieClient.java","117758","99028","216786","","433572"
"2017-06-21 19:58","PerChannelBookieClient.java","113940","71899","185839","","371678"
"2017-06-01 23:58","PerChannelBookieClient.java","113669","69498","183167","","366334"
"2014-02-21 19:01","PerChannelBookieClient.java","1382","3348","4730","7","9460"
"2014-02-05 22:43","PerChannelBookieClient.java","1184","1987","3171","7","6342"
"2017-04-20 19:55","PerChannelBookieClient.java","111948","61951","173899","","347798"
"2015-09-15 10:38","BookKeeper.java","20183","158020","178203","","356406"
"2015-10-22 09:22","BookKeeper.java","20196","159413","179609","","359218"
"2017-01-31 04:01","BookKeeper.java","42173","105169","147342","","294684"
"2012-07-23 23:39","BookKeeper.java","12738","40588","53326","2","106652"
"2012-12-13 13:07","BookKeeper.java","16920","86097","103017","2","206034"
"2015-07-10 22:48","BookKeeper.java","20034","157569","177603","","355206"
"2017-06-30 00:12","BookKeeper.java","42713","122522","165235","","330470"
"2014-02-06 09:21","BookKeeper.java","19520","139033","158553","7","317106"
"2012-06-05 08:00","BookKeeper.java","10339","27225","37564","1","75128"
"2012-06-19 12:39","BookKeeper.java","10996","29863","40859","2","81718"
"2012-09-12 11:59","BookKeeper.java","13619","61435","75054","2","150108"
"2014-01-21 05:19","BookKeeper.java","19229","137935","157164","6","314328"
"2013-10-02 06:40","BookKeeper.java","18997","132398","151395","5","302790"
"2014-02-21 19:01","BookKeeper.java","19558","140230","159788","7","319576"
"2016-10-13 07:50","BookKeeper.java","42060","91500","133560","","267120"
"2017-06-21 21:00","BookKeeper.java","42709","120047","162756","","325512"
"2012-03-01 15:58","BookKeeper.java","1442","7998","9440","1","18880"
"2013-06-12 18:41","BookKeeper.java","18901","130009","148910","5","297820"
"2011-11-29 23:55","BookKeeper.java","438","483","921","","1842"
"2013-05-06 19:32","BookKeeper.java","18714","125820","144534","5","289068"
"2013-01-10 19:13","BookKeeper.java","17594","91742","109336","2","218672"
"2017-03-28 22:35","BookKeeper.java","42175","109763","151938","","303876"
"2016-07-11 23:01","BookKeeper.java","42045","84016","126061","","252122"
"2016-10-13 09:27","BookKeeper.java","42136","91562","133698","","267396"
"2017-07-28 20:12","BookKeeper.java","42974","129338","172312","","344624"
"2017-05-15 19:52","BookKeeper.java","42545","113887","156432","","312864"
"2013-09-10 15:14","BookKeeper.java","18969","132236","151205","5","302410"
"2011-11-16 17:05","PendingAddOp.java","2735","4433","7168","","14336"
"2015-04-21 09:17","PendingAddOp.java","19430","162773","182203","","364406"
"2015-10-06 10:48","PendingAddOp.java","19470","164230","183700","","367400"
"2015-10-22 09:22","PendingAddOp.java","19474","165064","184538","","369076"
"2011-11-17 11:16","PendingAddOp.java","2969","5310","8279","","16558"
"2017-06-30 00:12","PendingAddOp.java","40530","126712","167242","","334484"
"2014-01-21 05:19","PendingAddOp.java","19001","144080","163081","6","326162"
"2012-09-12 11:59","PendingAddOp.java","14547","68736","83283","2","166566"
"2014-02-21 19:01","PendingAddOp.java","19192","146237","165429","7","330858"
"2014-02-05 22:43","PendingAddOp.java","19159","145041","164200","7","328400"
"2013-09-11 00:34","PendingAddOp.java","18868","138547","157415","5","314830"
"2013-10-14 18:32","PendingAddOp.java","18919","139625","158544","6","317088"
"2012-04-02 12:38","PendingAddOp.java","11814","31591","43405","1","86810"
"2013-04-26 18:38","PendingAddOp.java","18736","131755","150491","5","300982"
"2017-08-02 00:49","PendingAddOp.java","41168","147517","188685","","377370"
"2012-12-27 23:16","PendingAddOp.java","17403","95760","113163","2","226326"
"2017-05-15 19:52","PendingAddOp.java","40437","118152","158589","","317178"
"2016-11-30 00:02","CookieTest.java","111328","38090","149418","","298836"
"2014-12-10 19:43","CookieTest.java","2611","13843","16454","","32908"
"2014-09-23 17:53","CookieTest.java","2169","12317","14486","","28972"
"2014-09-18 06:57","CookieTest.java","2151","12243","14394","","28788"
"2016-01-26 22:11","TestZooKeeperClient.java","688","3273","3961","","7922"
"2017-03-23 15:59","TestZooKeeperClient.java","111627","37779","149406","","298812"
"2012-12-08 11:18","Bookie.java","4619","23920","28539","2","57078"
"2012-10-25 15:35","Bookie.java","3681","12925","16606","2","33212"
"2012-10-26 16:25","Bookie.java","3938","14131","18069","2","36138"
"2017-01-31 04:01","Bookie.java","66950","81994","148944","","297888"
"2017-03-28 22:37","Bookie.java","67043","86894","153937","","307874"
"2016-01-26 22:11","Bookie.java","12398","104566","116964","","233928"
"2015-03-18 07:38","Bookie.java","11964","100880","112844","","225688"
"2015-04-21 09:17","Bookie.java","11965","100983","112948","","225896"
"2012-10-18 16:40","Bookie.java","3502","11609","15111","2","30222"
"2012-12-03 17:59","Bookie.java","4449","23705","28154","2","56308"
"2013-06-21 19:26","Bookie.java","8830","72540","81370","5","162740"
"2014-09-23 17:53","Bookie.java","11666","97525","109191","","218382"
"2017-07-04 06:27","Bookie.java","68608","102426","171034","","342068"
"2017-06-05 22:25","Bookie.java","68383","96415","164798","","329596"
"2014-02-06 09:25","Bookie.java","10796","82361","93157","7","186314"
"2014-04-29 22:07","Bookie.java","10959","86029","96988","7","193976"
"2013-12-06 07:39","Bookie.java","10036","79346","89382","6","178764"
"2014-08-02 20:02","Bookie.java","11540","95307","106847","","213694"
"2013-10-02 07:01","Bookie.java","9012","74567","83579","5","167158"
"2017-06-28 23:24","Bookie.java","68426","98411","166837","","333674"
"2017-07-07 08:19","Bookie.java","68599","104380","172979","","345958"
"2013-09-11 00:34","Bookie.java","8983","74337","83320","5","166640"
"2014-01-21 17:26","Bookie.java","10203","81250","91453","6","182906"
"2013-10-12 05:42","Bookie.java","9780","76068","85848","6","171696"
"2013-10-22 16:21","Bookie.java","9986","77041","87027","6","174054"
"2017-05-16 00:31","Bookie.java","67690","91498","159188","","318376"
"2013-07-24 16:55","Bookie.java","8885","73653","82538","5","165076"
"2014-02-05 22:43","Bookie.java","10794","82351","93145","7","186290"
"2014-08-18 23:03","Bookie.java","11548","96783","108331","","216662"
"2014-05-09 14:04","Bookie.java","10973","86684","97657","7","195314"
"2013-06-15 19:05","Bookie.java","8826","72409","81235","5","162470"
"2017-06-01 23:58","Bookie.java","68362","94945","163307","","326614"
"2017-08-02 00:49","Bookie.java","70018","122042","192060","","384120"
"2013-12-02 18:45","Bookie.java","10026","79184","89210","6","178420"
"2013-05-04 14:22","Bookie.java","8610","67664","76274","5","152548"
"2012-12-18 13:04","Bookie.java","5180","28833","34013","2","68026"
"2016-11-18 00:18","Bookie.java","66898","68841","135739","","271478"
"2017-03-28 22:35","Bookie.java","67025","86661","153686","","307372"
"2016-07-14 23:02","Bookie.java","65870","59923","125793","","251586"
"2017-06-05 20:30","Bookie.java","68363","95304","163667","","327334"
"2016-11-30 00:02","Bookie.java","66915","69388","136303","","272606"
"2012-12-24 05:50","Bookie.java","5797","29558","35355","2","70710"
"2017-03-22 22:54","Bookie.java","67023","82355","149378","","298756"
"2012-12-24 06:23","Bookie.java","5861","29844","35705","2","71410"
"2015-10-22 09:22","BookKeeper.java","88","1468","1556","","3112"
"2017-01-31 04:01","BookKeeper.java","111059","36218","147277","","294554"
"2017-06-30 00:12","BookKeeper.java","114357","56329","170686","","341372"
"2016-10-13 07:50","BookKeeper.java","110784","22387","133171","","266342"
"2017-06-21 21:00","BookKeeper.java","114036","53537","167573","","335146"
"2017-03-28 22:35","BookKeeper.java","111258","41009","152267","","304534"
"2016-07-11 23:01","BookKeeper.java","105805","9939","115744","","231488"
"2016-10-13 09:27","BookKeeper.java","110906","22495","133401","","266802"
"2017-07-28 20:12","BookKeeper.java","115748","64275","180023","","360046"
"2017-05-15 19:52","BookKeeper.java","112523","46028","158551","","317102"
"2012-10-04 12:40","AuditorLedgerCheckerTest.java","3481","12694","16175","2","32350"
"2014-06-02 11:54","AuditorLedgerCheckerTest.java","11523","93810","105333","7","210666"
"2014-07-24 01:41","AuditorLedgerCheckerTest.java","11789","94561","106350","","212700"
"2012-12-14 20:26","AuditorLedgerCheckerTest.java","5627","33940","39567","2","79134"
"2012-10-26 16:25","AuditorLedgerCheckerTest.java","4687","20337","25024","2","50048"
"2016-03-08 07:18","AuditorLedgerCheckerTest.java","12908","112212","125120","","250240"
"2012-12-18 12:00","AuditorLedgerCheckerTest.java","5862","34682","40544","2","81088"
"2016-12-17 02:44","AuditorLedgerCheckerTest.java","64043","77711","141754","","283508"
"2017-07-07 05:11","AuditorLedgerCheckerTest.java","65519","106474","171993","","343986"
"2014-02-05 22:43","AuditorLedgerCheckerTest.java","11253","88267","99520","7","199040"
"2013-08-21 13:19","AuditorLedgerCheckerTest.java","9450","80166","89616","5","179232"
"2017-10-17 09:32","AuditorLedgerCheckerTest.java","72072","127564","199636","","399272"
"2017-05-12 15:20","AuditorLedgerCheckerTest.java","64448","92490","156938","","313876"
"2013-06-15 19:05","AuditorLedgerCheckerTest.java","9358","78398","87756","5","175512"
"2013-05-31 12:02","AuditorLedgerCheckerTest.java","9285","74225","83510","5","167020"
"2017-06-01 23:58","ZkLedgerIdGenerator.java","3184","9688","12872","","25744"
"2017-05-02 23:04","ZkLedgerIdGenerator.java","765","2586","3351","","6702"
"2011-11-17 11:16","LedgerRecoveryOp.java","254","897","1151","","2302"
"2012-05-25 17:13","LedgerRecoveryOp.java","10849","31995","42844","1","85688"
"2012-05-10 14:47","LedgerRecoveryOp.java","10538","30430","40968","1","81936"
"2013-10-14 17:38","LedgerRecoveryOp.java","18111","137085","155196","6","310392"
"2017-06-21 19:58","LedgerRecoveryOp.java","40393","121733","162126","","324252"
"2017-06-21 21:00","LedgerRecoveryOp.java","40395","122408","162803","","325606"
"2017-06-21 19:50","LedgerRecoveryOp.java","40392","121622","162014","","324028"
"2012-02-13 15:46","LedgerRecoveryOp.java","2421","12729","15150","1","30300"
"2013-03-25 18:02","LedgerRecoveryOp.java","17800","128758","146558","4","293116"
"2012-12-08 11:18","Bookie.java","1913","11970","13883","2","27766"
"2012-10-26 16:25","Bookie.java","310","1259","1569","2","3138"
"2017-01-31 04:01","Bookie.java","73855","79655","153510","","307020"
"2017-03-28 22:37","Bookie.java","73950","84557","158507","","317014"
"2016-01-26 22:11","Bookie.java","10228","93152","103380","","206760"
"2015-03-18 07:38","Bookie.java","9715","89387","99102","","198204"
"2015-04-21 09:17","Bookie.java","9716","89490","99206","","198412"
"2012-12-03 17:59","Bookie.java","1202","11214","12416","2","24832"
"2013-06-21 19:26","Bookie.java","6368","60834","67202","5","134404"
"2014-09-23 17:53","Bookie.java","9391","86006","95397","","190794"
"2017-07-04 06:27","Bookie.java","75579","100153","175732","","351464"
"2017-06-05 22:25","Bookie.java","75355","94143","169498","","338996"
"2014-02-06 09:25","Bookie.java","8502","70823","79325","7","158650"
"2014-04-29 22:07","Bookie.java","8672","74498","83170","7","166340"
"2013-12-06 07:39","Bookie.java","7655","67721","75376","6","150752"
"2014-08-02 20:02","Bookie.java","9264","83787","93051","","186102"
"2013-10-02 07:01","Bookie.java","6614","62925","69539","5","139078"
"2017-06-28 23:24","Bookie.java","75392","96133","171525","","343050"
"2017-07-07 08:19","Bookie.java","75567","102104","177671","","355342"
"2013-09-11 00:34","Bookie.java","6583","62693","69276","5","138552"
"2014-01-21 17:26","Bookie.java","7897","69700","77597","6","155194"
"2013-10-12 05:42","Bookie.java","7384","64428","71812","6","143624"
"2013-10-22 16:21","Bookie.java","7592","65403","72995","6","145990"
"2017-05-16 00:31","Bookie.java","74600","89164","163764","","327528"
"2013-07-24 16:55","Bookie.java","6444","61968","68412","5","136824"
"2014-02-05 22:43","Bookie.java","8500","70813","79313","7","158626"
"2014-08-18 23:03","Bookie.java","9272","85263","94535","","189070"
"2014-05-09 14:04","Bookie.java","8686","75153","83839","7","167678"
"2013-06-15 19:05","Bookie.java","6351","60690","67041","5","134082"
"2017-06-01 23:58","Bookie.java","75285","92624","167909","","335818"
"2017-08-02 00:49","Bookie.java","77003","119783","196786","","393572"
"2013-12-02 18:45","Bookie.java","7641","67555","75196","6","150392"
"2013-05-04 14:22","Bookie.java","6122","55932","62054","5","124108"
"2012-12-18 13:04","Bookie.java","2521","16930","19451","2","38902"
"2016-11-18 00:18","Bookie.java","73802","66501","140303","","280606"
"2017-03-28 22:35","Bookie.java","73932","84324","158256","","316512"
"2016-07-14 23:02","Bookie.java","72650","57459","130109","","260218"
"2017-06-05 20:30","Bookie.java","75338","93035","168373","","336746"
"2016-11-30 00:02","Bookie.java","73819","67048","140867","","281734"
"2012-12-24 05:50","Bookie.java","3145","17662","20807","2","41614"
"2017-03-22 22:54","Bookie.java","73929","80017","153946","","307892"
"2012-12-24 06:23","Bookie.java","3210","17949","21159","2","42318"
"2012-12-08 11:18","Bookie.java","1632","10740","12372","2","24744"
"2017-01-31 04:01","Bookie.java","74480","79331","153811","","307622"
"2017-03-28 22:37","Bookie.java","74574","84232","158806","","317612"
"2016-01-26 22:11","Bookie.java","10115","92090","102205","","204410"
"2015-03-18 07:38","Bookie.java","9590","88313","97903","","195806"
"2015-04-21 09:17","Bookie.java","9591","88416","98007","","196014"
"2012-12-03 17:59","Bookie.java","921","9984","10905","2","21810"
"2013-06-21 19:26","Bookie.java","6155","59672","65827","5","131654"
"2014-09-23 17:53","Bookie.java","9262","84928","94190","","188380"
"2017-07-04 06:27","Bookie.java","76212","99837","176049","","352098"
"2017-06-05 22:25","Bookie.java","75987","93826","169813","","339626"
"2014-02-06 09:25","Bookie.java","8366","69738","78104","7","156208"
"2014-04-29 22:07","Bookie.java","8536","73413","81949","7","163898"
"2013-12-06 07:39","Bookie.java","7496","66613","74109","6","148218"
"2014-08-02 20:02","Bookie.java","9130","82704","91834","","183668"
"2013-10-02 07:01","Bookie.java","6404","61766","68170","5","136340"
"2017-06-28 23:24","Bookie.java","76024","95816","171840","","343680"
"2017-07-07 08:19","Bookie.java","76201","101789","177990","","355980"
"2013-09-11 00:34","Bookie.java","6373","61534","67907","5","135814"
"2014-01-21 17:26","Bookie.java","7740","68594","76334","6","152668"
"2013-10-12 05:42","Bookie.java","7258","63353","70611","6","141222"
"2013-10-22 16:21","Bookie.java","7432","64294","71726","6","143452"
"2017-05-16 00:31","Bookie.java","75230","88845","164075","","328150"
"2013-07-24 16:55","Bookie.java","6234","60809","67043","5","134086"
"2014-02-05 22:43","Bookie.java","8364","69728","78092","7","156184"
"2014-08-18 23:03","Bookie.java","9142","84184","93326","","186652"
"2014-05-09 14:04","Bookie.java","8550","74068","82618","7","165236"
"2013-06-15 19:05","Bookie.java","6138","59528","65666","5","131332"
"2017-06-01 23:58","Bookie.java","75917","92307","168224","","336448"
"2017-08-02 00:49","Bookie.java","77638","119469","197107","","394214"
"2013-12-02 18:45","Bookie.java","7482","66447","73929","6","147858"
"2013-05-04 14:22","Bookie.java","5906","54767","60673","5","121346"
"2012-12-18 13:04","Bookie.java","2254","15714","17968","2","35936"
"2016-11-18 00:18","Bookie.java","74427","66177","140604","","281208"
"2017-03-28 22:35","Bookie.java","74556","83999","158555","","317110"
"2016-07-14 23:02","Bookie.java","73274","57134","130408","","260816"
"2017-06-05 20:30","Bookie.java","75970","92718","168688","","337376"
"2016-11-30 00:02","Bookie.java","74444","66724","141168","","282336"
"2012-12-24 05:50","Bookie.java","2883","16451","19334","2","38668"
"2017-03-22 22:54","Bookie.java","74553","79692","154245","","308490"
"2012-12-24 06:23","Bookie.java","2948","16738","19686","2","39372"
"2012-12-08 11:18","Bookie.java","14447","93592","108039","2","216078"
"2012-09-14 15:42","Bookie.java","12164","72008","84172","2","168344"
"2012-10-25 15:35","Bookie.java","14270","83358","97628","2","195256"
"2012-10-26 16:25","Bookie.java","14292","84329","98621","2","197242"
"2011-11-28 19:25","Bookie.java","8040","19932","27972","","55944"
"2012-02-01 12:06","Bookie.java","8582","22121","30703","1","61406"
"2011-09-05 19:38","Bookie.java","4889","10408","15297","","30594"
"2011-11-16 17:05","Bookie.java","7051","14268","21319","","42638"
"2011-11-11 11:24","Bookie.java","6609","12821","19430","","38860"
"2017-01-31 04:01","Bookie.java","36122","111010","147132","","294264"
"2017-03-28 22:37","Bookie.java","36108","115803","151911","","303822"
"2016-01-26 22:11","Bookie.java","16594","168606","185200","","370400"
"2015-03-18 07:38","Bookie.java","16568","165328","181896","","363792"
"2015-04-21 09:17","Bookie.java","16568","165430","181998","","363996"
"2012-02-01 12:58","Bookie.java","8582","23909","32491","1","64982"
"2012-10-18 16:40","Bookie.java","14203","82154","96357","2","192714"
"2012-12-03 17:59","Bookie.java","14393","93493","107886","2","215772"
"2012-07-04 16:17","Bookie.java","10465","46811","57276","2","114552"
"2012-07-23 23:39","Bookie.java","11567","51309","62876","2","125752"
"2013-06-21 19:26","Bookie.java","16026","139580","155606","5","311212"
"2012-09-07 07:04","Bookie.java","11963","71146","83109","2","166218"
"2014-09-23 17:53","Bookie.java","16568","162271","178839","","357678"
"2017-07-04 06:27","Bookie.java","36309","129971","166280","","332560"
"2017-06-05 22:25","Bookie.java","36298","124174","160472","","320944"
"2014-02-06 09:25","Bookie.java","16330","147739","164069","7","328138"
"2014-04-29 22:07","Bookie.java","16366","151280","167646","7","335292"
"2013-12-06 07:39","Bookie.java","16163","145317","161480","6","322960"
"2012-07-05 14:45","Bookie.java","10469","47297","57766","2","115532"
"2012-05-10 14:47","Bookie.java","10034","37143","47177","1","94354"
"2014-08-02 20:02","Bookie.java","16563","160174","176737","","353474"
"2012-04-17 13:16","Bookie.java","9826","35708","45534","1","91068"
"2012-04-16 16:11","Bookie.java","9677","35147","44824","1","89648"
"2013-10-02 07:01","Bookie.java","16068","141467","157535","5","315070"
"2012-06-19 12:39","Bookie.java","10423","41182","51605","2","103210"
"2017-06-28 23:24","Bookie.java","36297","126126","162423","","324846"
"2017-07-07 08:19","Bookie.java","36312","131937","168249","","336498"
"2013-09-11 00:34","Bookie.java","16052","141250","157302","5","314604"
"2014-01-21 17:26","Bookie.java","16184","147075","163259","6","326518"
"2013-10-12 05:42","Bookie.java","16090","142222","158312","6","316624"
"2013-10-22 16:21","Bookie.java","16153","143052","159205","6","318410"
"2017-05-16 00:31","Bookie.java","36286","119938","156224","","312448"
"2013-07-24 16:55","Bookie.java","16042","140654","156696","5","313392"
"2014-02-05 22:43","Bookie.java","16331","147732","164063","7","328126"
"2014-08-18 23:03","Bookie.java","16563","161642","178205","","356410"
"2014-05-09 14:04","Bookie.java","16366","151921","168287","7","336574"
"2013-06-15 19:05","Bookie.java","16026","139453","155479","5","310958"
"2017-06-01 23:58","Bookie.java","36292","122719","159011","","318022"
"2012-03-29 15:18","Bookie.java","9702","34022","43724","1","87448"
"2012-04-17 12:18","Bookie.java","9700","35359","45059","1","90118"
"2012-03-08 19:24","Bookie.java","8982","28401","37383","1","74766"
"2012-02-15 16:11","Bookie.java","8734","26271","35005","1","70010"
"2012-02-17 12:50","Bookie.java","8740","26518","35258","1","70516"
"2012-03-20 14:09","Bookie.java","9693","33298","42991","1","85982"
"2012-03-08 12:13","Bookie.java","8949","28324","37273","1","74546"
"2012-03-13 07:31","Bookie.java","9045","30721","39766","1","79532"
"2012-02-09 18:14","Bookie.java","8635","25913","34548","1","69096"
"2012-04-02 12:38","Bookie.java","9677","34973","44650","1","89300"
"2017-08-02 00:49","Bookie.java","36893","148761","185654","","371308"
"2011-11-16 19:01","Bookie.java","7051","14606","21657","","43314"
"2011-11-18 11:18","Bookie.java","7819","16967","24786","","49572"
"2013-12-02 18:45","Bookie.java","16161","145163","161324","6","322648"
"2013-05-04 14:22","Bookie.java","15935","134833","150768","5","301536"
"2012-12-18 13:04","Bookie.java","14603","98100","112703","2","225406"
"2016-11-18 00:18","Bookie.java","36116","97903","134019","","268038"
"2017-03-28 22:35","Bookie.java","36108","115588","151696","","303392"
"2016-07-14 23:02","Bookie.java","36112","90009","126121","","252242"
"2017-06-05 20:30","Bookie.java","36292","123077","159369","","318738"
"2016-11-30 00:02","Bookie.java","36115","98432","134547","","269094"
"2012-12-24 05:50","Bookie.java","14612","98217","112829","2","225658"
"2017-03-22 22:54","Bookie.java","36115","111291","147406","","294812"
"2012-12-24 06:23","Bookie.java","14655","98482","113137","2","226274"
"2012-12-08 11:18","Bookie.java","16734","83987","100721","2","201442"
"2012-09-14 15:42","Bookie.java","13866","61818","75684","2","151368"
"2012-10-25 15:35","Bookie.java","16443","73639","90082","2","180164"
"2012-10-26 16:25","Bookie.java","16478","74623","91101","2","182202"
"2012-02-01 12:06","Bookie.java","830","2477","3307","1","6614"
"2017-01-31 04:01","Bookie.java","42173","105169","147342","","294684"
"2017-03-28 22:37","Bookie.java","42176","109979","152155","","304310"
"2016-01-26 22:11","Bookie.java","20197","160317","180514","","361028"
"2015-03-18 07:38","Bookie.java","20000","156868","176868","","353736"
"2015-04-21 09:17","Bookie.java","19999","156969","176968","","353936"
"2012-02-01 12:58","Bookie.java","833","4268","5101","1","10202"
"2012-10-18 16:40","Bookie.java","16355","72414","88769","2","177538"
"2012-12-03 17:59","Bookie.java","16618","83826","100444","2","200888"
"2012-07-04 16:17","Bookie.java","11197","35651","46848","2","93696"
"2012-07-23 23:39","Bookie.java","12738","40588","53326","2","106652"
"2013-06-21 19:26","Bookie.java","18903","130565","149468","5","298936"
"2012-09-07 07:04","Bookie.java","13543","60834","74377","2","148754"
"2014-09-23 17:53","Bookie.java","19971","153782","173753","","347506"
"2017-07-04 06:27","Bookie.java","42745","124515","167260","","334520"
"2017-06-05 22:25","Bookie.java","42683","118667","161350","","322700"
"2014-02-06 09:25","Bookie.java","19520","139037","158557","7","317114"
"2014-04-29 22:07","Bookie.java","19566","142588","162154","7","324308"
"2013-12-06 07:39","Bookie.java","19151","136413","155564","6","311128"
"2012-07-05 14:45","Bookie.java","11205","36141","47346","2","94692"
"2012-05-10 14:47","Bookie.java","9997","25214","35211","1","70422"
"2014-08-02 20:02","Bookie.java","19960","151679","171639","","343278"
"2012-04-17 13:16","Bookie.java","9692","23682","33374","1","66748"
"2012-04-16 16:11","Bookie.java","9359","22937","32296","1","64592"
"2013-10-02 07:01","Bookie.java","18997","132504","151501","5","303002"
"2012-06-19 12:39","Bookie.java","10996","29863","40859","2","81718"
"2017-06-28 23:24","Bookie.java","42716","120653","163369","","326738"
"2017-07-07 08:19","Bookie.java","42738","126471","169209","","338418"
"2013-09-11 00:34","Bookie.java","18975","132281","151256","5","302512"
"2014-01-21 17:26","Bookie.java","19236","138235","157471","6","314942"
"2013-10-12 05:42","Bookie.java","19036","133276","152312","6","304624"
"2013-10-22 16:21","Bookie.java","19133","134140","153273","6","306546"
"2017-05-16 00:31","Bookie.java","42569","114329","156898","","313796"
"2013-07-24 16:55","Bookie.java","18927","131647","150574","5","301148"
"2014-02-05 22:43","Bookie.java","19520","139029","158549","7","317098"
"2014-08-18 23:03","Bookie.java","19960","153147","173107","","346214"
"2014-05-09 14:04","Bookie.java","19566","143229","162795","7","325590"
"2013-06-15 19:05","Bookie.java","18906","130441","149347","5","298694"
"2017-06-01 23:58","Bookie.java","42667","117202","159869","","319738"
"2012-03-29 15:18","Bookie.java","9230","21658","30888","1","61776"
"2012-04-17 12:18","Bookie.java","9385","23152","32537","1","65074"
"2012-03-08 19:24","Bookie.java","1646","9173","10819","1","21638"
"2012-02-15 16:11","Bookie.java","1228","6873","8101","1","16202"
"2012-02-17 12:50","Bookie.java","1232","7118","8350","1","16700"
"2012-03-20 14:09","Bookie.java","9085","20798","29883","1","59766"
"2012-03-08 12:13","Bookie.java","1580","9063","10643","1","21286"
"2012-03-13 07:31","Bookie.java","2088","11872","13960","1","27920"
"2012-02-09 18:14","Bookie.java","1074","6460","7534","1","15068"
"2012-04-02 12:38","Bookie.java","9356","22760","32116","1","64232"
"2017-08-02 00:49","Bookie.java","43374","143350","186724","","373448"
"2013-12-02 18:45","Bookie.java","19148","136258","155406","6","310812"
"2013-05-04 14:22","Bookie.java","18714","125720","144434","5","288868"
"2012-12-18 13:04","Bookie.java","16955","88560","105515","2","211030"
"2016-11-18 00:18","Bookie.java","42135","92030","134165","","268330"
"2017-03-28 22:35","Bookie.java","42175","109763","151938","","303876"
"2016-07-14 23:02","Bookie.java","42049","84054","126103","","252206"
"2017-06-05 20:30","Bookie.java","42667","117560","160227","","320454"
"2016-11-30 00:02","Bookie.java","42136","92561","134697","","269394"
"2012-12-24 05:50","Bookie.java","17146","88859","106005","2","212010"
"2017-03-22 22:54","Bookie.java","42177","105461","147638","","295276"
"2012-12-24 06:23","Bookie.java","17190","89125","106315","2","212630"
"2015-04-21 09:17","PendingAddOp.java","18923","160568","179491","","358982"
"2015-10-06 10:48","PendingAddOp.java","18964","162026","180990","","361980"
"2015-10-22 09:22","PendingAddOp.java","18973","162865","181838","","363676"
"2011-11-17 11:16","PendingAddOp.java","254","897","1151","","2302"
"2017-06-30 00:12","PendingAddOp.java","40399","124883","165282","","330564"
"2014-01-21 05:19","PendingAddOp.java","18235","141616","159851","6","319702"
"2012-09-12 11:59","PendingAddOp.java","13408","65899","79307","2","158614"
"2014-02-21 19:01","PendingAddOp.java","18534","143881","162415","7","324830"
"2014-02-05 22:43","PendingAddOp.java","18498","142682","161180","7","322360"
"2013-09-11 00:34","PendingAddOp.java","18052","136033","154085","5","308170"
"2013-10-14 18:32","PendingAddOp.java","18113","137121","155234","6","310468"
"2012-04-02 12:38","PendingAddOp.java","9922","28001","37923","1","75846"
"2013-04-26 18:38","PendingAddOp.java","17799","129120","146919","5","293838"
"2017-08-02 00:49","PendingAddOp.java","41066","145717","186783","","373566"
"2012-12-27 23:16","PendingAddOp.java","16347","93006","109353","2","218706"
"2017-05-15 19:52","PendingAddOp.java","40249","116266","156515","","313030"
"2014-01-21 05:19","PerChannelBookieClient.java","1106","5460","6566","6","13132"
"2014-01-09 07:30","PerChannelBookieClient.java","703","3625","4328","6","8656"
"2017-06-30 00:12","PerChannelBookieClient.java","114326","79783","194109","","388218"
"2014-05-27 13:56","PerChannelBookieClient.java","2807","12679","15486","7","30972"
"2017-07-04 06:27","PerChannelBookieClient.java","114442","81860","196302","","392604"
"2017-01-31 04:01","PerChannelBookieClient.java","111994","60638","172632","","345264"
"2015-10-06 10:05","PerChannelBookieClient.java","5274","29083","34357","","68714"
"2016-04-05 18:47","PerChannelBookieClient.java","108918","35024","143942","","287884"
"2017-04-15 13:58","PerChannelBookieClient.java","112207","66543","178750","","357500"
"2017-05-15 19:52","PerChannelBookieClient.java","112965","69955","182920","","365840"
"2016-04-05 08:45","PerChannelBookieClient.java","108910","34774","143684","","287368"
"2017-07-28 20:12","PerChannelBookieClient.java","115181","87193","202374","","404748"
"2017-01-31 02:14","PerChannelBookieClient.java","111985","55160","167145","","334290"
"2017-03-28 22:35","PerChannelBookieClient.java","112081","65317","177398","","354796"
"2017-03-23 00:48","PerChannelBookieClient.java","112085","61069","173154","","346308"
"2014-07-25 00:34","PerChannelBookieClient.java","3570","20307","23877","","47754"
"2017-08-02 00:49","PerChannelBookieClient.java","117701","103325","221026","","442052"
"2017-06-21 19:58","PerChannelBookieClient.java","114128","76441","190569","","381138"
"2017-06-01 23:58","PerChannelBookieClient.java","113869","74052","187921","","375842"
"2013-10-29 05:14","PerChannelBookieClient.java","624","1415","2039","6","4078"
"2014-02-21 19:01","PerChannelBookieClient.java","2435","8755","11190","7","22380"
"2014-02-05 22:43","PerChannelBookieClient.java","2255","7412","9667","7","19334"
"2017-04-20 19:55","PerChannelBookieClient.java","112209","66566","178775","","357550"
"2011-10-27 18:26","BookKeeperTestClient.java","5805","11919","17724","","35448"
"2011-11-18 11:18","BookKeeperTestClient.java","7801","17066","24867","","49734"
"2012-07-05 14:45","BookieJournalTest.java","2461","10926","13387","2","26774"
"2014-04-29 22:07","BookieJournalTest.java","14592","121143","135735","7","271470"
"2014-12-10 19:43","BookieJournalTest.java","15304","133728","149032","","298064"
"2017-05-15 19:52","BookieJournalTest.java","48676","103547","152223","","304446"
"2017-05-16 00:31","BookieJournalTest.java","48744","104033","152777","","305554"
"2013-10-11 08:36","BookieJournalTest.java","13672","110900","124572","6","249144"
"2013-10-12 05:42","BookieJournalTest.java","13776","111545","125321","6","250642"
"2017-01-31 04:01","LedgerDescriptor.java","40097","107768","147865","","295730"
"2017-05-16 00:31","LedgerDescriptor.java","40269","116704","156973","","313946"
"2012-04-17 12:18","LedgerDescriptor.java","9951","28393","38344","1","76688"
"2012-03-20 14:09","LedgerDescriptor.java","9728","26116","35844","1","71688"
"2012-02-09 18:14","LedgerDescriptor.java","2286","12347","14633","1","29266"
"2012-12-18 13:04","LedgerDescriptor.java","16282","92562","108844","2","217688"
"2016-11-18 00:18","LedgerDescriptor.java","40070","94640","134710","","269420"
"2011-11-16 17:05","LedgerMetadataImpl.java","2735","4433","7168","","14336"
"2016-02-23 19:16","LedgerMetadataImpl.java","19474","166267","185741","","371482"
"2012-06-27 15:35","LedgerMetadataImpl.java","12821","43266","56087","2","112174"
"2012-06-19 12:39","LedgerMetadataImpl.java","12679","37919","50598","2","101196"
"2012-09-12 11:59","LedgerMetadataImpl.java","14547","68736","83283","2","166566"
"2013-08-13 14:32","LedgerMetadataImpl.java","18856","138164","157020","5","314040"
"2017-06-01 23:58","LedgerMetadataImpl.java","40516","121424","161940","","323880"
"2012-01-17 16:52","LedgerMetadataImpl.java","4405","12129","16534","1","33068"
"2013-03-25 18:02","LedgerMetadataImpl.java","18737","131393","150130","4","300260"
"2013-04-26 18:38","LedgerMetadataImpl.java","18736","131755","150491","5","300982"
"2017-07-28 20:12","LedgerMetadataImpl.java","40782","133519","174301","","348602"
"2016-07-11 23:01","LedgerMetadataImpl.java","40227","88571","128798","","257596"
"2012-07-18 17:00","LedgerMetadataImpl.java","13966","48121","62087","2","124174"
"2017-06-01 21:20","BookieProtoEncoding.java","885","3205","4090","","8180"
"2017-05-17 08:57","BookieProtoEncoding.java","20","72","92","","184"
"2017-06-05 22:25","BookieProtoEncoding.java","1594","5811","7405","","14810"
"2016-03-16 05:03","BookieShell.java","104966","2233","107199","","214398"
"2017-06-01 23:58","BookieShell.java","113443","47732","161175","","322350"
"2017-07-07 05:11","BookieShell.java","114448","57652","172100","","344200"
"2017-01-11 07:37","BookieShell.java","110831","27267","138098","","276196"
"2016-12-21 01:42","BookieShell.java","110820","26898","137718","","275436"
"2017-01-11 07:34","BookieShell.java","110831","27143","137974","","275948"
"2016-11-30 00:02","BookieShell.java","110786","20965","131751","","263502"
"2017-01-30 23:25","BookieShell.java","110836","27447","138283","","276566"
"2017-03-28 22:35","BookieShell.java","111059","38401","149460","","298920"
"2017-01-30 21:31","BookieShell.java","110833","27336","138169","","276338"
"2017-03-22 22:54","BookieShell.java","110994","34032","145026","","290052"
"2012-11-30 04:54","LedgerFragment.java","2161","15938","18099","2","36198"
"2014-02-05 22:43","LedgerFragment.java","9255","75870","85125","7","170250"
"2013-05-04 14:22","LedgerDeleteTest.java","17936","127686","145622","5","291244"
"2012-03-15 10:37","LedgerDeleteTest.java","8763","22626","31389","1","62778"
"2013-05-31 12:02","LedgerDeleteTest.java","18075","128254","146329","5","292658"
"2014-01-22 14:35","LedgerDeleteTest.java","18490","140609","159099","6","318198"
"2012-11-26 16:42","LedgerDeleteTest.java","16030","83291","99321","2","198642"
"2016-03-08 06:49","LedgerDeleteTest.java","19220","163098","182318","","364636"
"2012-06-19 12:39","LedgerDeleteTest.java","10733","32344","43077","2","86154"
"2014-07-24 01:41","LedgerDeleteTest.java","18947","146958","165905","","331810"
"2012-12-03 17:59","ReadOnlyBookieTest.java","1184","12333","13517","2","27034"
"2014-12-10 19:43","ReadOnlyBookieTest.java","9619","88455","98074","","196148"
"2016-03-08 06:49","ReadOnlyBookieTest.java","10318","95393","105711","","211422"
"2016-04-14 00:51","ReadOnlyBookieTest.java","71321","55770","127091","","254182"
"2014-07-24 01:41","ReadOnlyBookieTest.java","9018","78226","87244","","174488"
"2013-03-25 06:48","ReadOnlyBookieTest.java","5768","55684","61452","4","122904"
"2014-01-22 14:35","ReadOnlyBookieTest.java","7953","71269","79222","6","158444"
"2014-01-21 17:26","ReadOnlyBookieTest.java","7840","70780","78620","6","157240"
"2012-11-27 16:52","ReadOnlyBookieTest.java","1093","11438","12531","2","25062"
"2016-04-07 21:39","ReadOnlyBookieTest.java","71311","55719","127030","","254060"
"2017-07-04 06:27","PendingReadOp.java","754","5859","6613","","13226"
"2014-08-02 20:02","ServerConfiguration.java","6537","64930","71467","","142934"
"2014-05-06 12:30","ServerConfiguration.java","5859","55602","61461","7","122922"
"2014-05-15 00:41","ServerConfiguration.java","5879","56536","62415","7","124830"
"2014-09-18 06:47","ServerConfiguration.java","6608","67010","73618","","147236"
"2017-07-04 06:27","ServerConfiguration.java","82279","90723","173002","","346004"
"2014-03-07 13:14","ServerConfiguration.java","5695","53079","58774","7","117548"
"2014-04-29 22:07","ServerConfiguration.java","5856","55552","61408","7","122816"
"2016-04-14 00:51","ServerConfiguration.java","78655","45837","124492","","248984"
"2015-01-16 15:57","ServerConfiguration.java","6989","70363","77352","","154704"
"2013-02-08 19:08","ServerConfiguration.java","1032","33193","34225","4","68450"
"2016-03-08 06:49","ServerConfiguration.java","7983","75791","83774","","167548"
"2016-01-26 22:11","ServerConfiguration.java","7731","74525","82256","","164512"
"2014-01-21 05:05","ServerConfiguration.java","4621","49655","54276","6","108552"
"2014-03-12 21:26","ServerConfiguration.java","5768","54954","60722","7","121444"
"2016-04-05 18:47","ServerConfiguration.java","78635","45767","124402","","248804"
"2016-04-27 09:55","ServerConfiguration.java","78703","46397","125100","","250200"
"2015-04-21 09:55","ServerConfiguration.java","7042","70857","77899","","155798"
"2015-01-12 15:18","ServerConfiguration.java","6986","69422","76408","","152816"
"2015-04-21 10:02","ServerConfiguration.java","7038","70886","77924","","155848"
"2013-01-14 16:59","ServerConfiguration.java","778","2226","3004","2","6008"
"2017-05-15 19:52","ServerConfiguration.java","81008","79024","160032","","320064"
"2017-03-22 22:54","ServerConfiguration.java","80325","70283","150608","","301216"
"2017-03-23 00:48","ServerConfiguration.java","80329","70339","150668","","301336"
"2017-01-31 02:11","ServerConfiguration.java","80239","63828","144067","","288134"
"2013-02-19 16:19","ServerConfiguration.java","1978","34092","36070","4","72140"
"2013-02-19 16:15","ServerConfiguration.java","1972","34067","36039","4","72078"
"2016-04-05 08:45","ServerConfiguration.java","78633","45523","124156","","248312"
"2016-11-09 03:02","ServerConfiguration.java","80206","56623","136829","","273658"
"2016-11-30 00:02","ServerConfiguration.java","80216","57315","137531","","275062"
"2017-06-05 20:30","ServerConfiguration.java","81885","83452","165337","","330674"
"2016-09-10 20:27","ServerConfiguration.java","80076","52704","132780","","265560"
"2017-08-02 00:49","ServerConfiguration.java","85337","111987","197324","","394648"
"2017-10-03 12:31","ServerConfiguration.java","91906","108713","200619","","401238"
"2017-08-16 03:37","ServerConfiguration.java","86558","119841","206399","","412798"
"2013-07-20 19:59","ServerConfiguration.java","3062","41840","44902","5","89804"
"2013-12-02 18:45","ServerConfiguration.java","4505","48289","52794","6","105588"
"2014-05-09 14:04","ServerConfiguration.java","5874","56211","62085","7","124170"
"2017-05-26 12:38","ServerConfiguration.java","81137","81469","162606","","325212"
"2013-06-15 19:05","ServerConfiguration.java","2979","41188","44167","5","88334"
"2014-01-15 15:58","ServerConfiguration.java","4585","48713","53298","6","106596"
"2013-10-22 07:44","ServerConfiguration.java","4384","45671","50055","6","100110"
"2017-07-07 08:19","ServerConfiguration.java","82268","92675","174943","","349886"
"2017-06-28 23:24","ServerConfiguration.java","82033","86644","168677","","337354"
"2017-11-08 12:27","ServerConfiguration.java","93243","127924","221167","","442334"
"2014-01-22 14:35","ServerConfiguration.java","4906","50955","55861","6","111722"
"2013-10-12 05:42","ServerConfiguration.java","4271","45185","49456","6","98912"
"2014-07-24 01:41","TestMetaStore.java","9721","70671","80392","","160784"
"2012-12-03 15:04","TestMetaStore.java","945","3490","4435","2","8870"
"2012-12-08 11:18","Bookie.java","16285","81891","98176","2","196352"
"2012-09-14 15:42","Bookie.java","13379","59684","73063","2","146126"
"2012-10-25 15:35","Bookie.java","15988","71537","87525","2","175050"
"2012-10-26 16:25","Bookie.java","16021","72519","88540","2","177080"
"2017-01-31 04:01","Bookie.java","42841","104190","147031","","294062"
"2017-03-28 22:37","Bookie.java","42844","109000","151844","","303688"
"2016-01-26 22:11","Bookie.java","19873","158346","178219","","356438"
"2015-03-18 07:38","Bookie.java","19672","154893","174565","","349130"
"2015-04-21 09:17","Bookie.java","19671","154994","174665","","349330"
"2012-10-18 16:40","Bookie.java","15900","70312","86212","2","172424"
"2012-12-03 17:59","Bookie.java","16169","81730","97899","2","195798"
"2012-07-04 16:17","Bookie.java","10659","33466","44125","2","88250"
"2012-07-23 23:39","Bookie.java","12205","38408","50613","2","101226"
"2013-06-21 19:26","Bookie.java","18533","128548","147081","5","294162"
"2012-09-07 07:04","Bookie.java","13035","58679","71714","2","143428"
"2014-09-23 17:53","Bookie.java","19628","151792","171420","","342840"
"2017-07-04 06:27","Bookie.java","43535","123658","167193","","334386"
"2017-06-05 22:25","Bookie.java","43469","117806","161275","","322550"
"2014-02-06 09:25","Bookie.java","19182","137052","156234","7","312468"
"2014-04-29 22:07","Bookie.java","19229","140604","159833","7","319666"
"2013-12-06 07:39","Bookie.java","18804","134419","153223","6","306446"
"2012-07-05 14:45","Bookie.java","10667","33956","44623","2","89246"
"2012-05-10 14:47","Bookie.java","9333","22903","32236","1","64472"
"2014-08-02 20:02","Bookie.java","19617","149689","169306","","338612"
"2012-04-17 13:16","Bookie.java","9004","21347","30351","1","60702"
"2012-04-16 16:11","Bookie.java","8671","20602","29273","1","58546"
"2013-10-02 07:01","Bookie.java","18634","130494","149128","5","298256"
"2012-06-19 12:39","Bookie.java","10456","27676","38132","2","76264"
"2017-06-28 23:24","Bookie.java","43502","119792","163294","","326588"
"2017-07-07 08:19","Bookie.java","43528","125614","169142","","338284"
"2013-09-11 00:34","Bookie.java","18612","130271","148883","5","297766"
"2014-01-21 17:26","Bookie.java","18884","136236","155120","6","310240"
"2013-10-12 05:42","Bookie.java","18680","131273","149953","6","299906"
"2013-10-22 16:21","Bookie.java","18782","132142","150924","6","301848"
"2017-05-16 00:31","Bookie.java","43247","113360","156607","","313214"
"2013-07-24 16:55","Bookie.java","18559","129632","148191","5","296382"
"2014-02-05 22:43","Bookie.java","19182","137044","156226","7","312452"
"2014-08-18 23:03","Bookie.java","19617","151157","170774","","341548"
"2014-05-09 14:04","Bookie.java","19229","141245","160474","7","320948"
"2013-06-15 19:05","Bookie.java","18536","128424","146960","5","293920"
"2017-06-01 23:58","Bookie.java","43453","116341","159794","","319588"
"2012-03-29 15:18","Bookie.java","8539","19320","27859","1","55718"
"2012-04-17 12:18","Bookie.java","8697","20817","29514","1","59028"
"2012-03-08 19:24","Bookie.java","885","6765","7650","1","15300"
"2012-02-15 16:11","Bookie.java","408","4406","4814","1","9628"
"2012-02-17 12:50","Bookie.java","412","4651","5063","1","10126"
"2012-03-20 14:09","Bookie.java","8389","18455","26844","1","53688"
"2012-03-08 12:13","Bookie.java","819","6655","7474","1","14948"
"2012-03-13 07:31","Bookie.java","1332","9469","10801","1","21602"
"2012-02-09 18:14","Bookie.java","251","3990","4241","1","8482"
"2012-04-02 12:38","Bookie.java","8668","20425","29093","1","58186"
"2017-08-02 00:49","Bookie.java","44231","142560","186791","","373582"
"2013-12-02 18:45","Bookie.java","18801","134264","153065","6","306130"
"2013-05-04 14:22","Bookie.java","18344","123703","142047","5","284094"
"2012-12-18 13:04","Bookie.java","16556","86514","103070","2","206140"
"2016-11-18 00:18","Bookie.java","42803","91051","133854","","267708"
"2017-03-28 22:35","Bookie.java","42843","108784","151627","","303254"
"2016-07-14 23:02","Bookie.java","42723","83081","125804","","251608"
"2017-06-05 20:30","Bookie.java","43453","116699","160152","","320304"
"2016-11-30 00:02","Bookie.java","42804","91582","134386","","268772"
"2012-12-24 05:50","Bookie.java","16747","86813","103560","2","207120"
"2017-03-22 22:54","Bookie.java","42845","104482","147327","","294654"
"2012-12-24 06:23","Bookie.java","16795","87083","103878","2","207756"
"2017-06-01 23:58","BookieInfoReader.java","2913","8739","11652","","23304"
"2017-08-01 08:34","BookieInfoReader.java","8256","36938","45194","","90388"
"2017-07-28 20:12","BookieInfoReader.java","5676","23331","29007","","58014"
"2014-12-10 19:43","ReadOnlyBookieTest.java","9483","77170","86653","","173306"
"2016-03-08 06:49","ReadOnlyBookieTest.java","10270","84196","94466","","188932"
"2016-04-14 00:51","ReadOnlyBookieTest.java","77737","51037","128774","","257548"
"2014-07-24 01:41","ReadOnlyBookieTest.java","8857","66916","75773","","151546"
"2013-03-25 06:48","ReadOnlyBookieTest.java","5386","44153","49539","4","99078"
"2014-01-22 14:35","ReadOnlyBookieTest.java","7713","59880","67593","6","135186"
"2014-01-21 17:26","ReadOnlyBookieTest.java","7600","59391","66991","6","133982"
"2016-04-07 21:39","ReadOnlyBookieTest.java","77727","50986","128713","","257426"
"2017-10-17 09:32","BookKeeperAdmin.java","33429","56881","90310","","180620"
"2017-07-07 05:11","BookKeeperAdmin.java","1305","10220","11525","","23050"
"2011-11-28 19:25","BookKeeper.java","1347","6022","7369","","14738"
"2015-09-15 10:38","BookKeeper.java","18960","161472","180432","","360864"
"2015-10-22 09:22","BookKeeper.java","18973","162865","181838","","363676"
"2017-01-31 04:01","BookKeeper.java","40097","107768","147865","","295730"
"2012-07-23 23:39","BookKeeper.java","12612","45137","57749","2","115498"
"2012-12-13 13:07","BookKeeper.java","16249","90101","106350","2","212700"
"2015-07-10 22:48","BookKeeper.java","18943","161153","180096","","360192"
"2017-06-30 00:12","BookKeeper.java","40399","124883","165282","","330564"
"2014-02-06 09:21","BookKeeper.java","18498","142686","161184","7","322368"
"2012-06-05 08:00","BookKeeper.java","10856","32417","43273","1","86546"
"2012-06-19 12:39","BookKeeper.java","11045","34587","45632","2","91264"
"2012-09-12 11:59","BookKeeper.java","13408","65899","79307","2","158614"
"2014-01-21 05:19","BookKeeper.java","18235","141616","159851","6","319702"
"2013-10-02 06:40","BookKeeper.java","18070","136146","154216","5","308432"
"2014-02-21 19:01","BookKeeper.java","18534","143881","162415","7","324830"
"2016-10-13 07:50","BookKeeper.java","39989","94104","134093","","268186"
"2017-06-21 21:00","BookKeeper.java","40395","122408","162803","","325606"
"2012-03-01 15:58","BookKeeper.java","2623","13854","16477","1","32954"
"2013-06-12 18:41","BookKeeper.java","17997","133780","151777","5","303554"
"2011-11-18 11:18","BookKeeper.java","939","2870","3809","","7618"
"2011-11-29 23:55","BookKeeper.java","1725","6445","8170","","16340"
"2013-05-06 19:32","BookKeeper.java","17814","129595","147409","5","294818"
"2013-01-10 19:13","BookKeeper.java","16726","95549","112275","2","224550"
"2017-03-28 22:35","BookKeeper.java","40082","112345","152427","","304854"
"2016-07-11 23:01","BookKeeper.java","39984","86630","126614","","253228"
"2016-10-13 09:27","BookKeeper.java","40071","94172","134243","","268486"
"2017-07-28 20:12","BookKeeper.java","40668","131707","172375","","344750"
"2017-05-15 19:52","BookKeeper.java","40249","116266","156515","","313030"
"2013-09-10 15:14","BookKeeper.java","18047","135989","154036","5","308072"
"2012-12-08 11:18","Bookie.java","17151","90777","107928","2","215856"
"2012-09-14 15:42","Bookie.java","14716","69041","83757","2","167514"
"2012-10-25 15:35","Bookie.java","16940","80509","97449","2","194898"
"2012-10-26 16:25","Bookie.java","16974","81492","98466","2","196932"
"2011-11-28 19:25","Bookie.java","3825","10198","14023","","28046"
"2012-02-01 12:06","Bookie.java","4431","12451","16882","1","33764"
"2011-11-16 17:05","Bookie.java","2735","4433","7168","","14336"
"2011-11-11 11:24","Bookie.java","2245","2938","5183","","10366"
"2017-01-31 04:01","Bookie.java","40292","109661","149953","","299906"
"2017-03-28 22:37","Bookie.java","40277","114453","154730","","309460"
"2016-01-26 22:11","Bookie.java","19475","165968","185443","","370886"
"2015-03-18 07:38","Bookie.java","19430","162671","182101","","364202"
"2015-04-21 09:17","Bookie.java","19430","162773","182203","","364406"
"2012-02-01 12:58","Bookie.java","4431","14239","18670","1","37340"
"2012-10-18 16:40","Bookie.java","16852","79284","96136","2","192272"
"2012-12-03 17:59","Bookie.java","17094","90675","107769","2","215538"
"2012-07-04 16:17","Bookie.java","12827","43654","56481","2","112962"
"2012-07-23 23:39","Bookie.java","13991","48214","62205","2","124410"
"2013-06-21 19:26","Bookie.java","18828","136863","155691","5","311382"
"2012-09-07 07:04","Bookie.java","14480","68144","82624","2","165248"
"2014-09-23 17:53","Bookie.java","19403","159587","178990","","357980"
"2017-07-04 06:27","Bookie.java","40546","128689","169235","","338470"
"2017-06-05 22:25","Bookie.java","40519","122876","163395","","326790"
"2014-02-06 09:25","Bookie.java","19159","145049","164208","7","328416"
"2014-04-29 22:07","Bookie.java","19197","148592","167789","7","335578"
"2013-12-06 07:39","Bookie.java","18984","142619","161603","6","323206"
"2012-07-05 14:45","Bookie.java","12832","44141","56973","2","113946"
"2012-05-10 14:47","Bookie.java","12253","33843","46096","1","92192"
"2014-08-02 20:02","Bookie.java","19397","157489","176886","","353772"
"2012-04-17 13:16","Bookie.java","11975","32338","44313","1","88626"
"2012-04-16 16:11","Bookie.java","11817","31768","43585","1","87170"
"2013-10-02 07:01","Bookie.java","18886","138766","157652","5","315304"
"2012-06-19 12:39","Bookie.java","12679","37919","50598","2","101196"
"2017-06-28 23:24","Bookie.java","40532","124842","165374","","330748"
"2017-07-07 08:19","Bookie.java","40545","130651","171196","","342392"
"2013-09-11 00:34","Bookie.java","18868","138547","157415","5","314830"
"2014-01-21 17:26","Bookie.java","18998","144370","163368","6","326736"
"2013-10-12 05:42","Bookie.java","18908","139521","158429","6","316858"
"2013-10-22 16:21","Bookie.java","18973","140353","159326","6","318652"
"2017-05-16 00:31","Bookie.java","40457","118590","159047","","318094"
"2013-07-24 16:55","Bookie.java","18845","137938","156783","5","313566"
"2014-02-05 22:43","Bookie.java","19159","145041","164200","7","328400"
"2014-08-18 23:03","Bookie.java","19397","158957","178354","","356708"
"2014-05-09 14:04","Bookie.java","19197","149233","168430","7","336860"
"2013-06-15 19:05","Bookie.java","18831","136739","155570","5","311140"
"2017-06-01 23:58","Bookie.java","40516","121424","161940","","323880"
"2012-03-29 15:18","Bookie.java","11830","30631","42461","1","84922"
"2012-04-17 12:18","Bookie.java","11840","31980","43820","1","87640"
"2012-03-08 19:24","Bookie.java","4913","18813","23726","1","47452"
"2012-02-15 16:11","Bookie.java","4626","16644","21270","1","42540"
"2012-02-17 12:50","Bookie.java","4632","16891","21523","1","43046"
"2012-03-20 14:09","Bookie.java","11821","29907","41728","1","83456"
"2012-03-08 12:13","Bookie.java","4874","18730","23604","1","47208"
"2012-03-13 07:31","Bookie.java","4997","21154","26151","1","52302"
"2012-02-09 18:14","Bookie.java","4513","16272","20785","1","41570"
"2012-04-02 12:38","Bookie.java","11814","31591","43405","1","86810"
"2017-08-02 00:49","Bookie.java","41168","147517","188685","","377370"
"2011-11-16 19:01","Bookie.java","2735","4771","7506","","15012"
"2011-11-18 11:18","Bookie.java","3592","7221","10813","","21626"
"2013-12-02 18:45","Bookie.java","18981","142464","161445","6","322890"
"2013-05-04 14:22","Bookie.java","18739","132118","150857","5","301714"
"2012-12-18 13:04","Bookie.java","17339","95317","112656","2","225312"
"2016-11-18 00:18","Bookie.java","40276","96544","136820","","273640"
"2017-03-28 22:35","Bookie.java","40277","114238","154515","","309030"
"2016-07-14 23:02","Bookie.java","40229","88607","128836","","257672"
"2017-06-05 20:30","Bookie.java","40516","121782","162298","","324596"
"2016-11-30 00:02","Bookie.java","40275","97073","137348","","274696"
"2012-12-24 05:50","Bookie.java","17351","95437","112788","2","225576"
"2017-03-22 22:54","Bookie.java","40284","109941","150225","","300450"
"2012-12-24 06:23","Bookie.java","17395","95703","113098","2","226196"
"2017-06-01 23:58","SASLClientAuthProvider.java","1148","2055","3203","","6406"
"2017-07-28 20:12","SASLClientAuthProvider.java","3994","16730","20724","","41448"
"2017-06-01 11:42","LedgerOutputStream.java","40823","119423","160246","","320492"
"2017-05-15 19:52","WriteLacProcessorV3.java","2252","10598","12850","","25700"
"2016-02-23 19:16","LedgerMetadataImpl.java","18973","164068","183041","","366082"
"2012-06-27 15:35","LedgerMetadataImpl.java","11226","39973","51199","2","102398"
"2012-06-19 12:39","LedgerMetadataImpl.java","11045","34587","45632","2","91264"
"2012-09-12 11:59","LedgerMetadataImpl.java","13408","65899","79307","2","158614"
"2013-08-13 14:32","LedgerMetadataImpl.java","18028","135638","153666","5","307332"
"2017-06-01 23:58","LedgerMetadataImpl.java","40364","119574","159938","","319876"
"2012-01-17 16:52","LedgerMetadataImpl.java","2040","8066","10106","1","20212"
"2013-03-25 18:02","LedgerMetadataImpl.java","17800","128758","146558","4","293116"
"2013-04-26 18:38","LedgerMetadataImpl.java","17799","129120","146919","5","293838"
"2017-07-28 20:12","LedgerMetadataImpl.java","40668","131707","172375","","344750"
"2016-07-11 23:01","LedgerMetadataImpl.java","39984","86630","126614","","253228"
"2012-07-18 17:00","LedgerMetadataImpl.java","12586","45043","57629","2","115258"
"2017-03-28 22:35","BookieClient.java","6827","34199","41026","","82052"
"2017-01-31 04:01","BookieClient.java","6632","29412","36044","","72088"
"2011-11-16 17:05","LedgerDescriptor.java","2735","4433","7168","","14336"
"2017-01-31 04:01","LedgerDescriptor.java","40292","109661","149953","","299906"
"2017-05-16 00:31","LedgerDescriptor.java","40457","118590","159047","","318094"
"2012-04-17 12:18","LedgerDescriptor.java","11840","31980","43820","1","87640"
"2012-03-20 14:09","LedgerDescriptor.java","11821","29907","41728","1","83456"
"2012-02-09 18:14","LedgerDescriptor.java","4513","16272","20785","1","41570"
"2012-12-18 13:04","LedgerDescriptor.java","17339","95317","112656","2","225312"
"2016-11-18 00:18","LedgerDescriptor.java","40276","96544","136820","","273640"
"2017-06-21 19:58","PendingReadOp.java","363","1751","2114","","4228"
"2017-07-04 06:27","PendingReadOp.java","1096","7589","8685","","17370"
"2017-06-21 19:58","PendingReadOp.java","361","1336","1697","","3394"
"2017-07-04 06:27","PendingReadOp.java","1094","7174","8268","","16536"
"2012-12-08 11:18","Bookie.java","16068","87996","104064","2","208128"
"2012-09-14 15:42","Bookie.java","13591","66218","79809","2","159618"
"2012-10-25 15:35","Bookie.java","15816","77687","93503","2","187006"
"2012-10-26 16:25","Bookie.java","15850","78670","94520","2","189040"
"2011-11-28 19:25","Bookie.java","1347","6022","7369","","14738"
"2012-02-01 12:06","Bookie.java","2068","8390","10458","1","20916"
"2017-01-31 04:01","Bookie.java","40097","107768","147865","","295730"
"2017-03-28 22:37","Bookie.java","40083","112561","152644","","305288"
"2016-01-26 22:11","Bookie.java","18974","163769","182743","","365486"
"2015-03-18 07:38","Bookie.java","18923","160466","179389","","358778"
"2015-04-21 09:17","Bookie.java","18923","160568","179491","","358982"
"2012-02-01 12:58","Bookie.java","2071","10181","12252","1","24504"
"2012-10-18 16:40","Bookie.java","15728","76462","92190","2","184380"
"2012-12-03 17:59","Bookie.java","15978","87861","103839","2","207678"
"2012-07-04 16:17","Bookie.java","11246","40375","51621","2","103242"
"2012-07-23 23:39","Bookie.java","12612","45137","57749","2","115498"
"2013-06-21 19:26","Bookie.java","17999","134336","152335","5","304670"
"2012-09-07 07:04","Bookie.java","13332","65298","78630","2","157260"
"2014-09-23 17:53","Bookie.java","18896","157382","176278","","352556"
"2017-07-04 06:27","Bookie.java","40429","126874","167303","","334606"
"2017-06-05 22:25","Bookie.java","40372","121031","161403","","322806"
"2014-02-06 09:25","Bookie.java","18498","142690","161188","7","322376"
"2014-04-29 22:07","Bookie.java","18538","146235","164773","7","329546"
"2013-12-06 07:39","Bookie.java","18181","140118","158299","6","316598"
"2012-07-05 14:45","Bookie.java","11251","40862","52113","2","104226"
"2012-05-10 14:47","Bookie.java","10538","30430","40968","1","81936"
"2014-08-02 20:02","Bookie.java","18884","155278","174162","","348324"
"2012-04-17 13:16","Bookie.java","10246","28911","39157","1","78314"
"2012-04-16 16:11","Bookie.java","9925","28178","38103","1","76206"
"2013-10-02 07:01","Bookie.java","18070","136252","154322","5","308644"
"2012-06-19 12:39","Bookie.java","11045","34587","45632","2","91264"
"2017-06-28 23:24","Bookie.java","40402","123014","163416","","326832"
"2017-07-07 08:19","Bookie.java","40432","128840","169272","","338544"
"2013-09-11 00:34","Bookie.java","18052","136033","154085","5","308170"
"2014-01-21 17:26","Bookie.java","18240","141914","160154","6","320308"
"2013-10-12 05:42","Bookie.java","18094","137009","155103","6","310206"
"2013-10-22 16:21","Bookie.java","18169","137851","156020","6","312040"
"2017-05-16 00:31","Bookie.java","40269","116704","156973","","313946"
"2013-07-24 16:55","Bookie.java","18017","135412","153429","5","306858"
"2014-02-05 22:43","Bookie.java","18498","142682","161180","7","322360"
"2014-08-18 23:03","Bookie.java","18884","156746","175630","","351260"
"2014-05-09 14:04","Bookie.java","18538","146876","165414","7","330828"
"2013-06-15 19:05","Bookie.java","18002","134212","152214","5","304428"
"2017-06-01 23:58","Bookie.java","40364","119574","159938","","319876"
"2012-03-29 15:18","Bookie.java","9857","26960","36817","1","73634"
"2012-04-17 12:18","Bookie.java","9951","28393","38344","1","76688"
"2012-03-08 19:24","Bookie.java","2739","14941","17680","1","35360"
"2012-02-15 16:11","Bookie.java","2422","12742","15164","1","30328"
"2012-02-17 12:50","Bookie.java","2426","12987","15413","1","30826"
"2012-03-20 14:09","Bookie.java","9728","26116","35844","1","71688"
"2012-03-08 12:13","Bookie.java","2693","14851","17544","1","35088"
"2012-03-13 07:31","Bookie.java","2832","17291","20123","1","40246"
"2012-02-09 18:14","Bookie.java","2286","12347","14633","1","29266"
"2012-04-02 12:38","Bookie.java","9922","28001","37923","1","75846"
"2017-08-02 00:49","Bookie.java","41066","145717","186783","","373566"
"2011-11-18 11:18","Bookie.java","939","2870","3809","","7618"
"2013-12-02 18:45","Bookie.java","18178","139963","158141","6","316282"
"2013-05-04 14:22","Bookie.java","17814","129495","147309","5","294618"
"2012-12-18 13:04","Bookie.java","16282","92562","108844","2","217688"
"2016-11-18 00:18","Bookie.java","40070","94640","134710","","269420"
"2017-03-28 22:35","Bookie.java","40082","112345","152427","","304854"
"2016-07-14 23:02","Bookie.java","39986","86666","126652","","253304"
"2017-06-05 20:30","Bookie.java","40364","119932","160296","","320592"
"2016-11-30 00:02","Bookie.java","40078","95178","135256","","270512"
"2012-12-24 05:50","Bookie.java","16295","92683","108978","2","217956"
"2017-03-22 22:54","Bookie.java","40087","108046","148133","","296266"
"2012-12-24 06:23","Bookie.java","16339","92949","109288","2","218576"
"2011-11-28 19:25","BookKeeper.java","3825","10198","14023","","28046"
"2015-09-15 10:38","BookKeeper.java","19467","163677","183144","","366288"
"2011-11-16 17:05","BookKeeper.java","2735","4433","7168","","14336"
"2015-10-22 09:22","BookKeeper.java","19474","165064","184538","","369076"
"2011-10-27 18:26","BookKeeper.java","1168","1646","2814","","5628"
"2017-01-31 04:01","BookKeeper.java","40292","109661","149953","","299906"
"2012-07-23 23:39","BookKeeper.java","13991","48214","62205","2","124410"
"2012-12-13 13:07","BookKeeper.java","17306","92856","110162","2","220324"
"2015-07-10 22:48","BookKeeper.java","19450","163358","182808","","365616"
"2017-06-30 00:12","BookKeeper.java","40530","126712","167242","","334484"
"2014-02-06 09:21","BookKeeper.java","19159","145045","164204","7","328408"
"2012-06-05 08:00","BookKeeper.java","12575","35834","48409","1","96818"
"2012-06-19 12:39","BookKeeper.java","12679","37919","50598","2","101196"
"2012-09-12 11:59","BookKeeper.java","14547","68736","83283","2","166566"
"2014-01-21 05:19","BookKeeper.java","19001","144080","163081","6","326162"
"2013-10-02 06:40","BookKeeper.java","18886","138660","157546","5","315092"
"2014-02-21 19:01","BookKeeper.java","19192","146237","165429","7","330858"
"2016-10-13 07:50","BookKeeper.java","40232","96045","136277","","272554"
"2017-06-21 21:00","BookKeeper.java","40535","124246","164781","","329562"
"2012-03-01 15:58","BookKeeper.java","4807","17736","22543","1","45086"
"2013-06-12 18:41","BookKeeper.java","18830","136311","155141","5","310282"
"2011-11-18 11:18","BookKeeper.java","3592","7221","10813","","21626"
"2011-11-29 23:55","BookKeeper.java","4157","10575","14732","","29464"
"2013-05-06 19:32","BookKeeper.java","18733","132212","150945","5","301890"
"2013-01-10 19:13","BookKeeper.java","17744","98265","116009","2","232018"
"2017-03-28 22:35","BookKeeper.java","40277","114238","154515","","309030"
"2016-07-11 23:01","BookKeeper.java","40227","88571","128798","","257596"
"2016-10-13 09:27","BookKeeper.java","40277","96076","136353","","272706"
"2017-07-28 20:12","BookKeeper.java","40782","133519","174301","","348602"
"2017-05-15 19:52","BookKeeper.java","40437","118152","158589","","317178"
"2013-09-10 15:14","BookKeeper.java","18866","138506","157372","5","314744"
"2012-12-12 11:20","BookieRecoveryTest.java","8861","58400","67261","2","134522"
"2012-09-12 11:59","BookieRecoveryTest.java","4963","33912","38875","2","77750"
"2017-06-30 00:12","BookieRecoveryTest.java","49493","110435","159928","","319856"
"2014-07-24 01:41","BookieRecoveryTest.java","14466","120866","135332","","270664"
"2012-12-04 22:15","BookieRecoveryTest.java","8721","57208","65929","2","131858"
"2017-04-11 20:15","BookieRecoveryTest.java","48290","97471","145761","","291522"
"2017-05-15 19:52","BookieRecoveryTest.java","48739","101214","149953","","299906"
"2012-07-18 17:00","BookieRecoveryTest.java","3288","12203","15491","2","30982"
"2012-12-10 16:02","BookieRecoveryTest.java","8827","57316","66143","2","132286"
"2013-08-13 14:32","BookieRecoveryTest.java","12470","106538","119008","5","238016"
"2014-02-05 22:43","BookieRecoveryTest.java","14036","114678","128714","7","257428"
"2017-06-21 19:58","PendingReadOp.java","1496","3593","5089","","10178"
"2017-06-05 21:48","PendingReadOp.java","1140","1849","2989","","5978"
"2017-06-05 22:13","PendingReadOp.java","1149","2271","3420","","6840"
"2017-07-04 06:27","PendingReadOp.java","2227","9429","11656","","23312"
"2017-06-30 00:12","BookieRecoveryTest.java","81159","92562","173721","","347442"
"2014-07-24 01:41","BookieRecoveryTest.java","7769","64630","72399","","144798"
"2017-04-11 20:15","BookieRecoveryTest.java","79655","79297","158952","","317904"
"2017-05-15 19:52","BookieRecoveryTest.java","80153","83089","163242","","326484"
"2013-08-13 14:32","BookieRecoveryTest.java","4929","49458","54387","5","108774"
"2014-02-05 22:43","BookieRecoveryTest.java","7110","58213","65323","7","130646"
"2017-07-28 20:12","AsyncCallback.java","42839","129158","171997","","343994"
"2013-05-06 19:32","AsyncCallback.java","18417","125478","143895","5","287790"
"2017-01-31 04:01","AsyncCallback.java","42030","104981","147011","","294022"
"2012-05-25 17:13","AsyncCallback.java","10001","26427","36428","1","72856"
"2017-07-04 06:27","AsyncCallback.java","42610","124335","166945","","333890"
"2017-06-21 19:58","PendingReadOp.java","758","3273","4031","","8062"
"2017-06-05 21:48","PendingReadOp.java","401","1528","1929","","3858"
"2017-06-05 22:13","PendingReadOp.java","411","1951","2362","","4724"
"2017-07-04 06:27","PendingReadOp.java","1458","9078","10536","","21072"
"2012-12-12 11:20","BookieRecoveryTest.java","5077","25667","30744","2","61488"
"2017-06-30 00:12","BookieRecoveryTest.java","68690","100683","169373","","338746"
"2014-07-24 01:41","BookieRecoveryTest.java","11666","89117","100783","","201566"
"2012-12-04 22:15","BookieRecoveryTest.java","4910","24448","29358","2","58716"
"2017-04-11 20:15","BookieRecoveryTest.java","67362","87594","154956","","309912"
"2017-05-15 19:52","BookieRecoveryTest.java","67845","91371","159216","","318432"
"2012-12-10 16:02","BookieRecoveryTest.java","5042","24582","29624","2","59248"
"2013-08-13 14:32","BookieRecoveryTest.java","9246","74365","83611","5","167222"
"2014-02-05 22:43","BookieRecoveryTest.java","11112","82805","93917","7","187834"
"2017-06-01 23:58","BookieShell.java","8607","45629","54236","","108472"
"2017-07-07 05:11","BookieShell.java","9676","55613","65289","","130578"
"2017-01-11 07:37","BookieShell.java","6043","25212","31255","","62510"
"2016-12-21 01:42","BookieShell.java","6031","24842","30873","","61746"
"2017-01-11 07:34","BookieShell.java","6043","25088","31131","","62262"
"2016-11-30 00:02","BookieShell.java","5997","18909","24906","","49812"
"2017-01-30 23:25","BookieShell.java","6052","25396","31448","","62896"
"2017-03-28 22:35","BookieShell.java","6281","36356","42637","","85274"
"2017-01-30 21:31","BookieShell.java","6049","25285","31334","","62668"
"2017-03-22 22:54","BookieShell.java","6216","31987","38203","","76406"
"2017-06-12 17:20","ZkUtils.java","114625","77712","192337","","384674"
"2017-03-28 22:40","ZkUtils.java","112797","67603","180400","","360800"
"2014-01-21 05:19","PerChannelBookieClient.java","14178","116959","131137","6","262274"
"2013-10-22 07:35","PerChannelBookieClient.java","13939","112366","126305","6","252610"
"2012-05-26 19:16","PerChannelBookieClient.java","263","864","1127","1","2254"
"2014-01-09 07:30","PerChannelBookieClient.java","14082","115431","129513","6","259026"
"2017-06-30 00:12","PerChannelBookieClient.java","49148","113032","162180","","324360"
"2014-05-27 13:56","PerChannelBookieClient.java","14726","123025","137751","7","275502"
"2017-07-04 06:27","PerChannelBookieClient.java","49219","115064","164283","","328566"
"2012-07-23 23:39","PerChannelBookieClient.java","4511","16436","20947","2","41894"
"2012-08-13 11:38","PerChannelBookieClient.java","5021","22841","27862","2","55724"
"2017-01-31 04:01","PerChannelBookieClient.java","47908","94979","142887","","285774"
"2015-10-06 10:05","PerChannelBookieClient.java","15660","137896","153556","","307112"
"2016-04-05 18:47","PerChannelBookieClient.java","47684","72217","119901","","239802"
"2017-04-15 13:58","PerChannelBookieClient.java","48004","100767","148771","","297542"
"2017-05-15 19:52","PerChannelBookieClient.java","48402","103819","152221","","304442"
"2012-12-01 15:04","PerChannelBookieClient.java","9524","60436","69960","2","139920"
"2016-04-05 08:45","PerChannelBookieClient.java","47682","71973","119655","","239310"
"2017-07-28 20:12","PerChannelBookieClient.java","49683","120122","169805","","339610"
"2017-01-31 02:14","PerChannelBookieClient.java","47894","89496","137390","","274780"
"2017-03-28 22:35","PerChannelBookieClient.java","47938","99601","147539","","295078"
"2017-03-23 00:48","PerChannelBookieClient.java","47944","95355","143299","","286598"
"2013-01-10 19:13","PerChannelBookieClient.java","11363","69586","80949","2","161898"
"2014-07-25 00:34","PerChannelBookieClient.java","15116","130280","145396","","290792"
"2017-08-02 00:49","PerChannelBookieClient.java","50122","134173","184295","","368590"
"2017-06-21 19:58","PerChannelBookieClient.java","49136","109876","159012","","318024"
"2017-06-01 23:58","PerChannelBookieClient.java","49088","107698","156786","","313572"
"2013-10-29 05:14","PerChannelBookieClient.java","14072","113290","127362","6","254724"
"2013-06-28 17:27","PerChannelBookieClient.java","13051","108970","122021","5","244042"
"2014-02-21 19:01","PerChannelBookieClient.java","14636","119383","134019","7","268038"
"2014-02-05 22:43","PerChannelBookieClient.java","14569","118153","132722","7","265444"
"2017-04-20 19:55","PerChannelBookieClient.java","48005","100789","148794","","297588"
"2013-09-11 00:34","PerChannelBookieClient.java","13144","110525","123669","5","247338"
"2013-08-20 12:51","PerChannelBookieClient.java","13103","110197","123300","5","246600"
"2016-03-08 06:49","CompactionTest.java","3706","19581","23287","","46574"
"2015-01-16 15:57","CompactionTest.java","2308","13749","16057","","32114"
"2014-12-10 19:43","CompactionTest.java","2293","11929","14222","","28444"
"2015-04-21 09:55","CompactionTest.java","2447","14329","16776","","33552"
"2016-05-04 15:55","CompactionTest.java","108003","23787","131790","","263580"
"2017-03-22 22:54","CompactionTest.java","111297","49322","160619","","321238"
"2017-06-21 21:07","CompactionTest.java","113602","66046","179648","","359296"
"2017-11-08 12:27","CompactionTest.java","127353","110101","237454","","474908"
"2017-05-16 00:31","CompactionTest.java","112469","58970","171439","","342878"
"2017-07-07 08:19","CompactionTest.java","114062","72536","186598","","373196"
"2017-06-01 21:20","BookieProtoEncoding.java","895","3222","4117","","8234"
"2017-05-17 08:57","BookieProtoEncoding.java","30","89","119","","238"
"2017-06-05 22:25","BookieProtoEncoding.java","1604","5828","7432","","14864"
"2017-06-01 23:58","LedgerMetadataImpl.java","113440","47555","160995","","321990"
"2017-07-28 20:12","LedgerMetadataImpl.java","115632","61576","177208","","354416"
"2016-07-11 23:01","LedgerMetadataImpl.java","105533","7084","112617","","225234"
"2017-08-01 08:34","BookieInfoReader.java","5494","28350","33844","","67688"
"2017-07-28 20:12","BookieInfoReader.java","2875","14704","17579","","35158"
"2012-12-08 11:18","Bookie.java","16248","89181","105429","2","210858"
"2012-09-14 15:42","Bookie.java","13808","67440","81248","2","162496"
"2012-10-25 15:35","Bookie.java","16027","78903","94930","2","189860"
"2012-10-26 16:25","Bookie.java","16061","79886","95947","2","191894"
"2011-11-28 19:25","Bookie.java","1918","7598","9516","","19032"
"2012-02-01 12:06","Bookie.java","2606","9933","12539","1","25078"
"2011-11-16 17:05","Bookie.java","606","1611","2217","","4434"
"2017-01-31 04:01","Bookie.java","40083","108759","148842","","297684"
"2017-03-28 22:37","Bookie.java","40065","113548","153613","","307226"
"2016-01-26 22:11","Bookie.java","18962","164762","183724","","367448"
"2015-03-18 07:38","Bookie.java","18921","161469","180390","","360780"
"2015-04-21 09:17","Bookie.java","18921","161571","180492","","360984"
"2012-02-01 12:58","Bookie.java","2609","11724","14333","1","28666"
"2012-10-18 16:40","Bookie.java","15939","77678","93617","2","187234"
"2012-12-03 17:59","Bookie.java","16187","89075","105262","2","210524"
"2012-07-04 16:17","Bookie.java","11551","41685","53236","2","106472"
"2012-07-23 23:39","Bookie.java","12908","46438","59346","2","118692"
"2013-06-21 19:26","Bookie.java","18134","135476","153610","5","307220"
"2012-09-07 07:04","Bookie.java","13557","66528","80085","2","160170"
"2014-09-23 17:53","Bookie.java","18894","158385","177279","","354558"
"2017-07-04 06:27","Bookie.java","40387","127837","168224","","336448"
"2017-06-05 22:25","Bookie.java","40343","122007","162350","","324700"
"2014-02-06 09:25","Bookie.java","18534","143731","162265","7","324530"
"2014-04-29 22:07","Bookie.java","18570","147272","165842","7","331684"
"2013-12-06 07:39","Bookie.java","18305","141247","159552","6","319104"
"2012-07-05 14:45","Bookie.java","11556","42172","53728","2","107456"
"2012-05-10 14:47","Bookie.java","10914","31811","42725","1","85450"
"2014-08-02 20:02","Bookie.java","18882","156281","175163","","350326"
"2012-04-17 13:16","Bookie.java","10626","30296","40922","1","81844"
"2012-04-16 16:11","Bookie.java","10301","29559","39860","1","79720"
"2013-10-02 07:01","Bookie.java","18197","137384","155581","5","311162"
"2012-06-19 12:39","Bookie.java","11362","35909","47271","2","94542"
"2017-06-28 23:24","Bookie.java","40360","123977","164337","","328674"
"2017-07-07 08:19","Bookie.java","40391","129804","170195","","340390"
"2013-09-11 00:34","Bookie.java","18179","137165","155344","5","310688"
"2014-01-21 17:26","Bookie.java","18332","143011","161343","6","322686"
"2013-10-12 05:42","Bookie.java","18222","138142","156364","6","312728"
"2013-10-22 16:21","Bookie.java","18294","138981","157275","6","314550"
"2017-05-16 00:31","Bookie.java","40246","117686","157932","","315864"
"2013-07-24 16:55","Bookie.java","18152","136552","154704","5","309408"
"2014-02-05 22:43","Bookie.java","18534","143723","162257","7","324514"
"2014-08-18 23:03","Bookie.java","18882","157749","176631","","353262"
"2014-05-09 14:04","Bookie.java","18570","147913","166483","7","332966"
"2013-06-15 19:05","Bookie.java","18131","135346","153477","5","306954"
"2017-06-01 23:58","Bookie.java","40340","120555","160895","","321790"
"2012-03-29 15:18","Bookie.java","10307","28415","38722","1","77444"
"2012-04-17 12:18","Bookie.java","10327","29774","40101","1","80202"
"2012-03-08 19:24","Bookie.java","3250","16457","19707","1","39414"
"2012-02-15 16:11","Bookie.java","2940","14265","17205","1","34410"
"2012-02-17 12:50","Bookie.java","2944","14510","17454","1","34908"
"2012-03-20 14:09","Bookie.java","10178","27571","37749","1","75498"
"2012-03-08 12:13","Bookie.java","3204","16367","19571","1","39142"
"2012-03-13 07:31","Bookie.java","3334","18798","22132","1","44264"
"2012-02-09 18:14","Bookie.java","2821","13887","16708","1","33416"
"2012-04-02 12:38","Bookie.java","10298","29382","39680","1","79360"
"2017-08-02 00:49","Bookie.java","41023","146679","187702","","375404"
"2011-11-16 19:01","Bookie.java","606","1949","2555","","5110"
"2011-11-18 11:18","Bookie.java","1533","4469","6002","","12004"
"2013-12-02 18:45","Bookie.java","18302","141092","159394","6","318788"
"2013-05-04 14:22","Bookie.java","17946","130632","148578","5","297156"
"2012-12-18 13:04","Bookie.java","16460","93745","110205","2","220410"
"2016-11-18 00:18","Bookie.java","40058","95633","135691","","271382"
"2017-03-28 22:35","Bookie.java","40065","113333","153398","","306796"
"2016-07-14 23:02","Bookie.java","39975","87660","127635","","255270"
"2017-06-05 20:30","Bookie.java","40340","120913","161253","","322506"
"2016-11-30 00:02","Bookie.java","40066","96171","136237","","272474"
"2012-12-24 05:50","Bookie.java","16472","93865","110337","2","220674"
"2017-03-22 22:54","Bookie.java","40073","109037","149110","","298220"
"2012-12-24 06:23","Bookie.java","16516","94131","110647","2","221294"
"2017-06-01 23:58","EntryLogger.java","113631","69167","182798","","365596"
"2014-01-22 14:35","EntryLogger.java","155","531","686","6","1372"
"2017-11-08 12:27","EntryLogger.java","126955","115963","242918","","485836"
"2017-01-31 02:11","EntryLogger.java","111645","49561","161206","","322412"
"2017-03-23 00:48","EntryLogger.java","111755","56092","167847","","335694"
"2016-07-14 23:02","EntryLogger.java","108887","31893","140780","","281560"
"2016-02-24 00:44","EntryLogger.java","5052","26835","31887","","63774"
"2015-04-21 10:02","EntryLogger.java","4006","22181","26187","","52374"
"2015-04-21 09:44","EntryLogger.java","3983","21974","25957","","51914"
"2017-03-28 22:37","Bookie.java","375","5182","5557","","11114"
"2017-07-04 06:27","Bookie.java","4684","23458","28142","","56284"
"2017-06-05 22:25","Bookie.java","3944","16932","20876","","41752"
"2017-06-28 23:24","Bookie.java","4088","19029","23117","","46234"
"2017-07-07 08:19","Bookie.java","4745","25482","30227","","60454"
"2017-05-16 00:31","Bookie.java","2479","11243","13722","","27444"
"2017-06-01 23:58","Bookie.java","3520","15059","18579","","37158"
"2017-08-02 00:49","Bookie.java","9319","46299","55618","","111236"
"2017-03-28 22:35","Bookie.java","334","4926","5260","","10520"
"2017-06-05 20:30","Bookie.java","3688","15585","19273","","38546"
"2017-03-22 22:54","Bookie.java","164","452","616","","1232"
"2017-01-31 04:01","BookKeeper.java","111033","34812","145845","","291690"
"2017-06-30 00:12","BookKeeper.java","114384","54976","169360","","338720"
"2016-10-13 07:50","BookKeeper.java","110722","20945","131667","","263334"
"2017-06-21 21:00","BookKeeper.java","114056","52177","166233","","332466"
"2017-03-28 22:35","BookKeeper.java","111232","39603","150835","","301670"
"2016-07-11 23:01","BookKeeper.java","105742","8496","114238","","228476"
"2016-10-13 09:27","BookKeeper.java","110867","21076","131943","","263886"
"2017-07-28 20:12","BookKeeper.java","115780","62927","178707","","357414"
"2017-05-15 19:52","BookKeeper.java","112523","44648","157171","","314342"
"2014-09-17 16:32","MultipleThreadReadTest.java","3500","18866","22366","","44732"
"2014-09-11 00:41","MultipleThreadReadTest.java","3464","18854","22318","","44636"
"2013-06-15 19:05","AuditorBookieTest.java","2928","40924","43852","5","87704"
"2014-02-05 22:43","AuditorBookieTest.java","5526","51496","57022","7","114044"
"2014-01-21 05:19","PerChannelBookieClient.java","14107","116287","130394","6","260788"
"2013-10-22 07:35","PerChannelBookieClient.java","13846","111672","125518","6","251036"
"2014-01-09 07:30","PerChannelBookieClient.java","14011","114759","128770","6","257540"
"2017-06-30 00:12","PerChannelBookieClient.java","49457","112740","162197","","324394"
"2014-05-27 13:56","PerChannelBookieClient.java","14675","122373","137048","7","274096"
"2017-07-04 06:27","PerChannelBookieClient.java","49527","114771","164298","","328596"
"2012-07-23 23:39","PerChannelBookieClient.java","4266","15590","19856","2","39712"
"2012-08-13 11:38","PerChannelBookieClient.java","4780","21999","26779","2","53558"
"2017-01-31 04:01","PerChannelBookieClient.java","48211","94681","142892","","285784"
"2015-10-06 10:05","PerChannelBookieClient.java","15620","137255","152875","","305750"
"2016-04-05 18:47","PerChannelBookieClient.java","47984","71916","119900","","239800"
"2017-04-15 13:58","PerChannelBookieClient.java","48307","100469","148776","","297552"
"2017-05-15 19:52","PerChannelBookieClient.java","48707","103523","152230","","304460"
"2012-12-01 15:04","PerChannelBookieClient.java","9415","59726","69141","2","138282"
"2016-04-05 08:45","PerChannelBookieClient.java","47982","71672","119654","","239308"
"2017-07-28 20:12","PerChannelBookieClient.java","49991","119829","169820","","339640"
"2017-01-31 02:14","PerChannelBookieClient.java","48202","89203","137405","","274810"
"2017-03-28 22:35","PerChannelBookieClient.java","48241","99303","147544","","295088"
"2017-03-23 00:48","PerChannelBookieClient.java","48247","95057","143304","","286608"
"2013-01-10 19:13","PerChannelBookieClient.java","11262","68884","80146","2","160292"
"2014-07-25 00:34","PerChannelBookieClient.java","15060","129623","144683","","289366"
"2017-08-02 00:49","PerChannelBookieClient.java","50430","133880","184310","","368620"
"2017-06-21 19:58","PerChannelBookieClient.java","49441","109580","159021","","318042"
"2017-06-01 23:58","PerChannelBookieClient.java","49393","107402","156795","","313590"
"2013-10-29 05:14","PerChannelBookieClient.java","13999","112616","126615","6","253230"
"2013-06-28 17:27","PerChannelBookieClient.java","12959","108277","121236","5","242472"
"2014-02-21 19:01","PerChannelBookieClient.java","14583","118729","133312","7","266624"
"2014-02-05 22:43","PerChannelBookieClient.java","14501","117484","131985","7","263970"
"2017-04-20 19:55","PerChannelBookieClient.java","48308","100491","148799","","297598"
"2013-09-11 00:34","PerChannelBookieClient.java","13052","109832","122884","5","245768"
"2013-08-20 12:51","PerChannelBookieClient.java","13011","109504","122515","5","245030"
"2017-06-21 19:58","PendingReadOp.java","114654","78013","192667","","385334"
"2017-06-05 21:48","PendingReadOp.java","114513","76484","190997","","381994"
"2017-06-05 22:13","PendingReadOp.java","114519","76903","191422","","382844"
"2017-06-01 11:42","PendingReadOp.java","113760","75022","188782","","377564"
"2017-06-01 22:39","PendingReadOp.java","114401","75245","189646","","379292"
"2014-02-05 22:43","PendingReadOp.java","3076","9279","12355","7","24710"
"2017-05-15 19:52","PendingReadOp.java","113551","71587","185138","","370276"
"2015-04-21 09:17","PendingReadOp.java","5265","28929","34194","","68388"
"2016-02-09 08:39","PendingReadOp.java","6110","33113","39223","","78446"
"2016-02-09 08:32","PendingReadOp.java","6111","33057","39168","","78336"
"2017-07-04 06:27","PendingReadOp.java","114955","83419","198374","","396748"
"2014-01-21 05:19","PendingReadOp.java","1962","7362","9324","6","18648"
"2017-06-05 22:25","BookieProtoEncoding.java","735","2632","3367","","6734"
"2017-05-16 00:31","LedgerDescriptor.java","2479","11243","13722","","27444"
"2017-06-01 23:58","LedgerManagerFactory.java","81562","84384","165946","","331892"
"2015-09-15 10:38","LedgerManagerFactory.java","8247","74371","82618","","165236"
"2017-06-01 21:20","BookieProtoEncoding.java","866","3134","4000","","8000"
"2017-06-05 22:25","BookieProtoEncoding.java","1575","5740","7315","","14630"
"2016-04-05 21:52","ZooKeeperUtil.java","105768","8694","114462","","228924"
"2017-10-17 09:32","BookKeeperAdmin.java","35114","65051","100165","","200330"
"2017-06-01 23:58","BookKeeperAdmin.java","3082","9567","12649","","25298"
"2017-07-07 05:11","BookKeeperAdmin.java","4329","19729","24058","","48116"
"2015-10-06 10:48","PendingAddOp.java","1063","2480","3543","","7086"
"2015-10-22 09:22","PendingAddOp.java","1095","3342","4437","","8874"
"2017-06-30 00:12","PendingAddOp.java","115145","57984","173129","","346258"
"2017-08-02 00:49","PendingAddOp.java","119218","82224","201442","","402884"
"2017-05-15 19:52","PendingAddOp.java","113312","47684","160996","","321992"
"2017-06-01 23:58","EntryLogger.java","114449","75667","190116","","380232"
"2014-01-21 17:26","EntryLogger.java","2041","7723","9764","6","19528"
"2014-01-22 14:35","EntryLogger.java","2186","8244","10430","6","20860"
"2017-11-08 12:27","EntryLogger.java","126942","121632","248574","","497148"
"2013-10-22 07:44","EntryLogger.java","1327","2623","3950","6","7900"
"2017-01-31 02:11","EntryLogger.java","112598","56196","168794","","337588"
"2017-03-23 00:48","EntryLogger.java","112693","62712","175405","","350810"
"2016-07-14 23:02","EntryLogger.java","109876","38564","148440","","296880"
"2016-02-24 00:44","EntryLogger.java","6233","33698","39931","","79862"
"2015-04-21 10:02","EntryLogger.java","5294","29151","34445","","68890"
"2015-04-21 09:44","EntryLogger.java","5282","28955","34237","","68474"
"2017-06-01 23:58","EntryLogger.java","113482","68642","182124","","364248"
"2017-11-08 12:27","EntryLogger.java","126878","115510","242388","","484776"
"2017-01-31 02:11","EntryLogger.java","111495","49035","160530","","321060"
"2017-03-23 00:48","EntryLogger.java","111605","55566","167171","","334342"
"2016-07-14 23:02","EntryLogger.java","108736","31366","140102","","280204"
"2016-02-24 00:44","EntryLogger.java","4901","26308","31209","","62418"
"2015-04-21 10:02","EntryLogger.java","3854","21653","25507","","51014"
"2015-04-21 09:44","EntryLogger.java","3829","21444","25273","","50546"
"2016-10-13 07:50","DNS.java","112401","28654","141055","","282110"
"2011-11-28 19:25","BookKeeper.java","2895","8790","11685","","23370"
"2015-09-15 10:38","BookKeeper.java","19259","162991","182250","","364500"
"2011-11-16 17:05","BookKeeper.java","1661","2881","4542","","9084"
"2015-10-22 09:22","BookKeeper.java","19267","164379","183646","","367292"
"2017-01-31 04:01","BookKeeper.java","40119","109010","149129","","298258"
"2012-07-23 23:39","BookKeeper.java","13338","47083","60421","2","120842"
"2012-12-13 13:07","BookKeeper.java","16828","91900","108728","2","217456"
"2015-07-10 22:48","BookKeeper.java","19242","162672","181914","","363828"
"2017-06-30 00:12","BookKeeper.java","40391","126095","166486","","332972"
"2014-02-06 09:21","BookKeeper.java","18838","144246","163084","7","326168"
"2012-06-05 08:00","BookKeeper.java","11821","34602","46423","1","92846"
"2012-06-19 12:39","BookKeeper.java","11948","36710","48658","2","97316"
"2012-09-12 11:59","BookKeeper.java","14056","67767","81823","2","163646"
"2014-01-21 05:19","BookKeeper.java","18635","143236","161871","6","323742"
"2013-10-02 06:40","BookKeeper.java","18506","137802","156308","5","312616"
"2014-02-21 19:01","BookKeeper.java","18870","145437","164307","7","328614"
"2016-10-13 07:50","BookKeeper.java","40023","95358","135381","","270762"
"2017-06-21 21:00","BookKeeper.java","40396","123629","164025","","328050"
"2012-03-01 15:58","BookKeeper.java","3908","16359","20267","1","40534"
"2013-06-12 18:41","BookKeeper.java","18445","135448","153893","5","307786"
"2011-11-18 11:18","BookKeeper.java","2545","5696","8241","","16482"
"2011-11-29 23:55","BookKeeper.java","3227","9167","12394","","24788"
"2013-05-06 19:32","BookKeeper.java","18305","131306","149611","5","299222"
"2013-01-10 19:13","BookKeeper.java","17273","97316","114589","2","229178"
"2017-03-28 22:35","BookKeeper.java","40104","113587","153691","","307382"
"2016-07-11 23:01","BookKeeper.java","40018","87884","127902","","255804"
"2016-10-13 09:27","BookKeeper.java","40104","95425","135529","","271058"
"2017-07-28 20:12","BookKeeper.java","40646","132905","173551","","347102"
"2017-05-15 19:52","BookKeeper.java","40265","117502","157767","","315534"
"2013-09-10 15:14","BookKeeper.java","18484","137646","156130","5","312260"
"2017-06-30 00:12","BookKeeper.java","4415","21228","25643","","51286"
"2017-06-21 21:00","BookKeeper.java","4036","18378","22414","","44828"
"2017-03-28 22:35","BookKeeper.java","334","4926","5260","","10520"
"2017-07-28 20:12","BookKeeper.java","6172","29540","35712","","71424"
"2017-05-15 19:52","BookKeeper.java","2252","10598","12850","","25700"
"2015-07-10 22:48","BookieInitializationTest.java","681","3321","4002","","8004"
"2017-07-07 08:19","BookieInitializationTest.java","115313","64151","179464","","358928"
"2017-06-28 23:24","BookieInitializationTest.java","114801","57843","172644","","345288"
"2017-07-28 06:39","BookieInitializationTest.java","116404","67131","183535","","367070"
"2017-08-02 00:49","BookieInitializationTest.java","119088","84169","203257","","406514"
"2017-06-05 20:30","BookieInitializationTest.java","114457","54455","168912","","337824"
"2017-05-15 19:52","BookieInitializationTest.java","113296","49743","163039","","326078"
"2017-06-01 23:58","ReplicationEnableCb.java","71763","94590","166353","","332706"
"2017-05-12 16:39","HierarchicalLedgerManager.java","60","740","800","","1600"
"2013-05-09 11:41","IndexCorruptionTest.java","2300","35553","37853","5","75706"
"2015-10-06 10:05","ReadOnlyLedgerHandle.java","7657","72280","79937","","159874"
"2017-01-31 04:01","ReadOnlyLedgerHandle.java","80233","69691","149924","","299848"
"2014-01-17 18:13","ReadOnlyLedgerHandle.java","4587","48859","53446","6","106892"
"2017-06-30 00:12","ReadOnlyLedgerHandle.java","82184","88455","170639","","341278"
"2014-02-05 22:43","ReadOnlyLedgerHandle.java","5529","51500","57029","7","114058"
"2017-03-23 15:55","ReadOnlyLedgerHandle.java","80314","70138","150452","","300904"
"2015-04-21 09:17","CodahaleOpStatsLogger.java","4068","24093","28161","","56322"
"2013-02-12 11:16","BookieServer.java","1242","31828","33070","4","66140"
"2013-04-02 17:38","BookieServer.java","1622","33211","34833","5","69666"
"2017-08-16 03:37","BookieServer.java","87208","119043","206251","","412502"
"2017-08-02 00:49","BookieServer.java","85987","111189","197176","","394352"
"2013-07-03 17:39","BookieServer.java","2411","39489","41900","5","83800"
"2013-07-24 16:55","BookieServer.java","2491","40437","42928","5","85856"
"2014-02-05 22:43","BookieServer.java","5084","49819","54903","7","109806"
"2017-06-28 23:24","BookieServer.java","82658","85821","168479","","336958"
"2013-06-15 19:05","BookieServer.java","2361","39122","41483","5","82966"
"2017-06-01 23:58","BookieServer.java","82455","82216","164671","","329342"
"2017-10-17 09:32","BookieServer.java","93097","116310","209407","","418814"
"2014-08-02 20:02","BookieServer.java","6116","63061","69177","","138354"
"2013-12-06 07:39","BookieServer.java","4028","46516","50544","6","101088"
"2014-01-21 05:05","BookieServer.java","4130","47716","51846","6","103692"
"2017-08-16 03:41","DNSToSwitchMapping.java","119164","114889","234053","","468106"
"2017-05-16 00:31","AuditorPeriodicCheckTest.java","113543","48563","162106","","324212"
"2016-09-10 21:01","AuditorPeriodicCheckTest.java","110254","19589","129843","","259686"
"2014-04-29 22:07","JournalChannel.java","2831","11613","14444","7","28888"
"2014-03-07 13:30","JournalChannel.java","2627","9097","11724","7","23448"
"2016-11-18 00:18","IndexPersistenceMgr.java","5537","13427","18964","","37928"
"2017-05-16 00:31","IndexPersistenceMgr.java","7929","37684","45613","","91226"
"2017-10-03 12:31","IndexPersistenceMgr.java","27125","75253","102378","","204756"
"2017-07-04 06:27","IndexPersistenceMgr.java","9938","49703","59641","","119282"
"2017-01-31 04:01","IndexPersistenceMgr.java","6114","27105","33219","","66438"
"2014-05-09 14:04","CookieTest.java","2849","12272","15121","7","30242"
"2016-11-30 00:02","CookieTest.java","112062","48247","160309","","320618"
"2014-12-10 19:43","CookieTest.java","4587","25242","29829","","59658"
"2014-09-23 17:53","CookieTest.java","4205","23776","27981","","55962"
"2014-09-18 06:57","CookieTest.java","4187","23702","27889","","55778"
"2017-07-04 06:27","Bookie.java","4475","18442","22917","","45834"
"2017-06-05 22:25","Bookie.java","3709","11890","15599","","31198"
"2017-06-28 23:24","Bookie.java","3859","13993","17852","","35704"
"2017-07-07 08:19","Bookie.java","4564","20494","25058","","50116"
"2017-05-16 00:31","Bookie.java","2203","6160","8363","","16726"
"2017-06-01 23:58","Bookie.java","3283","10015","13298","","26596"
"2017-08-02 00:49","Bookie.java","9385","41558","50943","","101886"
"2017-06-05 20:30","Bookie.java","3451","10541","13992","","27984"
"2014-12-10 19:43","LocalBookKeeper.java","12070","119115","131185","","262370"
"2013-02-08 19:08","LocalBookKeeper.java","7932","85569","93501","4","187002"
"2015-07-10 22:48","LocalBookKeeper.java","12240","121925","134165","","268330"
"2017-05-26 12:38","LocalBookKeeper.java","54630","100438","155068","","310136"
"2017-06-01 11:31","LocalBookKeeper.java","54665","101387","156052","","312104"
"2017-06-01 23:58","LocalBookKeeper.java","55207","101892","157099","","314198"
"2013-01-14 16:59","LocalBookKeeper.java","7766","54690","62456","2","124912"
"2017-01-31 04:01","Bookie.java","110942","33818","144760","","289520"
"2017-03-28 22:37","Bookie.java","111182","38865","150047","","300094"
"2017-07-04 06:27","Bookie.java","114490","56140","170630","","341260"
"2017-06-05 22:25","Bookie.java","113889","49753","163642","","327284"
"2017-06-28 23:24","Bookie.java","114007","51824","165831","","331662"
"2017-07-07 08:19","Bookie.java","114539","58152","172691","","345382"
"2017-05-16 00:31","Bookie.java","112599","44239","156838","","313676"
"2017-06-01 23:58","Bookie.java","113520","47935","161455","","322910"
"2017-08-02 00:49","Bookie.java","118625","78481","197106","","394212"
"2016-11-18 00:18","Bookie.java","110840","20615","131455","","262910"
"2017-03-28 22:35","Bookie.java","111142","38610","149752","","299504"
"2016-07-14 23:02","Bookie.java","105723","7608","113331","","226662"
"2017-06-05 20:30","Bookie.java","113640","48413","162053","","324106"
"2016-11-30 00:02","Bookie.java","110868","21173","132041","","264082"
"2017-03-22 22:54","Bookie.java","111076","34240","145316","","290632"
"2017-10-17 09:32","BookKeeperAdmin.java","125327","102642","227969","","455938"
"2017-06-01 23:58","BookKeeperAdmin.java","112883","66746","179629","","359258"
"2017-04-11 20:19","BookKeeperAdmin.java","111117","58495","169612","","339224"
"2017-07-07 05:11","BookKeeperAdmin.java","113597","76375","189972","","379944"
"2016-11-09 03:05","BookKeeperAdmin.java","110735","39823","150558","","301116"
"2016-11-30 00:07","BookKeeperAdmin.java","110781","40533","151314","","302628"
"2016-09-10 21:01","BookKeeperAdmin.java","109160","34563","143723","","287446"
"2016-07-14 23:02","BookKeeperAdmin.java","107924","29257","137181","","274362"
"2016-10-13 09:27","BookKeeperAdmin.java","110726","39480","150206","","300412"
"2016-03-16 05:03","BookKeeperAdmin.java","107506","24347","131853","","263706"
"2016-03-08 07:18","BookKeeperAdmin.java","4186","25313","29499","","58998"
"2014-12-06 08:03","BookKeeperAdmin.java","2468","16526","18994","","37988"
"2014-04-24 10:43","BookKeeperAdmin.java","222","2194","2416","7","4832"
"2014-09-06 07:51","BookKeeperAdmin.java","1995","14916","16911","","33822"
"2017-08-16 03:41","BookKeeperServerStats.java","8633","39482","48115","","96230"
"2017-10-03 12:31","BookKeeperServerStats.java","31191","45340","76531","","153062"
"2017-03-28 22:35","LocalBookieEnsemblePlacementPolicy.java","1240","19388","20628","","41256"
"2017-07-28 20:12","LocalBookieEnsemblePlacementPolicy.java","6467","43391","49858","","99716"
"2014-07-24 01:41","ZkLedgerLayoutTest.java","7632","65646","73278","","146556"
"2013-03-25 06:27","ZkLedgerLayoutTest.java","4145","42832","46977","4","93954"
"2013-05-31 12:02","TestLedgerUnderreplicationManager.java","4249","40369","44618","5","89236"
"2013-10-12 05:42","TestLedgerUnderreplicationManager.java","5572","48497","54069","6","108138"
"2015-07-10 22:48","TestLedgerUnderreplicationManager.java","8421","74641","83062","","166124"
"2016-11-18 00:18","InterleavedLedgerStorage.java","79935","58117","138052","","276104"
"2013-12-02 18:45","InterleavedLedgerStorage.java","5192","50589","55781","6","111562"
"2013-05-04 14:22","InterleavedLedgerStorage.java","3430","38723","42153","5","84306"
"2014-01-15 15:58","InterleavedLedgerStorage.java","5272","51013","56285","6","112570"
"2014-01-21 17:26","InterleavedLedgerStorage.java","5464","52750","58214","6","116428"
"2013-10-02 06:23","InterleavedLedgerStorage.java","4002","45606","49608","5","99216"
"2017-05-16 00:31","InterleavedLedgerStorage.java","80826","80873","161699","","323398"
"2014-08-02 20:02","InterleavedLedgerStorage.java","7127","67133","74260","","148520"
"2017-07-04 06:27","InterleavedLedgerStorage.java","81993","92050","174043","","348086"
"2015-04-21 09:55","InterleavedLedgerStorage.java","7623","73051","80674","","161348"
"2017-01-31 04:01","InterleavedLedgerStorage.java","79989","71272","151261","","302522"
"2016-03-08 06:49","InterleavedLedgerStorage.java","8550","77971","86521","","173042"
"2017-03-28 22:37","InterleavedLedgerStorage.java","80079","76169","156248","","312496"
"2015-04-21 09:17","InterleavedLedgerStorage.java","7603","72860","80463","","160926"
"2012-03-21 06:13","GarbageCollectorThread.java","333","465","798","1","1596"
"2013-05-04 14:22","GarbageCollectorThread.java","13550","108977","122527","5","245054"
"2013-09-11 00:34","GarbageCollectorThread.java","13832","115559","129391","5","258782"
"2014-01-15 15:58","GarbageCollectorThread.java","14653","120528","135181","6","270362"
"2013-10-22 07:44","GarbageCollectorThread.java","14539","117573","132112","6","264224"
"2017-05-09 23:06","GarbageCollectorThread.java","46966","105265","152231","","304462"
"2014-01-21 17:26","GarbageCollectorThread.java","14741","122161","136902","6","273804"
"2013-10-02 06:23","GarbageCollectorThread.java","13832","115570","129402","5","258804"
"2017-11-08 12:27","GarbageCollectorThread.java","50807","147235","198042","","396084"
"2012-12-24 05:50","GarbageCollectorThread.java","11441","71575","83016","2","166032"
"2017-03-28 22:39","GarbageCollectorThread.java","46763","103006","149769","","299538"
"2017-01-30 23:25","GarbageCollectorThread.java","46698","91976","138674","","277348"
"2016-05-04 15:55","GarbageCollectorThread.java","46521","75985","122506","","245012"
"2012-07-23 23:39","GarbageCollectorThread.java","6018","22289","28307","2","56614"
"2016-03-08 06:49","GarbageCollectorThread.java","16200","145755","161955","","323910"
"2016-02-24 00:44","GarbageCollectorThread.java","16196","145399","161595","","323190"
"2015-04-21 09:55","GarbageCollectorThread.java","15869","141431","157300","","314600"
"2012-05-17 19:07","GarbageCollectorThread.java","1986","6679","8665","1","17330"
"2012-05-08 09:35","GarbageCollectorThread.java","1264","4195","5459","1","10918"
"2013-10-30 16:23","GarbageCollectorThread.java","14635","119642","134277","6","268554"
"2013-05-09 11:41","IndexCorruptionTest.java","2335","35785","38120","5","76240"
"2013-05-04 14:22","GarbageCollectorThread.java","13320","108615","121935","5","243870"
"2013-09-11 00:34","GarbageCollectorThread.java","13602","115197","128799","5","257598"
"2014-01-15 15:58","GarbageCollectorThread.java","14441","120184","134625","6","269250"
"2013-10-22 07:44","GarbageCollectorThread.java","14312","117214","131526","6","263052"
"2017-05-09 23:06","GarbageCollectorThread.java","46859","105026","151885","","303770"
"2014-01-21 17:26","GarbageCollectorThread.java","14529","121817","136346","6","272692"
"2013-10-02 06:23","GarbageCollectorThread.java","13602","115208","128810","5","257620"
"2017-11-08 12:27","GarbageCollectorThread.java","50712","147008","197720","","395440"
"2012-12-24 05:50","GarbageCollectorThread.java","11211","71213","82424","2","164848"
"2017-03-28 22:39","GarbageCollectorThread.java","46656","102767","149423","","298846"
"2017-01-30 23:25","GarbageCollectorThread.java","46578","91724","138302","","276604"
"2016-05-04 15:55","GarbageCollectorThread.java","46402","75734","122136","","244272"
"2012-07-23 23:39","GarbageCollectorThread.java","5770","21909","27679","2","55358"
"2016-03-08 06:49","GarbageCollectorThread.java","16081","145504","161585","","323170"
"2016-02-24 00:44","GarbageCollectorThread.java","16078","145149","161227","","322454"
"2015-04-21 09:55","GarbageCollectorThread.java","15663","141093","156756","","313512"
"2012-05-17 19:07","GarbageCollectorThread.java","1737","6298","8035","1","16070"
"2012-05-08 09:35","GarbageCollectorThread.java","1011","3810","4821","1","9642"
"2013-10-30 16:23","GarbageCollectorThread.java","14424","119299","133723","6","267446"
"2017-07-28 20:12","BKException.java","11151","56451","67602","","135204"
"2017-05-02 23:04","BKException.java","6998","35786","42784","","85568"
"2017-08-02 00:49","BKException.java","14208","73120","87328","","174656"
"2017-01-31 04:01","BKException.java","6061","27993","34054","","68108"
"2014-01-22 07:37","CheckpointSource.java","2776","14771","17547","6","35094"
"2014-02-05 22:43","BookieLedgerIndexer.java","1505","3204","4709","7","9418"
"2017-05-16 00:31","TestPerChannelBookieClient.java","112662","46261","158923","","317846"
"2017-01-31 02:14","TestPerChannelBookieClient.java","111001","30367","141368","","282736"
"2016-04-05 08:45","TestPerChannelBookieClient.java","105296","7351","112647","","225294"
"2017-05-15 19:52","TestPerChannelBookieClient.java","112499","45680","158179","","316358"
"2011-11-18 11:18","BookKeeperTestClient.java","2545","5696","8241","","16482"
"2017-06-01 23:58","EntryLogger.java","113893","73815","187708","","375416"
"2014-01-21 17:26","EntryLogger.java","1121","5507","6628","6","13256"
"2014-01-22 14:35","EntryLogger.java","1271","6033","7304","6","14608"
"2017-11-08 12:27","EntryLogger.java","126694","120088","246782","","493564"
"2017-01-31 02:11","EntryLogger.java","111999","54301","166300","","332600"
"2017-03-23 00:48","EntryLogger.java","112100","60823","172923","","345846"
"2016-07-14 23:02","EntryLogger.java","109266","36658","145924","","291848"
"2016-02-24 00:44","EntryLogger.java","5513","31682","37195","","74390"
"2015-04-21 10:02","EntryLogger.java","4512","27073","31585","","63170"
"2015-04-21 09:44","EntryLogger.java","4500","26877","31377","","62754"
"2015-10-22 09:22","PendingAddOp.java","33","863","896","","1792"
"2017-06-30 00:12","PendingAddOp.java","114336","55758","170094","","340188"
"2017-08-02 00:49","PendingAddOp.java","118418","80007","198425","","396850"
"2017-05-15 19:52","PendingAddOp.java","112498","45453","157951","","315902"
"2012-12-08 11:18","ZkLedgerLayoutTest.java","16734","83987","100721","2","201442"
"2014-07-24 01:41","ZkLedgerLayoutTest.java","19806","145073","164879","","329758"
"2012-06-19 12:39","ZkLedgerLayoutTest.java","10996","29863","40859","2","81718"
"2012-03-15 10:37","ZkLedgerLayoutTest.java","8486","19605","28091","1","56182"
"2013-03-25 06:27","ZkLedgerLayoutTest.java","18652","124592","143244","4","286488"
"2017-06-30 00:12","DistributionSchedule.java","40530","126712","167242","","334484"
"2012-09-12 11:59","DistributionSchedule.java","14547","68736","83283","2","166566"
"2012-08-17 12:41","DistributionSchedule.java","14337","56997","71334","2","142668"
"2012-02-13 15:46","DistributionSchedule.java","4625","16631","21256","1","42512"
"2017-01-31 04:01","Bookie.java","111996","38124","150120","","300240"
"2017-03-28 22:37","Bookie.java","112226","43161","155387","","310774"
"2016-01-26 22:11","Bookie.java","1299","4551","5850","","11700"
"2015-04-21 09:17","Bookie.java","100","202","302","","604"
"2017-07-04 06:27","Bookie.java","115392","60294","175686","","351372"
"2017-06-05 22:25","Bookie.java","114806","53922","168728","","337456"
"2017-06-28 23:24","Bookie.java","114918","55987","170905","","341810"
"2017-07-07 08:19","Bookie.java","115441","62306","177747","","355494"
"2017-05-16 00:31","Bookie.java","113558","48450","162008","","324016"
"2017-06-01 23:58","Bookie.java","114445","52112","166557","","333114"
"2017-08-02 00:49","Bookie.java","119276","82384","201660","","403320"
"2016-11-18 00:18","Bookie.java","111919","24946","136865","","273730"
"2017-03-28 22:35","Bookie.java","112186","42906","155092","","310184"
"2016-07-14 23:02","Bookie.java","106836","11973","118809","","237618"
"2017-06-05 20:30","Bookie.java","114564","52589","167153","","334306"
"2016-11-30 00:02","Bookie.java","111947","25504","137451","","274902"
"2017-03-22 22:54","Bookie.java","112124","38540","150664","","301328"
"2017-05-04 20:58","AbstractZkLedgerManager.java","47606","104659","152265","","304530"
"2013-07-29 12:30","AbstractZkLedgerManager.java","13612","113551","127163","5","254326"
"2017-06-01 23:58","AbstractZkLedgerManager.java","48468","110178","158646","","317292"
"2017-06-12 17:20","AbstractZkLedgerManager.java","48496","111983","160479","","320958"
"2012-12-24 05:50","AbstractZkLedgerManager.java","11231","70119","81350","2","162700"
"2013-03-25 06:27","AbstractZkLedgerManager.java","13296","106411","119707","4","239414"
"2012-08-28 14:25","AbstractZkLedgerManager.java","6814","38216","45030","2","90060"
"2017-03-28 22:40","AbstractZkLedgerManager.java","47403","102609","150012","","300024"
"2016-02-09 08:23","AbstractZkLedgerManager.java","16107","143364","159471","","318942"
"2015-09-15 10:38","AbstractZkLedgerManager.java","16013","141025","157038","","314076"
"2012-12-08 11:18","AbstractZkLedgerManager.java","10558","64986","75544","2","151088"
"2016-02-23 19:16","AbstractZkLedgerManager.java","16109","143704","159813","","319626"
"2012-06-19 12:39","AbstractZkLedgerManager.java","2472","8514","10986","2","21972"
"2014-05-12 08:10","AbstractZkLedgerManager.java","15089","126245","141334","7","282668"
"2014-01-17 18:13","AbstractZkLedgerManager.java","14574","119559","134133","6","268266"
"2016-08-01 08:04","LedgerOpenOp.java","40469","87171","127640","","255280"
"2015-10-06 10:05","LedgerOpenOp.java","19285","161478","180763","","361526"
"2015-04-21 09:17","LedgerOpenOp.java","19208","160210","179418","","358836"
"2014-01-21 05:19","LedgerOpenOp.java","18492","141230","159722","6","319444"
"2012-06-19 12:39","LedgerOpenOp.java","11183","34082","45265","2","90530"
"2014-02-21 19:01","LedgerOpenOp.java","18808","143512","162320","7","324640"
"2011-11-18 11:18","LedgerOpenOp.java","717","2005","2722","","5444"
"2012-07-18 17:00","LedgerOpenOp.java","12729","44543","57272","2","114544"
"2017-01-31 04:01","Bookie.java","111910","37936","149846","","299692"
"2017-03-28 22:37","Bookie.java","112142","42975","155117","","310234"
"2016-01-26 22:11","Bookie.java","1200","4350","5550","","11100"
"2017-07-04 06:27","Bookie.java","115326","60126","175452","","350904"
"2017-06-05 22:25","Bookie.java","114737","53751","168488","","336976"
"2017-06-28 23:24","Bookie.java","114849","55816","170665","","341330"
"2017-07-07 08:19","Bookie.java","115375","62138","177513","","355026"
"2017-05-16 00:31","Bookie.java","113474","48264","161738","","323476"
"2017-06-01 23:58","Bookie.java","114369","51934","166303","","332606"
"2017-08-02 00:49","Bookie.java","119218","82224","201442","","402884"
"2016-11-18 00:18","Bookie.java","111832","24757","136589","","273178"
"2017-03-28 22:35","Bookie.java","112102","42720","154822","","309644"
"2016-07-14 23:02","Bookie.java","106749","11784","118533","","237066"
"2017-06-05 20:30","Bookie.java","114488","52411","166899","","333798"
"2016-11-30 00:02","Bookie.java","111860","25315","137175","","274350"
"2017-03-22 22:54","Bookie.java","112040","38354","150394","","300788"
"2017-06-21 19:58","PendingReadOp.java","113106","70262","183368","","366736"
"2017-06-05 21:48","PendingReadOp.java","112944","68712","181656","","363312"
"2017-06-05 22:13","PendingReadOp.java","112951","69132","182083","","364166"
"2017-06-01 11:42","PendingReadOp.java","112113","67172","179285","","358570"
"2017-06-01 22:39","PendingReadOp.java","112759","67400","180159","","360318"
"2017-05-15 19:52","PendingReadOp.java","111874","63707","175581","","351162"
"2015-04-21 09:17","PendingReadOp.java","2945","20406","23351","","46702"
"2016-02-09 08:39","PendingReadOp.java","3922","24722","28644","","57288"
"2016-02-09 08:32","PendingReadOp.java","3922","24665","28587","","57174"
"2017-07-04 06:27","PendingReadOp.java","113475","75736","189211","","378422"
"2017-05-15 19:52","ClientUtil.java","112434","60754","173188","","346376"
"2017-05-25 14:23","ClientUtil.java","112626","63228","175854","","351708"
"2017-06-30 00:12","PendingAddOp.java","114384","54976","169360","","338720"
"2017-08-02 00:49","PendingAddOp.java","118470","79229","197699","","395398"
"2017-05-15 19:52","PendingAddOp.java","112523","44648","157171","","314342"
"2017-10-17 09:32","BookKeeperAdmin.java","125165","103643","228808","","457616"
"2017-06-01 23:58","BookKeeperAdmin.java","112825","67851","180676","","361352"
"2017-04-11 20:19","BookKeeperAdmin.java","111078","59619","170697","","341394"
"2014-02-21 19:01","BookKeeperAdmin.java","201","1364","1565","7","3130"
"2017-07-07 05:11","BookKeeperAdmin.java","113496","77437","190933","","381866"
"2016-11-09 03:05","BookKeeperAdmin.java","110742","40993","151735","","303470"
"2016-11-30 00:07","BookKeeperAdmin.java","110786","41701","152487","","304974"
"2016-09-10 21:01","BookKeeperAdmin.java","109171","35737","144908","","289816"
"2016-07-14 23:02","BookKeeperAdmin.java","107943","30439","138382","","276764"
"2016-10-13 09:27","BookKeeperAdmin.java","110733","40650","151383","","302766"
"2016-03-16 05:03","BookKeeperAdmin.java","107526","25530","133056","","266112"
"2016-03-08 07:18","BookKeeperAdmin.java","4206","26496","30702","","61404"
"2014-12-06 08:03","BookKeeperAdmin.java","2510","17731","20241","","40482"
"2014-04-24 10:43","BookKeeperAdmin.java","422","3557","3979","7","7958"
"2014-09-06 07:51","BookKeeperAdmin.java","2165","16249","18414","","36828"
"2015-04-21 09:17","LedgerDeleteOp.java","4052","22316","26368","","52736"
"2015-10-06 10:05","LedgerDeleteOp.java","4836","24291","29127","","58254"
"2017-05-16 00:31","IndexPersistenceMgr.java","2889","24754","27643","","55286"
"2017-10-03 12:31","IndexPersistenceMgr.java","29012","69250","98262","","196524"
"2017-07-04 06:27","IndexPersistenceMgr.java","4948","36823","41771","","83542"
"2017-01-31 04:01","IndexPersistenceMgr.java","779","13880","14659","","29318"
"2017-11-08 12:27","EntryLocation.java","132573","99446","232019","","464038"
"2017-05-16 00:31","WriteEntryProcessorV3.java","113474","48264","161738","","323476"
"2016-11-12 03:35","WriteEntryProcessorV3.java","111832","24628","136460","","272920"
"2017-05-15 19:52","WriteEntryProcessorV3.java","113312","47684","160996","","321992"
"2015-07-10 22:48","TestZooKeeperClient.java","1519","5500","7019","","14038"
"2016-01-26 22:11","TestZooKeeperClient.java","2135","8701","10836","","21672"
"2017-03-23 15:59","TestZooKeeperClient.java","112812","42945","155757","","311514"
"2014-12-10 19:43","TestEntryLog.java","1949","11577","13526","","27052"
"2016-02-24 00:44","TestEntryLog.java","3263","18778","22041","","44082"
"2017-05-16 00:31","TestEntryLog.java","112271","58764","171035","","342070"
"2017-07-07 08:19","TestEntryLog.java","113867","72333","186200","","372400"
"2017-06-05 22:25","BookieRequestProcessor.java","3944","16932","20876","","41752"
"2017-07-04 06:27","BookieRequestProcessor.java","4684","23458","28142","","56284"
"2017-08-02 00:49","BookieRequestProcessor.java","9319","46299","55618","","111236"
"2017-03-28 22:35","BookieRequestProcessor.java","334","4926","5260","","10520"
"2017-05-15 19:52","BookieRequestProcessor.java","2252","10598","12850","","25700"
"2014-08-02 20:02","DiskChecker.java","9204","84864","94068","","188136"
"2014-01-15 15:58","DiskChecker.java","7660","69055","76715","6","153430"
"2017-07-07 08:19","DiskChecker.java","74455","102129","176584","","353168"
"2013-01-09 17:18","DiskChecker.java","4235","21886","26121","2","52242"
"2017-06-05 20:30","DiskChecker.java","74230","93064","167294","","334588"
"2012-03-20 12:51","GarbageCollectorThread.java","7772","11868","19640","1","39280"
"2012-03-21 06:13","GarbageCollectorThread.java","8096","12324","20420","1","40840"
"2013-05-04 14:22","GarbageCollectorThread.java","19039","118562","137601","5","275202"
"2013-09-11 00:34","GarbageCollectorThread.java","19314","125137","144451","5","288902"
"2014-01-15 15:58","GarbageCollectorThread.java","19608","129579","149187","6","298374"
"2013-10-22 07:44","GarbageCollectorThread.java","19501","126631","146132","6","292264"
"2017-05-09 23:06","GarbageCollectorThread.java","46104","108499","154603","","309206"
"2014-01-21 17:26","GarbageCollectorThread.java","19696","131212","150908","6","301816"
"2013-10-02 06:23","GarbageCollectorThread.java","19314","125148","144462","5","288924"
"2017-11-08 12:27","GarbageCollectorThread.java","49703","150227","199930","","399860"
"2012-12-24 05:50","GarbageCollectorThread.java","17184","81414","98598","2","197196"
"2017-03-28 22:39","GarbageCollectorThread.java","45901","106240","152141","","304282"
"2017-01-30 23:25","GarbageCollectorThread.java","45836","95210","141046","","282092"
"2016-05-04 15:55","GarbageCollectorThread.java","45693","79253","124946","","249892"
"2012-07-23 23:39","GarbageCollectorThread.java","12207","32574","44781","2","89562"
"2016-03-08 06:49","GarbageCollectorThread.java","20886","154537","175423","","350846"
"2016-02-24 00:44","GarbageCollectorThread.java","20880","154179","175059","","350118"
"2015-04-21 09:55","GarbageCollectorThread.java","20659","150317","170976","","341952"
"2012-05-17 19:07","GarbageCollectorThread.java","9548","18337","27885","1","55770"
"2012-05-08 09:35","GarbageCollectorThread.java","8903","15930","24833","1","49666"
"2013-10-30 16:23","GarbageCollectorThread.java","19589","128692","148281","6","296562"
"2016-03-08 06:49","ForceReadOnlyBookieTest.java","1716","7088","8804","","17608"
"2014-01-21 05:19","LedgerDeleteOp.java","13620","113459","127079","6","254158"
"2015-04-21 09:17","LedgerDeleteOp.java","14909","133012","147921","","295842"
"2015-10-06 10:05","LedgerDeleteOp.java","15236","134530","149766","","299532"
"2012-12-24 05:50","LedgerDeleteOp.java","9710","62556","72266","2","144532"
"2015-04-21 09:17","PendingAddOp.java","19208","160210","179418","","358836"
"2015-10-06 10:48","PendingAddOp.java","19287","161706","180993","","361986"
"2015-10-22 09:22","PendingAddOp.java","19296","162545","181841","","363682"
"2017-06-30 00:12","PendingAddOp.java","40883","124724","165607","","331214"
"2014-01-21 05:19","PendingAddOp.java","18492","141230","159722","6","319444"
"2012-09-12 11:59","PendingAddOp.java","13601","65449","79050","2","158100"
"2014-02-21 19:01","PendingAddOp.java","18808","143512","162320","7","324640"
"2014-02-05 22:43","PendingAddOp.java","18772","142313","161085","7","322170"
"2013-09-11 00:34","PendingAddOp.java","18282","135620","153902","5","307804"
"2013-10-14 18:32","PendingAddOp.java","18368","136733","155101","6","310202"
"2012-04-02 12:38","PendingAddOp.java","10040","27476","37516","1","75032"
"2013-04-26 18:38","PendingAddOp.java","18019","128697","146716","5","293432"
"2017-08-02 00:49","PendingAddOp.java","41569","145577","187146","","374292"
"2012-12-27 23:16","PendingAddOp.java","16555","92571","109126","2","218252"
"2017-05-15 19:52","PendingAddOp.java","40724","116098","156822","","313644"
"2019-02-20 11:43","LedgerCacheTest.java","44522","383199","427721","","855442"
"2017-05-16 00:31","LedgerCacheTest.java","2755","18083","20838","","41676"
"2017-10-17 09:32","AuditorElector.java","125918","110694","236612","","473224"
"2016-07-14 23:02","AuditorElector.java","109954","38748","148702","","297404"
"2016-09-10 21:01","AuditorElector.java","111170","44034","155204","","310408"
"2017-03-28 22:40","AuditorElector.java","112839","67659","180498","","360996"
"2014-06-02 11:54","AuditorElector.java","3800","15371","19171","7","38342"
"2014-04-24 10:43","AuditorElector.java","3560","12993","16553","7","33106"
"2014-09-06 07:58","AuditorElector.java","4876","25390","30266","","60532"
"2017-03-28 22:40","ScanAndCompareGarbageCollector.java","6774","33785","40559","","81118"
"2014-08-02 20:02","Journal.java","15344","131846","147190","","294380"
"2014-03-07 13:14","Journal.java","14852","120345","135197","7","270394"
"2014-04-29 22:07","Journal.java","14897","122702","137599","7","275198"
"2013-12-06 07:39","Journal.java","14289","116334","130623","6","261246"
"2012-10-18 16:40","Journal.java","9185","50027","59212","2","118424"
"2012-07-23 23:39","Journal.java","4751","17384","22135","2","44270"
"2015-04-21 09:23","Journal.java","15615","137372","152987","","305974"
"2012-10-16 23:20","Journal.java","8524","46795","55319","2","110638"
"2016-02-09 08:30","Journal.java","15963","140987","156950","","313900"
"2015-02-23 08:11","Journal.java","15613","137134","152747","","305494"
"2017-05-26 16:52","Journal.java","48366","106827","155193","","310386"
"2017-03-22 22:54","Journal.java","47795","95862","143657","","287314"
"2016-11-12 03:37","Journal.java","47724","82298","130022","","260044"
"2016-07-14 23:02","Journal.java","47645","74433","122078","","244156"
"2013-05-04 14:22","Journal.java","13066","104855","117921","5","235842"
"2013-07-20 19:59","Journal.java","13289","110176","123465","5","246930"
"2013-07-04 14:01","Journal.java","13264","109914","123178","5","246356"
"2017-06-01 23:58","Journal.java","48943","108261","157204","","314408"
"2017-05-09 22:24","Journal.java","48056","102719","150775","","301550"
"2013-10-12 05:42","Journal.java","14086","113109","127195","6","254390"
"2013-10-02 06:23","Journal.java","13355","111455","124810","5","249620"
"2017-05-16 00:31","Journal.java","48325","104868","153193","","306386"
"2017-03-23 00:48","ClientConfiguration.java","6772","29892","36664","","73328"
"2017-03-28 22:35","ClientConfiguration.java","6827","34199","41026","","82052"
"2017-01-31 02:14","ClientConfiguration.java","6577","23888","30465","","60930"
"2017-04-15 13:58","ClientConfiguration.java","7037","35509","42546","","85092"
"2017-03-23 00:59","ClientConfiguration.java","6785","29917","36702","","73404"
"2017-05-15 19:52","ClientConfiguration.java","8150","39276","47426","","94852"
"2016-10-13 07:50","ClientConfiguration.java","5862","15086","20948","","41896"
"2017-06-21 19:58","ClientConfiguration.java","9782","46231","56013","","112026"
"2017-06-05 21:48","ClientConfiguration.java","9461","44522","53983","","107966"
"2017-06-21 19:50","ClientConfiguration.java","9776","46115","55891","","111782"
"2017-08-02 00:49","ClientConfiguration.java","14572","74332","88904","","177808"
"2017-08-01 08:34","ClientConfiguration.java","13963","71138","85101","","170202"
"2017-06-30 00:12","ClientConfiguration.java","10126","49719","59845","","119690"
"2017-07-04 06:27","ClientConfiguration.java","10322","51876","62198","","124396"
"2017-01-31 04:01","ClientConfiguration.java","6632","29412","36044","","72088"
"2016-08-01 08:04","ClientConfiguration.java","743","3197","3940","","7880"
"2016-08-01 08:04","LedgerOpenOp.java","105848","10357","116205","","232410"
"2016-07-31 07:53","ConfigurationTest.java","108047","24885","132932","","265864"
"2012-05-25 17:13","LedgerRecoveryOp.java","10978","31481","42459","1","84918"
"2012-05-10 14:47","LedgerRecoveryOp.java","10664","29913","40577","1","81154"
"2013-10-14 17:38","LedgerRecoveryOp.java","18366","136697","155063","6","310126"
"2017-06-21 19:58","LedgerRecoveryOp.java","40876","121573","162449","","324898"
"2017-06-21 21:00","LedgerRecoveryOp.java","40878","122248","163126","","326252"
"2017-06-21 19:50","LedgerRecoveryOp.java","40875","121462","162337","","324674"
"2012-02-13 15:46","LedgerRecoveryOp.java","2237","11902","14139","1","28278"
"2013-03-25 18:02","LedgerRecoveryOp.java","18019","128334","146353","4","292706"
"2013-05-04 14:22","LedgerDeleteTest.java","13938","109825","123763","5","247526"
"2013-05-31 12:02","LedgerDeleteTest.java","14063","110379","124442","5","248884"
"2014-01-22 14:35","LedgerDeleteTest.java","14731","122987","137718","6","275436"
"2012-11-26 16:42","LedgerDeleteTest.java","11326","64724","76050","2","152100"
"2016-03-08 06:49","LedgerDeleteTest.java","16094","146109","162203","","324406"
"2012-06-19 12:39","LedgerDeleteTest.java","3496","11244","14740","2","29480"
"2014-07-24 01:41","LedgerDeleteTest.java","15357","129505","144862","","289724"
"2017-08-16 03:41","RackawareEnsemblePlacementPolicyImpl.java","11924","51169","63093","","126186"
"2012-05-10 14:47","Journal.java","434","1144","1578","1","3156"
"2014-08-02 20:02","Journal.java","15591","132803","148394","","296788"
"2014-03-07 13:14","Journal.java","15105","121308","136413","7","272826"
"2014-04-29 22:07","Journal.java","15150","123665","138815","7","277630"
"2013-12-06 07:39","Journal.java","14552","117307","131859","6","263718"
"2012-10-18 16:40","Journal.java","9546","51098","60644","2","121288"
"2012-07-23 23:39","Journal.java","5136","18479","23615","2","47230"
"2015-04-21 09:23","Journal.java","15857","138324","154181","","308362"
"2012-10-16 23:20","Journal.java","8887","47868","56755","2","113510"
"2016-02-09 08:30","Journal.java","16198","141932","158130","","316260"
"2015-02-23 08:11","Journal.java","15855","138086","153941","","307882"
"2017-05-26 16:52","Journal.java","48204","107375","155579","","311158"
"2017-03-22 22:54","Journal.java","47639","96416","144055","","288110"
"2016-11-12 03:37","Journal.java","47568","82852","130420","","260840"
"2016-07-14 23:02","Journal.java","47489","74987","122476","","244952"
"2013-05-04 14:22","Journal.java","13338","105837","119175","5","238350"
"2013-07-20 19:59","Journal.java","13560","111157","124717","5","249434"
"2013-07-04 14:01","Journal.java","13535","110895","124430","5","248860"
"2017-06-01 23:58","Journal.java","48789","108817","157606","","315212"
"2017-05-09 22:24","Journal.java","47898","103271","151169","","302338"
"2013-10-12 05:42","Journal.java","14349","114082","128431","6","256862"
"2013-10-02 06:23","Journal.java","13624","112434","126058","5","252116"
"2017-05-16 00:31","Journal.java","48163","105416","153579","","307158"
"2013-04-04 11:21","LedgerManagerTestCase.java","13351","106976","120327","5","240654"
"2017-06-12 17:20","LedgerManagerTestCase.java","48496","111983","160479","","320958"
"2017-05-16 00:31","LedgerManagerTestCase.java","47857","106792","154649","","309298"
"2012-12-24 05:50","LedgerManagerTestCase.java","11231","70119","81350","2","162700"
"2016-11-18 00:18","LedgerManagerTestCase.java","47292","84362","131654","","263308"
"2017-01-31 04:01","LedgerManagerTestCase.java","47334","97505","144839","","289678"
"2017-03-28 22:37","LedgerManagerTestCase.java","47360","102338","149698","","299396"
"2015-09-15 10:38","LedgerManagerTestCase.java","16013","141025","157038","","314076"
"2016-04-27 09:55","LedgerManagerTestCase.java","47142","75337","122479","","244958"
"2012-06-19 12:39","LedgerManagerTestCase.java","2472","8514","10986","2","21972"
"2017-07-04 06:27","LedgerManagerTestCase.java","48600","117545","166145","","332290"
"2017-05-15 19:52","BookKeeperClusterTestCase.java","81193","81220","162413","","324826"
"2013-01-09 17:18","BookKeeperClusterTestCase.java","2116","4511","6627","2","13254"
"2016-04-05 08:45","BookKeeperClusterTestCase.java","78897","47798","126695","","253390"
"2017-08-01 08:34","BookKeeperClusterTestCase.java","84888","110964","195852","","391704"
"2013-10-12 05:42","BookKeeperClusterTestCase.java","5572","48497","54069","6","108138"
"2014-02-05 22:43","BookKeeperClusterTestCase.java","6786","54980","61766","7","123532"
"2017-11-08 12:27","BookKeeperClusterTestCase.java","92927","129619","222546","","445092"
"2013-06-15 19:05","BookKeeperClusterTestCase.java","4352","44572","48924","5","97848"
"2014-05-09 14:04","BookKeeperClusterTestCase.java","7073","59421","66494","7","132988"
"2017-07-04 06:27","BookKeeperClusterTestCase.java","82358","92813","175171","","350342"
"2014-07-24 01:41","BookKeeperClusterTestCase.java","7530","61482","69012","","138024"
"2014-05-23 18:46","BookKeeperClusterTestCase.java","7078","59756","66834","7","133668"
"2017-06-30 00:12","BookKeeperClusterTestCase.java","82266","90760","173026","","346052"
"2014-04-24 10:43","BookKeeperClusterTestCase.java","7017","58346","65363","7","130726"
"2013-01-07 12:25","BookKeeperClusterTestCase.java","1746","3969","5715","2","11430"
"2016-04-27 09:55","BookKeeperClusterTestCase.java","78963","48668","127631","","255262"
"2013-01-03 11:06","BookKeeperClusterTestCase.java","1615","2811","4426","2","8852"
"2015-10-06 10:48","BookKeeperClusterTestCase.java","8806","75878","84684","","169368"
"2014-12-10 19:43","BookKeeperClusterTestCase.java","8168","71748","79916","","159832"
"2017-03-28 22:40","AbstractConfiguration.java","111394","41588","152982","","305964"
"2017-08-02 00:49","AbstractConfiguration.java","118438","80577","199015","","398030"
"2016-07-31 07:53","AbstractConfiguration.java","105879","10147","116026","","232052"
"2017-01-31 02:14","AbstractConfiguration.java","111039","30729","141768","","283536"
"2016-07-31 07:56","AbstractConfiguration.java","105879","10481","116360","","232720"
"2017-05-02 23:04","AbstractConfiguration.java","111956","43971","155927","","311854"
"2017-03-23 00:48","AbstractConfiguration.java","111197","36696","147893","","295786"
"2017-06-21 19:58","BookieClientTest.java","113106","70262","183368","","366736"
"2014-07-25 00:34","BookieClientTest.java","1736","13316","15052","","30104"
"2017-03-28 22:35","BookieClientTest.java","110928","59007","169935","","339870"
"2016-12-17 02:39","BookieClientTest.java","110791","47153","157944","","315888"
"2017-05-15 19:52","BookieClientTest.java","111874","63707","175581","","351162"
"2014-12-10 19:43","BookieClientTest.java","2838","18224","21062","","42124"
"2015-10-06 10:05","BookieClientTest.java","3740","22392","26132","","52264"
"2014-07-24 01:41","BookieClientTest.java","1183","6941","8124","","16248"
"2013-10-29 05:14","TestReadTimeout.java","10352","77679","88031","6","176062"
"2014-02-05 22:43","TestReadTimeout.java","11112","82805","93917","7","187834"
"2017-06-01 21:20","BookieProtocol.java","895","3222","4117","","8234"
"2017-06-05 22:25","BookieProtocol.java","1604","5828","7432","","14864"
"2017-07-07 05:11","ReplicationException.java","114166","74972","189138","","378276"
"2012-09-04 10:39","TestLedgerFragmentReplication.java","33","136","169","2","338"
"2012-10-05 16:24","TestLedgerFragmentReplication.java","3425","10494","13919","2","27838"
"2014-07-24 01:41","TestLedgerFragmentReplication.java","11807","91249","103056","","206112"
"2014-02-05 22:43","TestLedgerFragmentReplication.java","11271","84955","96226","7","192452"
"2015-04-21 09:23","Journal.java","1390","6645","8035","","16070"
"2016-02-09 08:30","Journal.java","2457","10979","13436","","26872"
"2015-02-23 08:11","Journal.java","1273","6292","7565","","15130"
"2017-05-26 16:52","Journal.java","114407","56366","170773","","341546"
"2017-03-22 22:54","Journal.java","112970","44535","157505","","315010"
"2016-11-12 03:37","Journal.java","112787","30859","143646","","287292"
"2016-07-14 23:02","Journal.java","107718","18004","125722","","251444"
"2017-06-01 23:58","Journal.java","115213","58029","173242","","346484"
"2017-05-09 22:24","Journal.java","113656","51817","165473","","330946"
"2017-05-16 00:31","Journal.java","114344","54385","168729","","337458"
"2014-05-23 18:46","BookieAutoRecoveryTest.java","111","1460","1571","7","3142"
"2014-05-09 14:04","BookieAutoRecoveryTest.java","90","1109","1199","7","2398"
"2013-01-09 17:18","LedgerDirsManager.java","2586","7761","10347","2","20694"
"2017-06-05 20:30","LedgerDirsManager.java","81037","87395","168432","","336864"
"2017-01-30 23:25","LedgerDirsManager.java","79491","67813","147304","","294608"
"2017-03-28 22:35","LedgerDirsManager.java","79574","78627","158201","","316402"
"2013-12-02 18:45","LedgerDirsManager.java","6194","54769","60963","6","121926"
"2014-01-15 15:58","LedgerDirsManager.java","6274","55193","61467","6","122934"
"2017-06-28 23:24","LedgerDirsManager.java","81100","90502","171602","","343204"
"2017-07-07 08:19","LedgerDirsManager.java","81276","96474","177750","","355500"
"2014-01-21 17:26","LedgerDirsManager.java","6459","56923","63382","6","126764"
"2013-10-02 07:01","LedgerDirsManager.java","5075","50047","55122","5","110244"
"2014-08-02 20:02","LedgerDirsManager.java","7993","71177","79170","","158340"
"2012-10-05 16:24","TestLedgerFragmentReplication.java","3399","10365","13764","2","27528"
"2014-07-24 01:41","TestLedgerFragmentReplication.java","11788","91127","102915","","205830"
"2014-02-05 22:43","TestLedgerFragmentReplication.java","11251","84832","96083","7","192166"
"2012-05-10 14:47","Journal.java","511","1738","2249","1","4498"
"2012-05-07 18:48","Journal.java","98","615","713","1","1426"
"2014-08-02 20:02","Journal.java","15422","133151","148573","","297146"
"2014-03-07 13:14","Journal.java","14937","121657","136594","7","273188"
"2014-04-29 22:07","Journal.java","14981","124013","138994","7","277988"
"2013-12-06 07:39","Journal.java","14388","117660","132048","6","264096"
"2012-10-18 16:40","Journal.java","9399","51468","60867","2","121734"
"2012-07-23 23:39","Journal.java","5044","18904","23948","2","47896"
"2015-04-21 09:23","Journal.java","15686","138670","154356","","308712"
"2012-10-16 23:20","Journal.java","8740","48238","56978","2","113956"
"2016-02-09 08:30","Journal.java","16026","142277","158303","","316606"
"2015-02-23 08:11","Journal.java","15684","138432","154116","","308232"
"2017-05-26 16:52","Journal.java","47873","107561","155434","","310868"
"2017-03-22 22:54","Journal.java","47307","96601","143908","","287816"
"2016-11-12 03:37","Journal.java","47237","83038","130275","","260550"
"2016-07-14 23:02","Journal.java","47158","75173","122331","","244662"
"2013-05-04 14:22","Journal.java","13177","106193","119370","5","238740"
"2013-07-20 19:59","Journal.java","13399","111513","124912","5","249824"
"2013-07-04 14:01","Journal.java","13374","111251","124625","5","249250"
"2017-06-01 23:58","Journal.java","48455","109000","157455","","314910"
"2017-05-09 22:24","Journal.java","47567","103457","151024","","302048"
"2013-10-12 05:42","Journal.java","14185","114435","128620","6","257240"
"2013-10-02 06:23","Journal.java","13463","112790","126253","5","252506"
"2017-05-16 00:31","Journal.java","47832","105602","153434","","306868"
"2017-07-28 20:12","BKException.java","5240","21752","26992","","53984"
"2017-08-02 00:49","BKException.java","8670","38794","47464","","94928"
"2017-06-01 23:58","MSLedgerManagerFactory.java","114505","75639","190144","","380288"
"2015-09-15 10:38","MSLedgerManagerFactory.java","5941","30377","36318","","72636"
"2017-03-28 22:40","MSLedgerManagerFactory.java","112819","67449","180268","","360536"
"2014-01-17 18:13","MSLedgerManagerFactory.java","1619","6028","7647","6","15294"
"2014-05-12 08:10","MSLedgerManagerFactory.java","3500","14080","17580","7","35160"
"2012-12-12 11:20","BookieLedgerIndexTest.java","5378","32423","37801","2","75602"
"2012-08-31 15:25","BookieLedgerIndexTest.java","435","3448","3883","2","7766"
"2013-10-14 16:43","BookieLedgerIndexTest.java","10088","83001","93089","6","186178"
"2017-08-02 00:49","AuthHandler.java","7739","36373","44112","","88224"
"2017-06-01 23:58","AuthHandler.java","1414","4607","6021","","12042"
"2017-06-05 22:25","BookieProtocol.java","735","2632","3367","","6734"
"2016-08-01 08:04","LedgerOpenOp.java","106758","12458","119216","","238432"
"2015-10-06 10:05","LedgerOpenOp.java","1056","2247","3303","","6606"
"2011-11-17 11:16","LedgerOutputStream.java","2969","5310","8279","","16558"
"2017-06-01 11:42","LedgerOutputStream.java","40521","121462","161983","","323966"
"2014-02-05 22:43","TestSpeculativeRead.java","3888","17457","21345","7","42690"
"2013-10-29 05:14","TestSpeculativeRead.java","2566","11769","14335","6","28670"
"2017-06-01 22:39","TestSpeculativeRead.java","112654","80864","193518","","387036"
"2014-07-24 01:41","TestSpeculativeRead.java","4725","24052","28777","","57554"
"2014-02-05 22:43","BookieClientTest.java","2368","7637","10005","7","20010"
"2017-06-21 19:58","BookieClientTest.java","114206","76631","190837","","381674"
"2014-07-25 00:34","BookieClientTest.java","3674","20523","24197","","48394"
"2017-03-28 22:35","BookieClientTest.java","112188","65536","177724","","355448"
"2016-12-17 02:39","BookieClientTest.java","112071","53702","165773","","331546"
"2017-05-15 19:52","BookieClientTest.java","113068","70170","183238","","366476"
"2014-12-10 19:43","BookieClientTest.java","4587","25242","29829","","59658"
"2015-10-06 10:05","BookieClientTest.java","5381","29302","34683","","69366"
"2014-07-24 01:41","BookieClientTest.java","3366","14393","17759","","35518"
"2015-09-15 10:38","AbstractConfiguration.java","20183","158020","178203","","356406"
"2017-03-28 22:40","AbstractConfiguration.java","42181","110212","152393","","304786"
"2012-10-05 16:24","AbstractConfiguration.java","15762","68656","84418","2","168836"
"2012-05-24 07:12","AbstractConfiguration.java","10295","26586","36881","1","73762"
"2012-06-19 12:39","AbstractConfiguration.java","10996","29863","40859","2","81718"
"2012-12-12 11:20","AbstractConfiguration.java","16796","85202","101998","2","203996"
"2017-08-02 00:49","AbstractConfiguration.java","43374","143350","186724","","373448"
"2013-06-12 18:41","AbstractConfiguration.java","18901","130009","148910","5","297820"
"2012-06-13 16:57","AbstractConfiguration.java","10370","28471","38841","","77682"
"2016-07-31 07:53","AbstractConfiguration.java","42051","84156","126207","","252414"
"2017-01-31 02:14","AbstractConfiguration.java","42157","99684","141841","","283682"
"2016-07-31 07:56","AbstractConfiguration.java","42051","84490","126541","","253082"
"2017-05-02 23:04","AbstractConfiguration.java","42380","112232","154612","","309224"
"2017-03-23 00:48","AbstractConfiguration.java","42179","105515","147694","","295388"
"2012-11-30 04:54","AbstractConfiguration.java","16599","83270","99869","2","199738"
"2014-09-18 06:47","ServerConfiguration.java","585","2594","3179","","6358"
"2017-07-04 06:27","ServerConfiguration.java","116075","66126","182201","","364402"
"2016-04-14 00:51","ServerConfiguration.java","107339","16128","123467","","246934"
"2015-01-16 15:57","ServerConfiguration.java","1248","6229","7477","","14954"
"2016-03-08 06:49","ServerConfiguration.java","2704","12119","14823","","29646"
"2016-01-26 22:11","ServerConfiguration.java","2348","10749","13097","","26194"
"2016-04-05 18:47","ServerConfiguration.java","107313","16052","123365","","246730"
"2016-04-27 09:55","ServerConfiguration.java","107400","16701","124101","","248202"
"2015-04-21 09:55","ServerConfiguration.java","1421","6843","8264","","16528"
"2015-01-12 15:18","ServerConfiguration.java","1239","5282","6521","","13042"
"2015-04-21 10:02","ServerConfiguration.java","1434","6889","8323","","16646"
"2017-05-15 19:52","ServerConfiguration.java","114187","53810","167997","","335994"
"2017-03-22 22:54","ServerConfiguration.java","112970","44535","157505","","315010"
"2017-03-23 00:48","ServerConfiguration.java","112975","44592","157567","","315134"
"2017-01-31 02:11","ServerConfiguration.java","112861","38057","150918","","301836"
"2016-04-05 08:45","ServerConfiguration.java","107302","15799","123101","","246202"
"2016-11-09 03:02","ServerConfiguration.java","112751","30775","143526","","287052"
"2016-11-30 00:02","ServerConfiguration.java","112812","31518","144330","","288660"
"2017-06-05 20:30","ServerConfiguration.java","115331","58505","173836","","347672"
"2016-09-10 20:27","ServerConfiguration.java","111124","25359","136483","","272966"
"2017-08-02 00:49","ServerConfiguration.java","119826","88083","207909","","415818"
"2017-10-03 12:31","ServerConfiguration.java","130390","88804","219194","","438388"
"2017-08-16 03:37","ServerConfiguration.java","121440","96330","217770","","435540"
"2017-05-26 12:38","ServerConfiguration.java","114403","56342","170745","","341490"
"2017-07-07 08:19","ServerConfiguration.java","116119","68133","184252","","368504"
"2017-06-28 23:24","ServerConfiguration.java","115626","61844","177470","","354940"
"2017-11-08 12:27","ServerConfiguration.java","132416","108704","241120","","482240"
"2016-02-09 08:28","BookieShell.java","1771","7491","9262","","18524"
"2016-03-16 05:03","BookieShell.java","106567","9554","116121","","232242"
"2015-01-13 13:06","BookieShell.java","393","2442","2835","","5670"
"2017-06-01 23:58","BookieShell.java","114680","54689","169369","","338738"
"2017-07-07 05:11","BookieShell.java","115638","64562","180200","","360400"
"2017-01-11 07:37","BookieShell.java","112254","34410","146664","","293328"
"2016-12-21 01:42","BookieShell.java","112243","34041","146284","","292568"
"2017-01-11 07:34","BookieShell.java","112254","34286","146540","","293080"
"2016-11-30 00:02","BookieShell.java","112210","28109","140319","","280638"
"2017-01-30 23:25","BookieShell.java","112259","34590","146849","","293698"
"2017-03-28 22:35","BookieShell.java","112443","45505","157948","","315896"
"2017-01-30 21:31","BookieShell.java","112256","34479","146735","","293470"
"2017-03-22 22:54","BookieShell.java","112386","41144","153530","","307060"
"2012-12-08 11:18","Bookie.java","17398","81216","98614","2","197228"
"2012-09-14 15:42","Bookie.java","14492","59009","73501","2","147002"
"2012-10-25 15:35","Bookie.java","17099","70860","87959","2","175918"
"2012-10-26 16:25","Bookie.java","17134","71844","88978","2","177956"
"2017-01-31 04:01","Bookie.java","44004","103565","147569","","295138"
"2017-03-28 22:37","Bookie.java","44007","108375","152382","","304764"
"2016-01-26 22:11","Bookie.java","21036","157721","178757","","357514"
"2015-03-18 07:38","Bookie.java","20835","154268","175103","","350206"
"2015-04-21 09:17","Bookie.java","20834","154369","175203","","350406"
"2012-10-18 16:40","Bookie.java","17011","69635","86646","2","173292"
"2012-12-03 17:59","Bookie.java","17282","81055","98337","2","196674"
"2012-07-04 16:17","Bookie.java","11768","32787","44555","2","89110"
"2012-07-23 23:39","Bookie.java","13318","37733","51051","2","102102"
"2013-06-21 19:26","Bookie.java","19683","127910","147593","5","295186"
"2012-09-07 07:04","Bookie.java","14148","58004","72152","2","144304"
"2014-09-23 17:53","Bookie.java","20791","151167","171958","","343916"
"2017-07-04 06:27","Bookie.java","45053","123388","168441","","336882"
"2017-06-05 22:25","Bookie.java","44987","117536","162523","","325046"
"2014-02-06 09:25","Bookie.java","20344","136426","156770","7","313540"
"2014-04-29 22:07","Bookie.java","20391","139978","160369","7","320738"
"2013-12-06 07:39","Bookie.java","19965","133792","153757","6","307514"
"2012-07-05 14:45","Bookie.java","11778","33279","45057","2","90114"
"2012-05-10 14:47","Bookie.java","10442","22224","32666","1","65332"
"2014-08-02 20:02","Bookie.java","20780","149064","169844","","339688"
"2012-04-17 13:16","Bookie.java","10113","20668","30781","1","61562"
"2012-04-16 16:11","Bookie.java","9763","19906","29669","1","59338"
"2013-10-02 07:01","Bookie.java","19784","129856","149640","5","299280"
"2012-06-19 12:39","Bookie.java","11565","26997","38562","2","77124"
"2017-06-28 23:24","Bookie.java","45020","119522","164542","","329084"
"2017-07-07 08:19","Bookie.java","45046","125344","170390","","340780"
"2013-09-11 00:34","Bookie.java","19762","129633","149395","5","298790"
"2014-01-21 17:26","Bookie.java","20045","135609","155654","6","311308"
"2013-10-12 05:42","Bookie.java","19831","130636","150467","6","300934"
"2013-10-22 16:21","Bookie.java","19943","131515","151458","6","302916"
"2017-05-16 00:31","Bookie.java","44411","112736","157147","","314294"
"2013-07-24 16:55","Bookie.java","19709","128994","148703","5","297406"
"2014-02-05 22:43","Bookie.java","20344","136418","156762","7","313524"
"2014-08-18 23:03","Bookie.java","20780","150532","171312","","342624"
"2014-05-09 14:04","Bookie.java","20391","140619","161010","7","322020"
"2013-06-15 19:05","Bookie.java","19686","127786","147472","5","294944"
"2017-06-01 23:58","Bookie.java","44971","116071","161042","","322084"
"2012-03-29 15:18","Bookie.java","9629","18622","28251","1","56502"
"2012-04-17 12:18","Bookie.java","9796","20128","29924","1","59848"
"2012-03-08 19:24","Bookie.java","1907","5999","7906","1","15812"
"2012-02-15 16:11","Bookie.java","1430","3640","5070","1","10140"
"2012-02-17 12:50","Bookie.java","1434","3885","5319","1","10638"
"2012-03-20 14:09","Bookie.java","9479","17757","27236","1","54472"
"2012-03-08 12:13","Bookie.java","1841","5889","7730","1","15460"
"2012-03-13 07:31","Bookie.java","2354","8703","11057","1","22114"
"2012-02-09 18:14","Bookie.java","1273","3224","4497","1","8994"
"2012-04-02 12:38","Bookie.java","9760","19729","29489","1","58978"
"2017-08-02 00:49","Bookie.java","45748","142289","188037","","376074"
"2013-12-02 18:45","Bookie.java","19962","133637","153599","6","307198"
"2013-05-04 14:22","Bookie.java","19494","123065","142559","5","285118"
"2012-12-18 13:04","Bookie.java","17670","85840","103510","2","207020"
"2016-11-18 00:18","Bookie.java","43966","90426","134392","","268784"
"2017-03-28 22:35","Bookie.java","44006","108159","152165","","304330"
"2016-07-14 23:02","Bookie.java","43886","82456","126342","","252684"
"2017-06-05 20:30","Bookie.java","44971","116429","161400","","322800"
"2016-11-30 00:02","Bookie.java","43967","90957","134924","","269848"
"2012-12-24 05:50","Bookie.java","17861","86139","104000","2","208000"
"2017-03-22 22:54","Bookie.java","44008","103857","147865","","295730"
"2012-12-24 06:23","Bookie.java","17909","86409","104318","2","208636"
"2017-11-08 12:27","BookieStorageThresholdTest.java","35439","65743","101182","","202364"
"2017-06-01 23:58","ReadEntryProcessorV3.java","115196","58642","173838","","347676"
"2017-05-16 00:31","ReadEntryProcessorV3.java","114331","55002","169333","","338666"
"2017-05-15 19:52","ReadEntryProcessorV3.java","114182","54435","168617","","337234"
"2016-11-12 03:35","ReadEntryProcessorV3.java","112797","31474","144271","","288542"
"2014-08-02 20:02","ReadEntryProcessorV3.java","165","795","960","","1920"
"2017-06-05 22:25","ReadEntryProcessorV3.java","115485","60380","175865","","351730"
"2017-05-15 19:52","AuthHandler.java","1608","4262","5870","","11740"
"2017-08-02 00:49","AuthHandler.java","9121","40409","49530","","99060"
"2017-06-01 23:58","AuthHandler.java","2935","8782","11717","","23434"
"2017-03-28 22:37","HandleFactoryImpl.java","111701","64497","176198","","352396"
"2016-02-09 08:28","BookieShell.java","1760","7276","9036","","18072"
"2016-03-16 05:03","BookieShell.java","106556","9339","115895","","231790"
"2015-01-13 13:06","BookieShell.java","381","2226","2607","","5214"
"2017-06-01 23:58","BookieShell.java","114680","54485","169165","","338330"
"2017-07-07 05:11","BookieShell.java","115638","64358","179996","","359992"
"2017-01-11 07:37","BookieShell.java","112249","34201","146450","","292900"
"2016-12-21 01:42","BookieShell.java","112238","33832","146070","","292140"
"2017-01-11 07:34","BookieShell.java","112249","34077","146326","","292652"
"2016-11-30 00:02","BookieShell.java","112205","27900","140105","","280210"
"2017-01-30 23:25","BookieShell.java","112254","34381","146635","","293270"
"2017-03-28 22:35","BookieShell.java","112438","45296","157734","","315468"
"2017-01-30 21:31","BookieShell.java","112251","34270","146521","","293042"
"2017-03-22 22:54","BookieShell.java","112381","40935","153316","","306632"
"2016-12-21 01:48","LedgerCacheTest.java","111405","62390","173795","","347590"
"2019-02-20 11:43","LedgerCacheTest.java","130352","420014","550366","","1100732"
"2013-08-12 19:01","LedgerCacheTest.java","2208","9604","11812","5","23624"
"2013-10-12 05:42","LedgerCacheTest.java","3400","12193","15593","6","31186"
"2017-05-16 00:31","LedgerCacheTest.java","112268","78581","190849","","381698"
"2013-12-02 18:45","LedgerCacheTest.java","3734","15397","19131","6","38262"
"2014-07-24 01:41","LedgerCacheTest.java","5631","25451","31082","","62164"
"2014-12-10 19:43","LedgerCacheTest.java","6303","35751","42054","","84108"
"2016-03-08 06:49","LedgerCacheTest.java","7307","42994","50301","","100602"
"2014-03-12 21:26","LedgerCacheTest.java","5046","22111","27157","7","54314"
"2017-04-15 13:58","ClientConfiguration.java","433","1533","1966","","3932"
"2017-05-15 19:52","ClientConfiguration.java","2005","5759","7764","","15528"
"2017-06-21 19:58","ClientConfiguration.java","3810","12887","16697","","33394"
"2017-06-05 21:48","ClientConfiguration.java","3476","11165","14641","","29282"
"2017-06-21 19:50","ClientConfiguration.java","3804","12771","16575","","33150"
"2017-08-02 00:49","ClientConfiguration.java","9396","41784","51180","","102360"
"2017-08-01 08:34","ClientConfiguration.java","8602","38405","47007","","94014"
"2017-06-30 00:12","ClientConfiguration.java","4207","16428","20635","","41270"
"2017-07-04 06:27","ClientConfiguration.java","4491","18673","23164","","46328"
"2016-11-18 00:18","LedgerDescriptorImpl.java","80536","58826","139362","","278724"
"2017-05-16 00:31","LedgerDescriptorImpl.java","81360","81515","162875","","325750"
"2017-07-04 06:27","LedgerDescriptorImpl.java","82514","92679","175193","","350386"
"2017-06-05 22:25","LedgerDescriptorImpl.java","82238","86617","168855","","337710"
"2017-01-31 04:01","LedgerDescriptorImpl.java","80590","71981","152571","","305142"
"2016-02-09 08:39","BookKeeperTest.java","10659","84098","94757","","189514"
"2015-10-16 07:00","BookKeeperTest.java","10554","82097","92651","","185302"
"2016-04-08 19:43","BookKeeperTest.java","78033","51649","129682","","259364"
"2017-01-31 04:01","BookKeeperTest.java","79473","75599","155072","","310144"
"2014-07-24 01:41","BookKeeperTest.java","9383","67780","77163","","154326"
"2017-05-15 19:52","BookKeeperTest.java","80148","84620","164768","","329536"
"2017-05-02 22:07","BookKeeperTest.java","79666","81784","161450","","322900"
"2013-05-06 19:32","BookKeeperTest.java","6280","46516","52796","5","105592"
"2013-01-10 19:13","BookKeeperTest.java","4445","11723","16168","2","32336"
"2015-07-10 22:48","ZooKeeperUtil.java","1878","6218","8096","","16192"
"2014-12-10 19:43","ZooKeeperUtil.java","1217","2917","4134","","8268"
"2016-04-05 21:52","ZooKeeperUtil.java","107467","14733","122200","","244400"
"2017-08-02 00:49","BookieRequestHandler.java","117723","99339","217062","","434124"
"2017-05-15 19:52","BookieRequestHandler.java","112690","65672","178362","","356724"
"2017-03-23 00:48","ClientConfiguration.java","250","6059","6309","","12618"
"2017-03-28 22:35","ClientConfiguration.java","345","10406","10751","","21502"
"2017-04-15 13:58","ClientConfiguration.java","680","11841","12521","","25042"
"2017-03-23 00:59","ClientConfiguration.java","263","6084","6347","","12694"
"2017-05-15 19:52","ClientConfiguration.java","2090","15905","17995","","35990"
"2017-06-21 19:58","ClientConfiguration.java","3791","22929","26720","","53440"
"2017-06-05 21:48","ClientConfiguration.java","3466","21216","24682","","49364"
"2017-06-21 19:50","ClientConfiguration.java","3785","22813","26598","","53196"
"2017-08-02 00:49","ClientConfiguration.java","9032","51481","60513","","121026"
"2017-08-01 08:34","ClientConfiguration.java","8289","48153","56442","","112884"
"2017-06-30 00:12","ClientConfiguration.java","4161","26443","30604","","61208"
"2017-07-04 06:27","ClientConfiguration.java","4425","28668","33093","","66186"
"2014-04-29 22:07","BookieJournalTest.java","12843","110929","123772","7","247544"
"2014-12-10 19:43","BookieJournalTest.java","13596","123555","137151","","274302"
"2017-05-15 19:52","BookieJournalTest.java","52246","98652","150898","","301796"
"2017-05-16 00:31","BookieJournalTest.java","52312","99136","151448","","302896"
"2013-10-11 08:36","BookieJournalTest.java","11780","100543","112323","6","224646"
"2013-10-12 05:42","BookieJournalTest.java","11899","101203","113102","6","226204"
"2012-09-07 07:04","BookieException.java","6130","38204","44334","2","88668"
"2013-02-08 19:08","BookieException.java","11785","102055","113840","4","227680"
"2017-07-07 08:19","BookieException.java","49070","117586","166656","","333312"
"2016-11-18 00:18","LedgerCacheImpl.java","79935","58117","138052","","276104"
"2017-05-16 00:31","LedgerCacheImpl.java","80826","80873","161699","","323398"
"2013-10-11 08:36","LedgerCacheImpl.java","4820","46806","51626","6","103252"
"2017-06-01 23:58","LedgerCacheImpl.java","81562","84384","165946","","331892"
"2014-08-02 20:02","LedgerCacheImpl.java","7127","67133","74260","","148520"
"2017-07-04 06:27","LedgerCacheImpl.java","81993","92050","174043","","348086"
"2017-01-31 04:01","LedgerCacheImpl.java","79989","71272","151261","","302522"
"2017-01-31 04:01","BookieRequestProcessor.java","111668","56304","167972","","335944"
"2017-06-05 22:25","BookieRequestProcessor.java","113836","71460","185296","","370592"
"2017-07-04 06:27","BookieRequestProcessor.java","114239","77649","191888","","383776"
"2014-08-02 20:02","BookieRequestProcessor.java","2950","16309","19259","","38518"
"2017-08-02 00:49","BookieRequestProcessor.java","117723","99339","217062","","434124"
"2014-07-25 00:34","BookieRequestProcessor.java","2903","15632","18535","","37070"
"2017-03-28 22:35","BookieRequestProcessor.java","111768","60996","172764","","345528"
"2017-01-31 02:14","BookieRequestProcessor.java","111656","50823","162479","","324958"
"2017-05-15 19:52","BookieRequestProcessor.java","112690","65672","178362","","356724"
"2017-07-28 20:12","BookKeeperClientStats.java","115195","82853","198048","","396096"
"2017-06-21 19:50","BookKeeperClientStats.java","113935","71784","185719","","371438"
"2017-08-01 08:34","BookKeeperClusterTestCase.java","6815","32864","39679","","79358"
"2017-11-08 12:27","BookKeeperClusterTestCase.java","36593","73258","109851","","219702"
"2017-07-04 06:27","BookKeeperClusterTestCase.java","2652","13080","15732","","31464"
"2017-06-30 00:12","BookKeeperClusterTestCase.java","2341","10808","13149","","26298"
"2017-06-01 23:58","ReplicationWorker.java","3128","9616","12744","","25488"
"2017-05-26 16:52","ReplicationWorker.java","2141","7772","9913","","19826"
"2014-06-06 15:29","CompactionTest.java","2405","11078","13483","7","26966"
"2014-01-17 18:13","CompactionTest.java","170","1394","1564","6","3128"
"2016-03-08 06:49","CompactionTest.java","5177","29725","34902","","69804"
"2015-01-16 15:57","CompactionTest.java","3992","24106","28098","","56196"
"2014-12-10 19:43","CompactionTest.java","3979","22288","26267","","52534"
"2015-04-21 09:55","CompactionTest.java","4082","24637","28719","","57438"
"2016-05-04 15:55","CompactionTest.java","108622","33079","141701","","283402"
"2017-03-22 22:54","CompactionTest.java","111701","58399","170100","","340200"
"2017-06-21 21:07","CompactionTest.java","113806","74923","188729","","377458"
"2014-01-22 14:35","CompactionTest.java","739","3528","4267","6","8534"
"2017-11-08 12:27","CompactionTest.java","126610","118031","244641","","489282"
"2017-05-16 00:31","CompactionTest.java","112733","67907","180640","","361280"
"2014-01-15 15:58","CompactionTest.java","132","1000","1132","6","2264"
"2017-07-07 08:19","CompactionTest.java","114121","81268","195389","","390778"
"2017-06-01 23:58","PendingReadLacOp.java","1414","4607","6021","","12042"
"2017-06-30 00:12","PendingReadLacOp.java","2341","10808","13149","","26298"
"2014-01-17 18:13","BookieLedgerIndexer.java","10328","86777","97105","6","194210"
"2014-02-05 22:43","BookieLedgerIndexer.java","10977","89125","100102","7","200204"
"2016-08-01 08:04","LedgerOpenOp.java","40232","89275","129507","","259014"
"2011-11-17 11:16","LedgerOpenOp.java","2969","5310","8279","","16558"
"2015-10-06 10:05","LedgerOpenOp.java","19469","164003","183472","","366944"
"2015-04-21 09:17","LedgerOpenOp.java","19430","162773","182203","","364406"
"2011-11-16 17:05","LedgerOpenOp.java","2735","4433","7168","","14336"
"2014-01-21 05:19","LedgerOpenOp.java","19001","144080","163081","6","326162"
"2012-06-19 12:39","LedgerOpenOp.java","12679","37919","50598","2","101196"
"2014-02-21 19:01","LedgerOpenOp.java","19192","146237","165429","7","330858"
"2011-11-18 11:18","LedgerOpenOp.java","3592","7221","10813","","21626"
"2012-07-18 17:00","LedgerOpenOp.java","13966","48121","62087","2","124174"
"2014-04-24 10:43","ReplicationException.java","11094","92377","103471","7","206942"
"2017-07-07 05:11","ReplicationException.java","65196","107285","172481","","344962"
"2017-05-16 00:31","LedgerDescriptorImpl.java","2889","24754","27643","","55286"
"2017-07-04 06:27","LedgerDescriptorImpl.java","4948","36823","41771","","83542"
"2017-06-05 22:25","LedgerDescriptorImpl.java","4302","30391","34693","","69386"
"2017-01-31 04:01","LedgerDescriptorImpl.java","779","13880","14659","","29318"
"2017-05-17 08:57","LedgerHandle.java","291","768","1059","","2118"
"2017-05-25 14:23","LedgerHandle.java","361","2643","3004","","6008"
"2017-06-21 19:50","LedgerHandle.java","1929","7142","9071","","18142"
"2017-06-21 21:00","LedgerHandle.java","1949","7945","9894","","19788"
"2017-06-01 23:58","LedgerHandle.java","1414","4607","6021","","12042"
"2017-07-04 06:27","LedgerHandle.java","2652","13080","15732","","31464"
"2017-06-30 00:12","LedgerHandle.java","2341","10808","13149","","26298"
"2017-06-01 23:58","ReplicationWorker.java","112825","67851","180676","","361352"
"2017-04-11 20:14","ReplicationWorker.java","111077","59615","170692","","341384"
"2016-03-16 04:51","ReplicationWorker.java","107525","25326","132851","","265702"
"2016-09-10 21:01","ReplicationWorker.java","109171","35737","144908","","289816"
"2017-05-26 16:52","ReplicationWorker.java","112056","66225","178281","","356562"
"2015-04-21 09:17","ReplicationWorker.java","2945","20406","23351","","46702"
"2014-04-24 10:43","ReplicationWorker.java","422","3557","3979","7","7958"
"2014-09-06 07:58","ReplicationWorker.java","2206","16422","18628","","37256"
"2014-12-10 19:43","BookieInitializationTest.java","9686","87385","97071","","194142"
"2014-06-06 15:29","BookieInitializationTest.java","8806","76869","85675","7","171350"
"2015-07-10 22:48","BookieInitializationTest.java","9913","90252","100165","","200330"
"2013-10-02 07:01","BookieInitializationTest.java","6614","62925","69539","5","139078"
"2013-06-21 18:51","BookieInitializationTest.java","6352","60738","67090","5","134180"
"2013-07-24 16:55","BookieInitializationTest.java","6444","61968","68412","5","136824"
"2014-01-21 17:26","BookieInitializationTest.java","7897","69700","77597","6","155194"
"2013-10-12 05:42","BookieInitializationTest.java","7384","64428","71812","6","143624"
"2017-07-07 08:19","BookieInitializationTest.java","75567","102104","177671","","355342"
"2017-06-28 23:24","BookieInitializationTest.java","75392","96133","171525","","343050"
"2017-07-28 06:39","BookieInitializationTest.java","76140","104566","180706","","361412"
"2017-08-02 00:49","BookieInitializationTest.java","77003","119783","196786","","393572"
"2017-06-05 20:30","BookieInitializationTest.java","75338","93035","168373","","336746"
"2017-05-15 19:52","BookieInitializationTest.java","74528","88674","163202","","326404"
"2017-06-01 23:58","ReplicationWorker.java","114449","75667","190116","","380232"
"2017-04-11 20:14","ReplicationWorker.java","112809","67539","180348","","360696"
"2014-02-05 22:43","ReplicationWorker.java","3075","9267","12342","7","24684"
"2016-03-16 04:51","ReplicationWorker.java","109530","33523","143053","","286106"
"2016-09-10 21:01","ReplicationWorker.java","111092","43850","154942","","309884"
"2017-05-26 16:52","ReplicationWorker.java","113714","74075","187789","","375578"
"2015-04-21 09:17","ReplicationWorker.java","5264","28917","34181","","68362"
"2013-12-06 07:39","ReplicationWorker.java","1547","5492","7039","6","14078"
"2014-04-24 10:43","ReplicationWorker.java","3452","12779","16231","7","32462"
"2014-09-06 07:58","ReplicationWorker.java","4775","25183","29958","","59916"
"2017-01-31 02:14","TestAuth.java","6577","23888","30465","","60930"
"2017-06-30 00:12","ReadLastConfirmedOp.java","49423","112761","162184","","324368"
"2012-08-27 14:43","ReadLastConfirmedOp.java","5395","29898","35293","2","70586"
"2012-09-14 15:42","ReadLastConfirmedOp.java","6120","37601","43721","2","87442"
"2017-05-15 19:52","ReadLastConfirmedOp.java","48676","103547","152223","","304446"
"2017-06-01 23:58","ReadLastConfirmedOp.java","49362","107426","156788","","313576"
"2014-02-21 19:01","ReadLastConfirmedOp.java","14544","118745","133289","7","266578"
"2014-06-06 15:29","CompactionTest.java","2270","9719","11989","7","23978"
"2016-03-08 06:49","CompactionTest.java","5089","28413","33502","","67004"
"2015-01-16 15:57","CompactionTest.java","3883","22773","26656","","53312"
"2014-12-10 19:43","CompactionTest.java","3871","20956","24827","","49654"
"2015-04-21 09:55","CompactionTest.java","3987","23318","27305","","54610"
"2016-05-04 15:55","CompactionTest.java","108534","31767","140301","","280602"
"2017-03-22 22:54","CompactionTest.java","111638","57112","168750","","337500"
"2017-06-21 21:07","CompactionTest.java","113776","73669","187445","","374890"
"2014-01-22 14:35","CompactionTest.java","582","2147","2729","6","5458"
"2017-11-08 12:27","CompactionTest.java","126692","116889","243581","","487162"
"2017-05-16 00:31","CompactionTest.java","112679","66629","179308","","358616"
"2017-07-07 08:19","CompactionTest.java","114110","80033","194143","","388286"
"2013-09-11 00:34","GarbageCollectorThread.java","797","7097","7894","5","15788"
"2014-01-15 15:58","GarbageCollectorThread.java","2351","12799","15150","6","30300"
"2013-10-22 07:44","GarbageCollectorThread.java","2071","9678","11749","6","23498"
"2017-05-09 23:06","GarbageCollectorThread.java","111584","74456","186040","","372080"
"2014-01-21 17:26","GarbageCollectorThread.java","2775","14768","17543","6","35086"
"2013-10-02 06:23","GarbageCollectorThread.java","805","7116","7921","5","15842"
"2017-11-08 12:27","GarbageCollectorThread.java","124608","125609","250217","","500434"
"2017-03-28 22:39","GarbageCollectorThread.java","111149","71965","183114","","366228"
"2017-01-30 23:25","GarbageCollectorThread.java","111005","60856","171861","","343722"
"2016-05-04 15:55","GarbageCollectorThread.java","109386","43423","152809","","305618"
"2016-03-08 06:49","GarbageCollectorThread.java","6272","40400","46672","","93344"
"2016-02-24 00:44","GarbageCollectorThread.java","6221","39997","46218","","92436"
"2015-04-21 09:55","GarbageCollectorThread.java","5302","35437","40739","","81478"
"2013-10-30 16:23","GarbageCollectorThread.java","2256","11836","14092","6","28184"
"2017-07-04 06:27","SyncThreadTest.java","114022","70533","184555","","369110"
"2017-01-31 04:01","SyncThreadTest.java","111191","48928","160119","","320238"
"2016-04-14 00:51","SyncThreadTest.java","107892","23141","131033","","262066"
"2016-03-08 06:49","SyncThreadTest.java","3706","19581","23287","","46574"
"2017-03-28 22:37","SyncThreadTest.java","111345","53889","165234","","330468"
"2016-11-18 00:18","SyncThreadTest.java","111115","35751","146866","","293732"
"2017-05-16 00:31","SyncThreadTest.java","112469","58970","171439","","342878"
"2016-12-21 01:48","LedgerCacheTest.java","80243","63320","143563","","287126"
"2013-02-12 06:00","LedgerCacheTest.java","1046","33138","34184","4","68368"
"2019-02-20 11:43","LedgerCacheTest.java","98903","420657","519560","","1039120"
"2013-08-12 19:01","LedgerCacheTest.java","3126","42614","45740","5","91480"
"2013-10-12 05:42","LedgerCacheTest.java","4278","45163","49441","6","98882"
"2017-05-16 00:31","LedgerCacheTest.java","81099","79504","160603","","321206"
"2013-12-02 18:45","LedgerCacheTest.java","4512","48267","52779","6","105558"
"2014-07-24 01:41","LedgerCacheTest.java","6343","58255","64598","","129196"
"2014-12-10 19:43","LedgerCacheTest.java","6989","68529","75518","","151036"
"2016-03-08 06:49","LedgerCacheTest.java","7990","75769","83759","","167518"
"2014-03-12 21:26","LedgerCacheTest.java","5775","54932","60707","7","121414"
"2013-03-25 06:27","TestSpeculativeRead.java","2608","36813","39421","4","78842"
"2014-02-05 22:43","TestSpeculativeRead.java","5802","53576","59378","7","118756"
"2013-10-29 05:14","TestSpeculativeRead.java","4793","48201","52994","6","105988"
"2017-06-01 22:39","TestSpeculativeRead.java","81377","83792","165169","","330338"
"2014-07-24 01:41","TestSpeculativeRead.java","6571","60103","66674","","133348"
"2016-08-01 08:04","LedgerOpenOp.java","39989","87334","127323","","254646"
"2011-11-17 11:16","LedgerOpenOp.java","254","897","1151","","2302"
"2015-10-06 10:05","LedgerOpenOp.java","18962","161798","180760","","361520"
"2015-04-21 09:17","LedgerOpenOp.java","18923","160568","179491","","358982"
"2014-01-21 05:19","LedgerOpenOp.java","18235","141616","159851","6","319702"
"2012-06-19 12:39","LedgerOpenOp.java","11045","34587","45632","2","91264"
"2014-02-21 19:01","LedgerOpenOp.java","18534","143881","162415","7","324830"
"2011-11-18 11:18","LedgerOpenOp.java","939","2870","3809","","7618"
"2012-07-18 17:00","LedgerOpenOp.java","12586","45043","57629","2","115258"
"2014-04-24 10:43","ReplicationException.java","11298","106016","117314","7","234628"
"2012-08-27 16:55","ReplicationException.java","1311","14746","16057","2","32114"
"2012-08-14 11:40","ReplicationException.java","596","8140","8736","2","17472"
"2017-07-07 05:11","ReplicationException.java","55372","110896","166268","","332536"
"2016-08-01 08:04","LedgerOpenOp.java","36034","90980","127014","","254028"
"2011-11-17 11:16","LedgerOpenOp.java","7296","15540","22836","","45672"
"2015-10-06 10:05","LedgerOpenOp.java","16538","166975","183513","","367026"
"2015-04-21 09:17","LedgerOpenOp.java","16502","165748","182250","","364500"
"2011-09-05 19:38","LedgerOpenOp.java","4901","10804","15705","","31410"
"2011-11-16 17:05","LedgerOpenOp.java","7085","14686","21771","","43542"
"2014-01-21 05:19","LedgerOpenOp.java","16129","147111","163240","6","326480"
"2012-06-19 12:39","LedgerOpenOp.java","10388","41531","51919","2","103838"
"2014-02-21 19:01","LedgerOpenOp.java","16289","149237","165526","7","331052"
"2011-11-18 11:18","LedgerOpenOp.java","7844","17376","25220","","50440"
"2012-07-18 17:00","LedgerOpenOp.java","11509","51567","63076","2","126152"
"2017-05-15 19:52","LedgerHandle.java","1577","3931","5508","","11016"
"2017-05-17 08:57","LedgerHandle.java","1840","4671","6511","","13022"
"2017-05-25 14:23","LedgerHandle.java","1895","6531","8426","","16852"
"2017-06-21 19:50","LedgerHandle.java","3408","10975","14383","","28766"
"2017-06-21 21:00","LedgerHandle.java","3425","11775","15200","","30400"
"2017-06-01 23:58","LedgerHandle.java","2905","8452","11357","","22714"
"2017-07-04 06:27","LedgerHandle.java","4112","16894","21006","","42012"
"2017-06-30 00:12","LedgerHandle.java","3814","14635","18449","","36898"
"2014-12-09 19:57","TestCallbacks.java","2232","13817","16049","","32098"
"2014-06-02 11:54","TestCallbacks.java","345","1891","2236","7","4472"
"2014-12-09 19:57","TestCallbacks.java","1997","12036","14033","","28066"
"2017-05-15 19:52","LedgerHandle.java","2056","10036","12092","","24184"
"2017-05-02 22:07","LedgerHandle.java","535","6161","6696","","13392"
"2017-05-17 08:57","LedgerHandle.java","2308","10765","13073","","26146"
"2017-05-25 14:23","LedgerHandle.java","2362","12624","14986","","29972"
"2017-06-21 19:50","LedgerHandle.java","3836","17029","20865","","41730"
"2017-06-21 21:00","LedgerHandle.java","3852","17828","21680","","43360"
"2017-06-01 23:58","LedgerHandle.java","3336","14509","17845","","35690"
"2017-07-04 06:27","LedgerHandle.java","4508","22916","27424","","54848"
"2017-06-30 00:12","LedgerHandle.java","4237","20684","24921","","49842"
"2016-07-14 23:02","ZkLedgerUnderreplicationManager.java","487","1472","1959","","3918"
"2017-07-07 05:11","ZkLedgerUnderreplicationManager.java","10286","52716","63002","","126004"
"2017-06-28 23:28","ZkLedgerUnderreplicationManager.java","9783","47192","56975","","113950"
"2017-06-01 23:58","ZkLedgerUnderreplicationManager.java","9212","42727","51939","","103878"
"2017-03-28 22:40","ZkLedgerUnderreplicationManager.java","6776","33787","40563","","81126"
"2014-01-15 15:58","GarbageCollectorThread.java","1625","5773","7398","6","14796"
"2013-10-22 07:44","GarbageCollectorThread.java","1334","2641","3975","6","7950"
"2017-05-09 23:06","GarbageCollectorThread.java","113202","69774","182976","","365952"
"2014-01-21 17:26","GarbageCollectorThread.java","2048","7741","9789","6","19578"
"2013-10-02 06:23","GarbageCollectorThread.java","8","19","27","5","54"
"2017-11-08 12:27","GarbageCollectorThread.java","126932","121633","248565","","497130"
"2017-03-28 22:39","GarbageCollectorThread.java","112746","67262","180008","","360016"
"2017-01-30 23:25","GarbageCollectorThread.java","112597","56148","168745","","337490"
"2016-05-04 15:55","GarbageCollectorThread.java","109629","37366","146995","","293990"
"2016-03-08 06:49","GarbageCollectorThread.java","6287","34115","40402","","80804"
"2016-02-24 00:44","GarbageCollectorThread.java","6234","33710","39944","","79888"
"2015-04-21 09:55","GarbageCollectorThread.java","5285","29120","34405","","68810"
"2013-10-30 16:23","GarbageCollectorThread.java","1520","4800","6320","6","12640"
"2017-05-15 19:52","BookKeeperClusterTestCase.java","80953","78585","159538","","319076"
"2016-04-05 08:45","BookKeeperClusterTestCase.java","78578","45084","123662","","247324"
"2017-08-01 08:34","BookKeeperClusterTestCase.java","84806","108487","193293","","386586"
"2013-10-12 05:42","BookKeeperClusterTestCase.java","3899","44429","48328","6","96656"
"2014-02-05 22:43","BookKeeperClusterTestCase.java","5196","50995","56191","7","112382"
"2017-11-08 12:27","BookKeeperClusterTestCase.java","93236","127533","220769","","441538"
"2013-06-15 19:05","BookKeeperClusterTestCase.java","2586","40411","42997","5","85994"
"2014-05-09 14:04","BookKeeperClusterTestCase.java","5520","55473","60993","7","121986"
"2017-07-04 06:27","BookKeeperClusterTestCase.java","82254","90314","172568","","345136"
"2014-07-24 01:41","BookKeeperClusterTestCase.java","5987","57544","63531","","127062"
"2014-05-23 18:46","BookKeeperClusterTestCase.java","5526","55809","61335","7","122670"
"2017-06-30 00:12","BookKeeperClusterTestCase.java","82149","88248","170397","","340794"
"2014-04-24 10:43","BookKeeperClusterTestCase.java","5457","54391","59848","7","119696"
"2016-04-27 09:55","BookKeeperClusterTestCase.java","78648","45958","124606","","249212"
"2015-10-06 10:48","BookKeeperClusterTestCase.java","7335","72012","79347","","158694"
"2014-12-10 19:43","BookKeeperClusterTestCase.java","6639","67824","74463","","148926"
"2017-06-01 23:58","ReplicationWorker.java","8617","45842","54459","","108918"
"2017-04-11 20:14","ReplicationWorker.java","6385","37122","43507","","87014"
"2016-09-10 21:01","ReplicationWorker.java","4273","13038","17311","","34622"
"2017-05-26 16:52","ReplicationWorker.java","7762","44130","51892","","103784"
"2017-06-01 23:58","EntryLogger.java","47572","110879","158451","","316902"
"2014-01-21 17:26","EntryLogger.java","14643","122414","137057","6","274114"
"2013-10-02 06:23","EntryLogger.java","14218","116307","130525","5","261050"
"2014-01-22 14:35","EntryLogger.java","14738","122885","137623","6","275246"
"2017-11-08 12:27","EntryLogger.java","50558","147337","197895","","395790"
"2013-10-22 07:44","EntryLogger.java","14449","117834","132283","6","264566"
"2012-06-13 16:57","EntryLogger.java","2799","9672","12471","","24942"
"2013-05-04 14:22","EntryLogger.java","13942","109720","123662","5","247324"
"2017-01-31 02:11","EntryLogger.java","46491","92178","138669","","277338"
"2017-03-23 00:48","EntryLogger.java","46515","98623","145138","","290276"
"2016-07-14 23:02","EntryLogger.java","46384","77161","123545","","247090"
"2012-12-24 06:23","EntryLogger.java","12024","72731","84755","2","169510"
"2012-12-10 11:04","EntryLogger.java","11538","67662","79200","2","158400"
"2016-02-24 00:44","EntryLogger.java","16098","145652","161750","","323500"
"2015-04-21 10:02","EntryLogger.java","15771","141717","157488","","314976"
"2012-10-18 16:40","EntryLogger.java","10814","55645","66459","2","132918"
"2012-07-26 04:32","EntryLogger.java","6589","23222","29811","2","59622"
"2013-01-04 11:32","EntryLogger.java","12364","74462","86826","2","173652"
"2015-04-21 09:44","EntryLogger.java","15770","141532","157302","","314604"
"2012-05-09 10:39","EntryLogger.java","1877","5580","7457","1","14914"
"2012-05-07 18:48","EntryLogger.java","1857","5136","6993","1","13986"
"2012-05-10 14:47","EntryLogger.java","2213","6202","8415","1","16830"
"2012-05-17 19:07","EntryLogger.java","2580","7624","10204","1","20408"
"2017-06-01 23:58","EntryLogger.java","49781","106215","155996","","311992"
"2014-01-21 17:26","EntryLogger.java","14077","114975","129052","6","258104"
"2013-10-02 06:23","EntryLogger.java","12976","108192","121168","5","242336"
"2014-01-22 14:35","EntryLogger.java","14182","115456","129638","6","259276"
"2017-11-08 12:27","EntryLogger.java","53633","143539","197172","","394344"
"2013-10-22 07:44","EntryLogger.java","13824","110336","124160","6","248320"
"2013-05-04 14:22","EntryLogger.java","12681","101586","114267","5","228534"
"2017-01-31 02:11","EntryLogger.java","48583","87397","135980","","271960"
"2017-03-23 00:48","EntryLogger.java","48635","93870","142505","","285010"
"2016-07-14 23:02","EntryLogger.java","48477","72381","120858","","241716"
"2012-12-24 06:23","EntryLogger.java","10256","64090","74346","2","148692"
"2012-12-10 11:04","EntryLogger.java","9523","58774","68297","2","136594"
"2016-02-24 00:44","EntryLogger.java","15839","138520","154359","","308718"
"2015-04-21 10:02","EntryLogger.java","15365","134438","149803","","299606"
"2012-10-18 16:40","EntryLogger.java","8726","46684","55410","2","110820"
"2012-07-26 04:32","EntryLogger.java","4135","13895","18030","2","36060"
"2013-01-04 11:32","EntryLogger.java","10748","65973","76721","2","153442"
"2015-04-21 09:44","EntryLogger.java","15363","134252","149615","","299230"
"2014-08-02 20:02","ServerConfiguration.java","1363","10013","11376","","22752"
"2014-05-15 00:41","ServerConfiguration.java","32","946","978","7","1956"
"2014-09-18 06:47","ServerConfiguration.java","1944","12603","14547","","29094"
"2017-07-04 06:27","ServerConfiguration.java","114109","72810","186919","","373838"
"2016-04-14 00:51","ServerConfiguration.java","108052","25491","133543","","267086"
"2015-01-16 15:57","ServerConfiguration.java","2576","16207","18783","","37566"
"2016-03-08 06:49","ServerConfiguration.java","3909","21974","25883","","51766"
"2016-01-26 22:11","ServerConfiguration.java","3567","20618","24185","","48370"
"2016-04-05 18:47","ServerConfiguration.java","108026","25415","133441","","266882"
"2016-04-27 09:55","ServerConfiguration.java","108105","26056","134161","","268322"
"2015-04-21 09:55","ServerConfiguration.java","2711","16783","19494","","38988"
"2015-01-12 15:18","ServerConfiguration.java","2568","15261","17829","","35658"
"2015-04-21 10:02","ServerConfiguration.java","2724","16829","19553","","39106"
"2017-05-15 19:52","ServerConfiguration.java","112439","60712","173151","","346302"
"2017-03-22 22:54","ServerConfiguration.java","111413","51628","163041","","326082"
"2017-03-23 00:48","ServerConfiguration.java","111418","51685","163103","","326206"
"2017-01-31 02:11","ServerConfiguration.java","111319","45165","156484","","312968"
"2016-04-05 08:45","ServerConfiguration.java","108016","25163","133179","","266358"
"2016-11-09 03:02","ServerConfiguration.java","111225","37899","149124","","298248"
"2016-11-30 00:02","ServerConfiguration.java","111273","38629","149902","","299804"
"2017-06-05 20:30","ServerConfiguration.java","113528","65352","178880","","357760"
"2016-09-10 20:27","ServerConfiguration.java","109635","32520","142155","","284310"
"2017-08-02 00:49","ServerConfiguration.java","117765","94672","212437","","424874"
"2017-10-03 12:31","ServerConfiguration.java","125360","92424","217784","","435568"
"2017-08-16 03:37","ServerConfiguration.java","119366","102906","222272","","444544"
"2014-05-09 14:04","ServerConfiguration.java","16","610","626","7","1252"
"2017-05-26 12:38","ServerConfiguration.java","112635","63224","175859","","351718"
"2017-07-07 08:19","ServerConfiguration.java","114141","74805","188946","","377892"
"2017-06-28 23:24","ServerConfiguration.java","113723","68591","182314","","364628"
"2017-11-08 12:27","ServerConfiguration.java","127265","112203","239468","","478936"
"2012-02-13 15:46","BookieFailureTest.java","1609","9986","11595","1","23190"
"2012-12-20 06:48","BookieFailureTest.java","16393","90750","107143","2","214286"
"2012-08-13 11:38","BookieFailureTest.java","12715","49204","61919","2","123838"
"2014-07-24 01:41","BookieFailureTest.java","18947","146958","165905","","331810"
"2012-06-19 12:39","BookieFailureTest.java","10733","32344","43077","2","86154"
"2017-05-12 16:39","SortedLedgerStorage.java","1650","15750","17400","","34800"
"2017-05-16 00:31","SortedLedgerStorage.java","2755","18083","20838","","41676"
"2017-03-22 22:54","Cookie.java","831","13690","14521","","29042"
"2017-05-09 23:06","GarbageCollectorThread.java","112203","64627","176830","","353660"
"2014-01-21 17:26","GarbageCollectorThread.java","464","2009","2473","6","4946"
"2017-11-08 12:27","GarbageCollectorThread.java","126683","117236","243919","","487838"
"2017-03-28 22:39","GarbageCollectorThread.java","111745","62113","173858","","347716"
"2017-01-30 23:25","GarbageCollectorThread.java","111553","50956","162509","","325018"
"2016-05-04 15:55","GarbageCollectorThread.java","108557","32146","140703","","281406"
"2016-03-08 06:49","GarbageCollectorThread.java","5112","28792","33904","","67808"
"2016-02-24 00:44","GarbageCollectorThread.java","5023","28351","33374","","66748"
"2015-04-21 09:55","GarbageCollectorThread.java","4012","23699","27711","","55422"
"2014-01-15 15:58","GarbageCollectorThread.java","699","3540","4239","6","8478"
"2017-05-09 23:06","GarbageCollectorThread.java","112613","67878","180491","","360982"
"2014-01-21 17:26","GarbageCollectorThread.java","1121","5507","6628","6","13256"
"2017-11-08 12:27","GarbageCollectorThread.java","126694","120088","246782","","493564"
"2017-03-28 22:39","GarbageCollectorThread.java","112156","65365","177521","","355042"
"2017-01-30 23:25","GarbageCollectorThread.java","111999","54243","166242","","332484"
"2016-05-04 15:55","GarbageCollectorThread.java","109017","35447","144464","","288928"
"2016-03-08 06:49","GarbageCollectorThread.java","5589","32110","37699","","75398"
"2016-02-24 00:44","GarbageCollectorThread.java","5513","31682","37195","","74390"
"2015-04-21 09:55","GarbageCollectorThread.java","4502","27030","31532","","63064"
"2013-10-30 16:23","GarbageCollectorThread.java","549","2522","3071","6","6142"
"2013-02-08 19:08","BookieException.java","7684","65880","73564","4","147128"
"2017-07-07 08:19","BookieException.java","68758","105200","173958","","347916"
"2017-06-01 23:58","EntryLogger.java","46313","115203","161516","","323032"
"2014-01-21 17:26","EntryLogger.java","19327","132681","152008","6","304016"
"2013-10-02 06:23","EntryLogger.java","18995","126667","145662","5","291324"
"2014-01-22 14:35","EntryLogger.java","19397","133127","152524","6","305048"
"2017-11-08 12:27","EntryLogger.java","48966","151328","200294","","400588"
"2013-10-22 07:44","EntryLogger.java","19146","128114","147260","6","294520"
"2012-03-16 10:41","EntryLogger.java","7520","13103","20623","1","41246"
"2012-06-13 16:57","EntryLogger.java","9733","22189","31922","","63844"
"2013-05-04 14:22","EntryLogger.java","18727","120088","138815","5","277630"
"2012-03-08 12:13","EntryLogger.java","453","2291","2744","1","5488"
"2017-01-31 02:11","EntryLogger.java","45295","96565","141860","","283720"
"2017-03-23 00:48","EntryLogger.java","45315","103006","148321","","296642"
"2016-07-14 23:02","EntryLogger.java","45193","81553","126746","","253492"
"2012-12-24 06:23","EntryLogger.java","17102","83392","100494","2","200988"
"2012-12-10 11:04","EntryLogger.java","16634","78341","94975","2","189950"
"2016-02-24 00:44","EntryLogger.java","20408","155545","175953","","351906"
"2015-04-21 10:02","EntryLogger.java","20209","151738","171947","","343894"
"2012-10-18 16:40","EntryLogger.java","16104","66518","82622","2","165244"
"2012-07-26 04:32","EntryLogger.java","12171","34387","46558","2","93116"
"2013-01-04 11:32","EntryLogger.java","17369","85050","102419","2","204838"
"2015-04-21 09:44","EntryLogger.java","20208","151553","171761","","343522"
"2012-05-09 10:39","EntryLogger.java","8976","18262","27238","1","54476"
"2012-05-07 18:48","EntryLogger.java","8963","17825","26788","1","53576"
"2012-05-10 14:47","EntryLogger.java","9238","18810","28048","1","56096"
"2012-05-17 19:07","EntryLogger.java","9603","20230","29833","1","59666"
"2014-08-02 20:02","ServerConfiguration.java","1388","9124","10512","","21024"
"2014-09-18 06:47","ServerConfiguration.java","1969","11714","13683","","27366"
"2017-07-04 06:27","ServerConfiguration.java","114211","71998","186209","","372418"
"2016-04-14 00:51","ServerConfiguration.java","108137","24662","132799","","265598"
"2015-01-16 15:57","ServerConfiguration.java","2620","15337","17957","","35914"
"2016-03-08 06:49","ServerConfiguration.java","3997","21148","25145","","50290"
"2016-01-26 22:11","ServerConfiguration.java","3651","19788","23439","","46878"
"2016-04-05 18:47","ServerConfiguration.java","108111","24586","132697","","265394"
"2016-04-27 09:55","ServerConfiguration.java","108190","25227","133417","","266834"
"2015-04-21 09:55","ServerConfiguration.java","2755","15913","18668","","37336"
"2015-01-12 15:18","ServerConfiguration.java","2612","14391","17003","","34006"
"2015-04-21 10:02","ServerConfiguration.java","2768","15959","18727","","37454"
"2017-05-15 19:52","ServerConfiguration.java","112535","59894","172429","","344858"
"2017-03-22 22:54","ServerConfiguration.java","111514","50815","162329","","324658"
"2017-03-23 00:48","ServerConfiguration.java","111515","50868","162383","","324766"
"2017-01-31 02:11","ServerConfiguration.java","111405","44337","155742","","311484"
"2016-04-05 08:45","ServerConfiguration.java","108101","24334","132435","","264870"
"2016-11-09 03:02","ServerConfiguration.java","111310","37070","148380","","296760"
"2016-11-30 00:02","ServerConfiguration.java","111359","37801","149160","","298320"
"2017-06-05 20:30","ServerConfiguration.java","113629","64539","178168","","356336"
"2016-09-10 20:27","ServerConfiguration.java","109720","31691","141411","","282822"
"2017-08-02 00:49","ServerConfiguration.java","117865","93858","211723","","423446"
"2017-10-03 12:31","ServerConfiguration.java","125550","91700","217250","","434500"
"2017-08-16 03:37","ServerConfiguration.java","119472","102098","221570","","443140"
"2017-05-26 12:38","ServerConfiguration.java","112731","62406","175137","","350274"
"2017-07-07 08:19","ServerConfiguration.java","114238","73988","188226","","376452"
"2017-06-28 23:24","ServerConfiguration.java","113824","67778","181602","","363204"
"2017-11-08 12:27","ServerConfiguration.java","127463","111487","238950","","477900"
"2017-05-16 00:31","BookieProtocol.java","45822","112029","157851","","315702"
"2017-06-01 21:20","BookieProtocol.java","46407","114941","161348","","322696"
"2012-04-02 12:38","BookieProtocol.java","8643","16494","25137","1","50274"
"2013-03-18 00:31","BookieProtocol.java","18697","118717","137414","4","274828"
"2016-04-05 08:45","BookieProtocol.java","45209","79872","125081","","250162"
"2013-02-12 11:16","BookieProtocol.java","18597","118404","137001","4","274002"
"2017-05-15 19:52","BookieProtocol.java","45779","111568","157347","","314694"
"2012-10-18 16:40","BookieProtocol.java","16219","66725","82944","2","165888"
"2017-06-05 22:25","BookieProtocol.java","46399","116830","163229","","326458"
"2012-05-25 17:13","BookieProtocol.java","9784","20702","30486","1","60972"
"2013-03-18 00:31","ResponseBuilder.java","187","400","587","4","1174"
"2017-05-16 00:31","ResponseBuilder.java","111735","78135","189870","","379740"
"2017-06-01 23:58","AbstractZkLedgerManager.java","2474","7131","9605","","19210"
"2017-06-12 17:20","AbstractZkLedgerManager.java","2914","9348","12262","","24524"
"2017-11-08 12:27","GarbageCollectorThread.java","37484","75613","113097","","226194"
"2017-07-07 05:11","ZkLedgerUnderreplicationManager.java","9973","51418","61391","","122782"
"2017-06-28 23:28","ZkLedgerUnderreplicationManager.java","9470","45894","55364","","110728"
"2017-06-01 23:58","ZkLedgerUnderreplicationManager.java","8899","41429","50328","","100656"
"2017-03-28 22:40","ZkLedgerUnderreplicationManager.java","6459","32485","38944","","77888"
"2017-05-25 14:23","DigestManager.java","361","2643","3004","","6008"
"2017-06-05 22:25","BookkeeperInternalCallbacks.java","3944","16932","20876","","41752"
"2017-08-02 00:49","BookkeeperInternalCallbacks.java","9319","46299","55618","","111236"
"2017-06-21 21:00","BookkeeperInternalCallbacks.java","4036","18378","22414","","44828"
"2017-06-05 22:13","BookkeeperInternalCallbacks.java","3703","16397","20100","","40200"
"2017-05-15 19:52","BookkeeperInternalCallbacks.java","2252","10598","12850","","25700"
"2017-03-28 22:35","BookkeeperInternalCallbacks.java","334","4926","5260","","10520"
"2012-07-23 23:39","LocalBookKeeper.java","12759","44641","57400","2","114800"
"2014-12-10 19:43","LocalBookKeeper.java","19200","158127","177327","","354654"
"2013-02-08 19:08","LocalBookKeeper.java","17094","126613","143707","4","287414"
"2012-05-10 14:47","LocalBookKeeper.java","10664","29913","40577","1","81154"
"2015-07-10 22:48","LocalBookKeeper.java","19231","160798","180029","","360058"
"2011-11-18 11:18","LocalBookKeeper.java","717","2005","2722","","5444"
"2017-05-26 12:38","LocalBookKeeper.java","40783","118473","159256","","318512"
"2017-06-01 11:31","LocalBookKeeper.java","40814","119418","160232","","320464"
"2017-06-01 23:58","LocalBookKeeper.java","40847","119414","160261","","320522"
"2013-01-14 16:59","LocalBookKeeper.java","16980","95786","112766","2","225532"
"2012-05-07 18:48","LedgerCache.java","12010","32890","44900","1","89800"
"2017-07-04 06:27","LedgerCache.java","40546","128689","169235","","338470"
"2012-03-20 12:51","LedgerCache.java","11724","29676","41400","1","82800"
"2017-05-16 00:31","LedgerCache.java","40457","118590","159047","","318094"
"2012-12-18 13:04","LedgerCache.java","17339","95317","112656","2","225312"
"2016-11-18 00:18","LedgerCache.java","40276","96544","136820","","273640"
"2016-04-08 19:43","BookKeeperTest.java","105061","5238","110299","","220598"
"2017-01-31 04:01","BookKeeperTest.java","110842","33529","144371","","288742"
"2017-05-15 19:52","BookKeeperTest.java","112343","43376","155719","","311438"
"2017-05-02 22:07","BookKeeperTest.java","111347","40026","151373","","302746"
"2017-05-16 00:31","LedgerDescriptorReadOnlyImpl.java","81360","81515","162875","","325750"
"2014-07-24 01:41","TestFencing.java","14466","120866","135332","","270664"
"2012-12-18 13:04","TestFencing.java","9117","61855","70972","2","141944"
"2014-02-05 22:43","TestFencing.java","14036","114678","128714","7","257428"
"2013-08-23 18:48","TestFencing.java","12497","106850","119347","5","238694"
"2017-05-15 19:52","DigestManager.java","54557","98117","152674","","305348"
"2017-05-25 14:23","DigestManager.java","54661","100503","155164","","310328"
"2017-01-31 04:01","DigestManager.java","54001","89215","143216","","286432"
"2017-06-30 00:12","PendingWriteLacOp.java","4415","21228","25643","","51286"
"2017-05-15 19:52","PendingWriteLacOp.java","2252","10598","12850","","25700"
"2017-07-07 05:11","Auditor.java","113496","77437","190933","","381866"
"2017-05-26 16:52","Auditor.java","112056","66225","178281","","356562"
"2016-09-10 21:01","Auditor.java","109171","35737","144908","","289816"
"2016-11-09 03:02","Auditor.java","110736","40970","151706","","303412"
"2016-03-08 07:18","Auditor.java","4206","26496","30702","","61404"
"2014-04-24 10:43","Auditor.java","422","3557","3979","7","7958"
"2014-06-02 11:54","Auditor.java","797","6070","6867","7","13734"
"2014-05-06 12:30","Auditor.java","494","4054","4548","7","9096"
"2014-05-23 18:48","Auditor.java","524","5008","5532","7","11064"
"2014-07-24 01:41","TestEntryLog.java","15439","125775","141214","","282428"
"2014-12-10 19:43","TestEntryLog.java","15853","135817","151670","","303340"
"2016-02-24 00:44","TestEntryLog.java","16321","142172","158493","","316986"
"2014-03-12 21:26","TestEntryLog.java","15123","122704","137827","7","275654"
"2012-10-18 16:40","TestEntryLog.java","9511","50639","60150","2","120300"
"2013-10-12 05:42","TestEntryLog.java","14358","113667","128025","6","256050"
"2017-05-16 00:31","TestEntryLog.java","48495","105324","153819","","307638"
"2017-07-07 08:19","TestEntryLog.java","49248","118050","167298","","334596"
"2016-12-21 01:48","LedgerCacheTest.java","79973","64692","144665","","289330"
"2013-02-12 06:00","LedgerCacheTest.java","1861","35595","37456","4","74912"
"2013-01-07 03:48","LedgerCacheTest.java","894","2536","3430","2","6860"
"2019-02-20 11:43","LedgerCacheTest.java","98066","421462","519528","","1039056"
"2013-08-12 19:01","LedgerCacheTest.java","3846","44976","48822","5","97644"
"2013-10-12 05:42","LedgerCacheTest.java","4958","47485","52443","6","104886"
"2017-05-16 00:31","LedgerCacheTest.java","80826","80873","161699","","323398"
"2013-12-02 18:45","LedgerCacheTest.java","5192","50589","55781","6","111562"
"2014-07-24 01:41","LedgerCacheTest.java","6927","60481","67408","","134816"
"2014-12-10 19:43","LedgerCacheTest.java","7565","70747","78312","","156624"
"2016-03-08 06:49","LedgerCacheTest.java","8550","77971","86521","","173042"
"2014-03-12 21:26","LedgerCacheTest.java","6377","57176","63553","7","127106"
"2017-05-09 23:06","GarbageCollectorThread.java","112298","63177","175475","","350950"
"2017-11-08 12:27","GarbageCollectorThread.java","126955","115963","242918","","485836"
"2017-03-28 22:39","GarbageCollectorThread.java","111840","60663","172503","","345006"
"2017-01-30 23:25","GarbageCollectorThread.java","111645","49503","161148","","322296"
"2016-05-04 15:55","GarbageCollectorThread.java","108631","30675","139306","","278612"
"2016-03-08 06:49","GarbageCollectorThread.java","5141","27276","32417","","64834"
"2016-02-24 00:44","GarbageCollectorThread.java","5052","26835","31887","","63774"
"2015-04-21 09:55","GarbageCollectorThread.java","3996","22138","26134","","52268"
"2014-01-15 15:58","GarbageCollectorThread.java","1618","5755","7373","6","14746"
"2013-10-22 07:44","GarbageCollectorThread.java","1327","2623","3950","6","7900"
"2017-05-09 23:06","GarbageCollectorThread.java","113204","69765","182969","","365938"
"2014-01-21 17:26","GarbageCollectorThread.java","2041","7723","9764","6","19528"
"2017-11-08 12:27","GarbageCollectorThread.java","126942","121632","248574","","497148"
"2017-03-28 22:39","GarbageCollectorThread.java","112748","67253","180001","","360002"
"2017-01-30 23:25","GarbageCollectorThread.java","112598","56138","168736","","337472"
"2016-05-04 15:55","GarbageCollectorThread.java","109630","37356","146986","","293972"
"2016-03-08 06:49","GarbageCollectorThread.java","6286","34103","40389","","80778"
"2016-02-24 00:44","GarbageCollectorThread.java","6233","33698","39931","","79862"
"2015-04-21 09:55","GarbageCollectorThread.java","5284","29108","34392","","68784"
"2013-10-30 16:23","GarbageCollectorThread.java","1513","4782","6295","6","12590"
"2017-06-05 22:25","ReadEntryProcessorV3.java","449","1898","2347","","4694"
"2016-12-21 01:48","LedgerCacheTest.java","80101","64598","144699","","289398"
"2013-02-12 06:00","LedgerCacheTest.java","1787","35299","37086","4","74172"
"2013-01-07 03:48","LedgerCacheTest.java","820","2240","3060","2","6120"
"2019-02-20 11:43","LedgerCacheTest.java","98217","421391","519608","","1039216"
"2013-08-12 19:01","LedgerCacheTest.java","3772","44680","48452","5","96904"
"2013-10-12 05:42","LedgerCacheTest.java","4886","47191","52077","6","104154"
"2017-05-16 00:31","LedgerCacheTest.java","80956","80781","161737","","323474"
"2013-12-02 18:45","LedgerCacheTest.java","5120","50295","55415","6","110830"
"2014-07-24 01:41","LedgerCacheTest.java","6863","60195","67058","","134116"
"2014-12-10 19:43","LedgerCacheTest.java","7508","70468","77976","","155952"
"2016-03-08 06:49","LedgerCacheTest.java","8494","77693","86187","","172374"
"2014-03-12 21:26","LedgerCacheTest.java","6311","56888","63199","7","126398"
"2012-12-03 15:04","InMemoryMetastoreCursor.java","945","3490","4435","2","8870"
"2013-04-04 11:21","InMemoryMetastoreCursor.java","6399","48532","54931","5","109862"
"2014-12-10 19:43","BookieJournalTest.java","2558","14431","16989","","33978"
"2017-05-15 19:52","BookieJournalTest.java","112434","60754","173188","","346376"
"2017-05-16 00:31","BookieJournalTest.java","112574","61312","173886","","347772"
"2017-05-04 20:58","AbstractZkLedgerManager.java","113297","70411","183708","","367416"
"2017-06-01 23:58","AbstractZkLedgerManager.java","114513","76284","190797","","381594"
"2017-06-12 17:20","AbstractZkLedgerManager.java","114680","78228","192908","","385816"
"2017-03-28 22:40","AbstractZkLedgerManager.java","112868","68135","181003","","362006"
"2016-02-09 08:23","AbstractZkLedgerManager.java","6218","33536","39754","","79508"
"2015-09-15 10:38","AbstractZkLedgerManager.java","6071","31144","37215","","74430"
"2016-02-23 19:16","AbstractZkLedgerManager.java","6243","33899","40142","","80284"
"2014-05-12 08:10","AbstractZkLedgerManager.java","3691","14908","18599","7","37198"
"2014-01-17 18:13","AbstractZkLedgerManager.java","1851","6897","8748","6","17496"
"2017-06-05 20:30","LedgerDirsManager.java","81835","83018","164853","","329706"
"2017-01-30 23:25","LedgerDirsManager.java","80185","63332","143517","","287034"
"2017-03-28 22:35","LedgerDirsManager.java","80269","74147","154416","","308832"
"2013-12-02 18:45","LedgerDirsManager.java","4134","47534","51668","6","103336"
"2014-01-15 15:58","LedgerDirsManager.java","4214","47958","52172","6","104344"
"2017-06-28 23:24","LedgerDirsManager.java","81983","86210","168193","","336386"
"2017-07-07 08:19","LedgerDirsManager.java","82244","92267","174511","","349022"
"2014-01-21 17:26","LedgerDirsManager.java","4407","49696","54103","6","108206"
"2013-10-02 07:01","LedgerDirsManager.java","2949","42746","45695","5","91390"
"2014-08-02 20:02","LedgerDirsManager.java","6190","64199","70389","","140778"
"2017-05-16 00:31","BookieProtocol.java","48023","106379","154402","","308804"
"2017-06-01 21:20","BookieProtocol.java","48654","109337","157991","","315982"
"2013-03-18 00:31","BookieProtocol.java","13315","105484","118799","4","237598"
"2016-04-05 08:45","BookieProtocol.java","47294","74106","121400","","242800"
"2013-02-12 11:16","BookieProtocol.java","13191","105147","118338","4","236676"
"2017-05-15 19:52","BookieProtocol.java","47971","105909","153880","","307760"
"2012-10-18 16:40","BookieProtocol.java","9845","52500","62345","2","124690"
"2017-06-05 22:25","BookieProtocol.java","48653","111233","159886","","319772"
"2012-05-25 17:13","BookieProtocol.java","1469","4536","6005","1","12010"
"2014-07-24 01:41","ConfigurationTest.java","15440","125802","141242","","282484"
"2016-07-31 07:53","ConfigurationTest.java","47821","75021","122842","","245684"
"2017-08-02 00:49","AbstractConfiguration.java","9309","41254","50563","","101126"
"2017-05-02 23:04","AbstractConfiguration.java","765","2586","3351","","6702"
"2014-02-05 22:43","TestBenchmark.java","8943","63909","72852","7","145704"
"2016-02-09 08:12","TestBenchmark.java","10796","86332","97128","","194256"
"2015-07-10 22:48","LocalBookKeeper.java","681","3321","4002","","8004"
"2017-05-26 12:38","LocalBookKeeper.java","113512","52275","165787","","331574"
"2017-06-01 11:31","LocalBookKeeper.java","113576","53253","166829","","333658"
"2017-06-01 23:58","LocalBookKeeper.java","114338","53978","168316","","336632"
"2017-06-12 17:20","AbstractZkLedgerManager.java","462","2239","2701","","5402"
"2014-02-05 22:43","BookieClientTest.java","18694","140947","159641","7","319282"
"2013-10-12 05:42","BookieClientTest.java","18238","135222","153460","6","306920"
"2017-06-21 19:58","BookieClientTest.java","41175","120584","161759","","323518"
"2014-07-25 00:34","BookieClientTest.java","19101","152934","172035","","344070"
"2017-03-28 22:35","BookieClientTest.java","40847","111179","152026","","304052"
"2016-12-17 02:39","BookieClientTest.java","40827","99442","140269","","280538"
"2017-05-15 19:52","BookieClientTest.java","41020","115106","156126","","312252"
"2014-12-10 19:43","BookieClientTest.java","19127","156766","175893","","351786"
"2012-01-13 18:06","BookieClientTest.java","1183","5226","6409","1","12818"
"2015-10-06 10:05","BookieClientTest.java","19214","160119","179333","","358666"
"2014-07-24 01:41","BookieClientTest.java","18947","146958","165905","","331810"
"2017-07-04 06:27","ServerConfiguration.java","115763","63805","179568","","359136"
"2016-04-14 00:51","ServerConfiguration.java","106929","13709","120638","","241276"
"2015-01-16 15:57","ServerConfiguration.java","664","3636","4300","","8600"
"2016-03-08 06:49","ServerConfiguration.java","2283","9689","11972","","23944"
"2016-01-26 22:11","ServerConfiguration.java","1927","8319","10246","","20492"
"2016-04-05 18:47","ServerConfiguration.java","106903","13633","120536","","241072"
"2016-04-27 09:55","ServerConfiguration.java","106990","14282","121272","","242544"
"2015-04-21 09:55","ServerConfiguration.java","839","4252","5091","","10182"
"2015-01-12 15:18","ServerConfiguration.java","655","2689","3344","","6688"
"2015-04-21 10:02","ServerConfiguration.java","852","4298","5150","","10300"
"2017-05-15 19:52","ServerConfiguration.java","113824","51438","165262","","330524"
"2017-03-22 22:54","ServerConfiguration.java","112569","42125","154694","","309388"
"2017-03-23 00:48","ServerConfiguration.java","112574","42182","154756","","309512"
"2017-01-31 02:11","ServerConfiguration.java","112460","35647","148107","","296214"
"2016-04-05 08:45","ServerConfiguration.java","106892","13380","120272","","240544"
"2016-11-09 03:02","ServerConfiguration.java","112350","28365","140715","","281430"
"2016-11-30 00:02","ServerConfiguration.java","112411","29108","141519","","283038"
"2017-06-05 20:30","ServerConfiguration.java","114972","56137","171109","","342218"
"2016-09-10 20:27","ServerConfiguration.java","110714","22940","133654","","267308"
"2017-08-02 00:49","ServerConfiguration.java","119520","85768","205288","","410576"
"2017-10-03 12:31","ServerConfiguration.java","130127","86532","216659","","433318"
"2017-08-16 03:37","ServerConfiguration.java","121135","94016","215151","","430302"
"2017-05-26 12:38","ServerConfiguration.java","114040","53970","168010","","336020"
"2017-07-07 08:19","ServerConfiguration.java","115807","65812","181619","","363238"
"2017-06-28 23:24","ServerConfiguration.java","115314","59523","174837","","349674"
"2017-11-08 12:27","ServerConfiguration.java","132210","106489","238699","","477398"
"2017-05-25 14:23","LedgerFragmentReplicator.java","112050","66165","178215","","356430"
"2014-02-21 19:01","LedgerFragmentReplicator.java","201","1364","1565","7","3130"
"2016-09-10 21:01","LedgerFragmentReplicator.java","109171","35737","144908","","289816"
"2014-04-24 10:43","ReplicationException.java","11090","98264","109354","7","218708"
"2012-08-27 16:55","ReplicationException.java","802","6693","7495","2","14990"
"2017-07-07 05:11","ReplicationException.java","61519","109499","171018","","342036"
"2017-01-31 04:01","BookkeeperInternalCallbacks.java","40292","109661","149953","","299906"
"2011-11-28 19:25","BookkeeperInternalCallbacks.java","3825","10198","14023","","28046"
"2017-06-05 22:25","BookkeeperInternalCallbacks.java","40519","122876","163395","","326790"
"2012-07-05 07:10","BookkeeperInternalCallbacks.java","12827","43656","56483","2","112966"
"2014-01-17 18:13","BookkeeperInternalCallbacks.java","18986","143169","162155","6","324310"
"2017-08-02 00:49","BookkeeperInternalCallbacks.java","41168","147517","188685","","377370"
"2017-06-21 21:00","BookkeeperInternalCallbacks.java","40535","124246","164781","","329562"
"2017-06-05 22:13","BookkeeperInternalCallbacks.java","40516","122579","163095","","326190"
"2014-02-05 22:43","BookkeeperInternalCallbacks.java","19159","145041","164200","7","328400"
"2017-05-15 19:52","BookkeeperInternalCallbacks.java","40437","118152","158589","","317178"
"2017-03-28 22:35","BookkeeperInternalCallbacks.java","40277","114238","154515","","309030"
"2017-05-16 00:31","LedgerCacheImpl.java","2889","24754","27643","","55286"
"2017-06-01 23:58","LedgerCacheImpl.java","3881","28521","32402","","64804"
"2017-07-04 06:27","LedgerCacheImpl.java","4948","36823","41771","","83542"
"2017-01-31 04:01","LedgerCacheImpl.java","779","13880","14659","","29318"
"2013-10-14 16:43","BookieLedgerIndexTest.java","6004","51872","57876","6","115752"
"2012-12-20 06:48","BookieFailureTest.java","16896","82876","99772","2","199544"
"2012-08-13 11:38","BookieFailureTest.java","12600","40712","53312","2","106624"
"2014-07-24 01:41","BookieFailureTest.java","19972","139606","159578","","319156"
"2012-06-19 12:39","BookieFailureTest.java","10425","23659","34084","2","68168"
"2016-02-09 08:39","BookKeeperTest.java","237","2133","2370","","4740"
"2016-04-08 19:43","BookKeeperTest.java","105294","7367","112661","","225322"
"2017-01-31 04:01","BookKeeperTest.java","111008","35591","146599","","293198"
"2017-05-15 19:52","BookKeeperTest.java","112496","45425","157921","","315842"
"2017-05-02 22:07","BookKeeperTest.java","111510","42085","153595","","307190"
"2016-07-14 23:02","FileSystemUpgrade.java","46004","78225","124229","","248458"
"2017-03-22 22:54","FileSystemUpgrade.java","46132","99632","145764","","291528"
"2013-02-08 19:08","FileSystemUpgrade.java","17954","113657","131611","4","263222"
"2012-12-08 11:18","FileSystemUpgrade.java","16620","74089","90709","2","181418"
"2012-09-07 07:26","FileSystemUpgrade.java","13104","50646","63750","2","127500"
"2014-09-18 06:57","FileSystemUpgrade.java","20581","144552","165133","","330266"
"2012-05-10 14:47","FileSystemUpgrade.java","8924","14357","23281","1","46562"
"2017-05-15 19:52","LedgerHandle.java","80589","80196","160785","","321570"
"2017-05-02 22:07","LedgerHandle.java","80026","77279","157305","","314610"
"2017-03-23 15:55","LedgerHandle.java","79913","71540","151453","","302906"
"2016-09-10 21:01","LedgerHandle.java","79671","54011","133682","","267364"
"2016-07-11 23:01","LedgerHandle.java","78417","48653","127070","","254140"
"2013-04-26 18:38","LedgerHandle.java","2823","37734","40557","5","81114"
"2013-10-14 18:32","LedgerHandle.java","4666","47264","51930","6","103860"
"2014-02-05 22:43","LedgerHandle.java","5802","53576","59378","7","118756"
"2014-02-21 19:01","LedgerHandle.java","5936","54873","60809","7","121618"
"2017-05-17 08:57","LedgerHandle.java","80681","80765","161446","","322892"
"2017-05-25 14:23","LedgerHandle.java","80713","82602","163315","","326630"
"2017-06-21 19:50","LedgerHandle.java","81597","86417","168014","","336028"
"2017-06-21 21:00","LedgerHandle.java","81602","87205","168807","","337614"
"2017-06-01 23:58","LedgerHandle.java","81412","84212","165624","","331248"
"2014-01-21 05:19","LedgerHandle.java","4996","51967","56963","6","113926"
"2014-09-18 06:47","LedgerHandle.java","6842","68835","75677","","151354"
"2014-12-09 19:57","LedgerHandle.java","6960","70046","77006","","154012"
"2017-07-04 06:27","LedgerHandle.java","81852","91887","173739","","347478"
"2017-06-30 00:12","LedgerHandle.java","81750","89824","171574","","343148"
"2014-05-30 14:01","LedgerHandle.java","6167","59038","65205","7","130410"
"2014-05-30 15:07","LedgerHandle.java","6187","59097","65284","7","130568"
"2014-01-17 18:13","LedgerHandle.java","4923","50998","55921","6","111842"
"2013-01-07 12:25","LedgerHandle.java","553","2356","2909","2","5818"
"2016-02-09 08:32","LedgerHandle.java","8042","76559","84601","","169202"
"2016-03-16 05:03","LedgerHandle.java","78226","44004","122230","","244460"
"2015-10-22 09:22","LedgerHandle.java","7928","75410","83338","","166676"
"2015-10-06 10:05","LedgerHandle.java","7902","74328","82230","","164460"
"2017-01-31 04:01","LedgerHandle.java","79832","71093","150925","","301850"
"2015-04-21 09:39","LedgerHandle.java","7259","72514","79773","","159546"
"2015-10-06 11:12","LedgerHandle.java","7905","74571","82476","","164952"
"2014-12-05 14:10","LedgerHandle.java","6919","69556","76475","","152950"
"2017-07-28 20:12","BKException.java","115620","88717","204337","","408674"
"2016-07-11 22:53","BKException.java","109800","37597","147397","","294794"
"2017-05-02 23:04","BKException.java","113207","69792","182999","","365998"
"2014-02-21 19:01","BKException.java","3271","10676","13947","7","27894"
"2017-08-02 00:49","BKException.java","118126","104835","222961","","445922"
"2015-09-15 10:38","BKException.java","5967","30537","36504","","73008"
"2017-01-31 04:01","BKException.java","112613","62342","174955","","349910"
"2015-10-06 10:48","BKException.java","5975","31095","37070","","74140"
"2015-10-22 09:22","BKException.java","6002","31952","37954","","75908"
"2017-05-25 14:23","LedgerFragmentReplicator.java","112098","65050","177148","","354296"
"2016-09-10 21:01","LedgerFragmentReplicator.java","109160","34563","143723","","287446"
"2017-01-31 04:01","BookKeeperTest.java","6636","29146","35782","","71564"
"2017-05-15 19:52","BookKeeperTest.java","8157","39013","47170","","94340"
"2017-05-02 22:07","BookKeeperTest.java","7060","35562","42622","","85244"
"2012-03-31 10:58","CloseTest.java","11840","31479","43319","1","86638"
"2017-07-07 05:11","Auditor.java","114996","85235","200231","","400462"
"2014-02-05 22:43","Auditor.java","3185","9483","12668","7","25336"
"2017-05-26 16:52","Auditor.java","113771","74238","188009","","376018"
"2016-09-10 21:01","Auditor.java","111170","44034","155204","","310408"
"2016-11-09 03:02","Auditor.java","112623","49155","161778","","323556"
"2016-03-08 07:18","Auditor.java","6344","34932","41276","","82552"
"2014-04-24 10:43","Auditor.java","3560","12993","16553","7","33106"
"2014-06-02 11:54","Auditor.java","3800","15371","19171","7","38342"
"2014-05-06 12:30","Auditor.java","3615","13473","17088","7","34176"
"2014-05-23 18:48","Auditor.java","3636","14418","18054","7","36108"
"2017-05-15 19:52","BookKeeperTest.java","2252","10598","12850","","25700"
"2017-05-02 22:07","BookKeeperTest.java","734","6726","7460","","14920"
"2016-03-08 06:49","ReadOnlyBookieTest.java","1660","7899","9559","","19118"
"2016-04-14 00:51","ReadOnlyBookieTest.java","106323","11936","118259","","236518"
"2016-04-07 21:39","ReadOnlyBookieTest.java","106310","11882","118192","","236384"
"2014-12-10 19:43","UpgradeTest.java","15304","133728","149032","","298064"
"2012-09-07 07:26","UpgradeTest.java","5696","36551","42247","2","84494"
"2017-05-15 19:52","UpgradeTest.java","48676","103547","152223","","304446"
"2012-11-23 11:49","UpgradeTest.java","9363","57435","66798","2","133596"
"2013-10-11 08:36","UpgradeTest.java","13672","110900","124572","6","249144"
"2013-10-12 05:42","UpgradeTest.java","13776","111545","125321","6","250642"
"2016-02-09 08:12","FlatLedgerManager.java","20194","160273","180467","","360934"
"2012-03-31 09:13","FlatLedgerManager.java","9292","22117","31409","1","62818"
"2013-04-04 11:21","FlatLedgerManager.java","18700","125150","143850","5","287700"
"2012-12-24 05:50","FlatLedgerManager.java","17146","88859","106005","2","212010"
"2019-02-20 11:43","IndexInMemPageMgr.java","141104","404494","545598","","1091196"
"2017-06-01 23:58","IndexInMemPageMgr.java","115213","58029","173242","","346484"
"2016-04-05 08:50","IndexInMemPageMgr.java","107306","15863","123169","","246338"
"2012-12-24 05:50","LedgerCacheImpl.java","796","904","1700","2","3400"
"2016-11-18 00:18","LedgerCacheImpl.java","80536","58826","139362","","278724"
"2017-05-16 00:31","LedgerCacheImpl.java","81360","81515","162875","","325750"
"2013-10-11 08:36","LedgerCacheImpl.java","5517","47611","53128","6","106256"
"2017-06-01 23:58","LedgerCacheImpl.java","82096","85026","167122","","334244"
"2014-08-02 20:02","LedgerCacheImpl.java","7815","67929","75744","","151488"
"2017-07-04 06:27","LedgerCacheImpl.java","82514","92679","175193","","350386"
"2017-01-31 04:01","LedgerCacheImpl.java","80590","71981","152571","","305142"
"2012-03-15 10:37","BookieZKExpireTest.java","8763","22626","31389","1","62778"
"2013-03-25 06:27","BookieZKExpireTest.java","17871","126555","144426","4","288852"
"2012-12-15 03:08","BookieZKExpireTest.java","16367","89984","106351","2","212702"
"2014-12-10 19:43","BookieZKExpireTest.java","19127","156766","175893","","351786"
"2016-01-26 22:11","BookieZKExpireTest.java","19226","162090","181316","","362632"
"2014-01-21 05:19","PerChannelBookieClient.java","420","1852","2272","6","4544"
"2017-06-30 00:12","PerChannelBookieClient.java","114000","76535","190535","","381070"
"2014-05-27 13:56","PerChannelBookieClient.java","2216","9166","11382","7","22764"
"2017-07-04 06:27","PerChannelBookieClient.java","114137","78633","192770","","385540"
"2017-01-31 04:01","PerChannelBookieClient.java","111595","57317","168912","","337824"
"2015-10-06 10:05","PerChannelBookieClient.java","4770","25657","30427","","60854"
"2016-04-05 18:47","PerChannelBookieClient.java","108461","31645","140106","","280212"
"2017-04-15 13:58","PerChannelBookieClient.java","111837","63251","175088","","350176"
"2017-05-15 19:52","PerChannelBookieClient.java","112603","66671","179274","","358548"
"2016-04-05 08:45","PerChannelBookieClient.java","108453","31395","139848","","279696"
"2017-07-28 20:12","PerChannelBookieClient.java","115043","84133","199176","","398352"
"2017-01-31 02:14","PerChannelBookieClient.java","111586","51839","163425","","326850"
"2017-03-28 22:35","PerChannelBookieClient.java","111691","62005","173696","","347392"
"2017-03-23 00:48","PerChannelBookieClient.java","111695","57757","169452","","338904"
"2014-07-25 00:34","PerChannelBookieClient.java","2992","16807","19799","","39598"
"2017-08-02 00:49","PerChannelBookieClient.java","117600","100302","217902","","435804"
"2017-06-21 19:58","PerChannelBookieClient.java","113800","73191","186991","","373982"
"2017-06-01 23:58","PerChannelBookieClient.java","113538","70799","184337","","368674"
"2014-02-21 19:01","PerChannelBookieClient.java","1770","5168","6938","7","13876"
"2014-02-05 22:43","PerChannelBookieClient.java","1587","3822","5409","7","10818"
"2017-04-20 19:55","PerChannelBookieClient.java","111841","63276","175117","","350234"
"2017-06-01 23:58","ReadEntryProcessorV3.java","1160","3935","5095","","10190"
"2017-06-05 22:25","ReadEntryProcessorV3.java","1604","5828","7432","","14864"
"2017-01-31 04:01","BookkeeperInternalCallbacks.java","42173","105169","147342","","294684"
"2017-06-05 22:25","BookkeeperInternalCallbacks.java","42683","118667","161350","","322700"
"2012-07-05 07:10","BookkeeperInternalCallbacks.java","11198","35654","46852","2","93704"
"2014-01-17 18:13","BookkeeperInternalCallbacks.java","19187","136997","156184","6","312368"
"2017-08-02 00:49","BookkeeperInternalCallbacks.java","43374","143350","186724","","373448"
"2017-06-21 21:00","BookkeeperInternalCallbacks.java","42709","120047","162756","","325512"
"2017-06-05 22:13","BookkeeperInternalCallbacks.java","42668","118358","161026","","322052"
"2014-02-05 22:43","BookkeeperInternalCallbacks.java","19520","139029","158549","7","317098"
"2017-05-15 19:52","BookkeeperInternalCallbacks.java","42545","113887","156432","","312864"
"2017-03-28 22:35","BookkeeperInternalCallbacks.java","42175","109763","151938","","303876"
"2012-09-14 15:42","LedgerLayout.java","13866","61818","75684","2","151368"
"2012-06-19 12:39","LedgerLayout.java","10996","29863","40859","2","81718"
"2012-09-07 07:04","LedgerLayout.java","13543","60834","74377","2","148754"
"2017-06-01 23:58","LedgerLayout.java","42667","117202","159869","","319738"
"2016-07-14 23:02","LedgerLayout.java","42049","84054","126103","","252206"
"2017-08-02 00:49","ServerConfiguration.java","5371","23577","28948","","57896"
"2017-10-03 12:31","ServerConfiguration.java","30576","38939","69515","","139030"
"2017-08-16 03:37","ServerConfiguration.java","7866","32705","40571","","81142"
"2017-07-07 08:19","ServerConfiguration.java","141","2104","2245","","4490"
"2017-11-08 12:27","ServerConfiguration.java","34947","61184","96131","","192262"
"2013-10-02 06:40","MSLedgerManagerFactory.java","1079","8030","9109","5","18218"
"2017-06-01 23:58","MSLedgerManagerFactory.java","112840","80925","193765","","387530"
"2015-09-15 10:38","MSLedgerManagerFactory.java","6053","37440","43493","","86986"
"2017-03-28 22:40","MSLedgerManagerFactory.java","111253","72834","184087","","368174"
"2014-01-17 18:13","MSLedgerManagerFactory.java","2537","13897","16434","6","32868"
"2014-05-12 08:10","MSLedgerManagerFactory.java","4114","21645","25759","7","51518"
"2017-06-01 23:58","LedgerLayout.java","68362","94945","163307","","326614"
"2016-07-14 23:02","LedgerLayout.java","65870","59923","125793","","251586"
"2017-05-16 00:31","BookieProtocol.java","111707","77894","189601","","379202"
"2017-06-01 21:20","BookieProtocol.java","112394","80908","193302","","386604"
"2016-04-05 08:45","BookieProtocol.java","109148","43791","152939","","305878"
"2017-05-15 19:52","BookieProtocol.java","111613","77382","188995","","377990"
"2017-06-05 22:25","BookieProtocol.java","112625","83036","195661","","391322"
"2016-03-16 04:51","AutoRecoveryMain.java","109530","33523","143053","","286106"
"2014-03-10 03:14","AutoRecoveryMain.java","3379","11458","14837","7","29674"
"2014-04-24 10:43","AutoRecoveryMain.java","3452","12779","16231","7","32462"
"2014-09-06 07:58","AutoRecoveryMain.java","4775","25183","29958","","59916"
"2013-12-06 07:39","AutoRecoveryMain.java","1547","5492","7039","6","14078"
"2017-06-21 19:58","BookieClientTest.java","115554","61130","176684","","353368"
"2017-03-28 22:35","BookieClientTest.java","112996","49495","162491","","324982"
"2016-12-17 02:39","BookieClientTest.java","112831","37613","150444","","300888"
"2017-05-15 19:52","BookieClientTest.java","114182","54435","168617","","337234"
"2014-12-10 19:43","BookieClientTest.java","1394","5200","6594","","13188"
"2015-10-06 10:05","BookieClientTest.java","2400","9472","11872","","23744"
"2017-05-15 19:52","WriteEntryProcessor.java","112499","45680","158179","","316358"
"2017-05-15 19:52","LedgerHandle.java","4272","29539","33811","","67622"
"2017-05-02 22:07","LedgerHandle.java","2958","25871","28829","","57658"
"2017-03-23 15:55","LedgerHandle.java","2564","19851","22415","","44830"
"2017-05-17 08:57","LedgerHandle.java","4475","30219","34694","","69388"
"2017-05-25 14:23","LedgerHandle.java","4527","32076","36603","","73206"
"2017-06-21 19:50","LedgerHandle.java","5920","36400","42320","","84640"
"2017-06-21 21:00","LedgerHandle.java","5935","37198","43133","","86266"
"2017-06-01 23:58","LedgerHandle.java","5430","33890","39320","","78640"
"2017-07-04 06:27","LedgerHandle.java","6475","42170","48645","","97290"
"2017-06-30 00:12","LedgerHandle.java","6270","40004","46274","","92548"
"2017-01-31 04:01","LedgerHandle.java","2405","19326","21731","","43462"
"2017-03-28 22:40","ZkLedgerIdGenerator.java","111394","41588","152982","","305964"
"2016-02-09 08:12","ZkLedgerIdGenerator.java","290","2532","2822","","5644"
"2017-06-01 23:58","ZkLedgerIdGenerator.java","113588","50286","163874","","327748"
"2017-05-02 23:04","ZkLedgerIdGenerator.java","111956","43971","155927","","311854"
"2017-08-02 00:49","BookieNettyServer.java","118145","104804","222949","","445898"
"2017-06-01 09:47","BookieNettyServer.java","113715","74705","188420","","376840"
"2013-10-11 16:18","BookieNettyServer.java","913","1309","2222","6","4444"
"2017-05-15 19:52","BookieNettyServer.java","113553","71578","185131","","370262"
"2016-09-10 20:27","BookieNettyServer.java","111078","43715","154793","","309586"
"2017-01-31 02:14","BookieNettyServer.java","112598","56808","169406","","338812"
"2016-04-05 08:45","BookieNettyServer.java","109546","36445","145991","","291982"
"2017-03-23 00:48","BookieNettyServer.java","112693","62712","175405","","350810"
"2016-04-05 18:47","BookieNettyServer.java","109548","36689","146237","","292474"
"2014-01-21 05:05","BookieNettyServer.java","1880","6923","8803","6","17606"
"2017-05-15 19:52","AuthHandler.java","8150","39276","47426","","94852"
"2017-04-15 13:58","AuthHandler.java","7037","35509","42546","","85092"
"2016-04-10 05:58","AuthHandler.java","43","321","364","","728"
"2017-01-31 02:14","AuthHandler.java","6577","23888","30465","","60930"
"2016-04-27 21:11","AuthHandler.java","247","1051","1298","","2596"
"2017-08-02 00:49","AuthHandler.java","14572","74332","88904","","177808"
"2017-06-01 23:58","AuthHandler.java","9287","43606","52893","","105786"
"2017-06-28 23:24","LedgerDirsManager.java","451","3495","3946","","7892"
"2017-07-07 08:19","LedgerDirsManager.java","1234","10074","11308","","22616"
"2015-07-10 22:48","ZooKeeperUtil.java","15948","139059","155007","","310014"
"2014-08-18 23:00","ZooKeeperUtil.java","15614","134385","149999","","299998"
"2012-06-05 08:00","ZooKeeperUtil.java","1014","3476","4490","1","8980"
"2014-12-10 19:43","ZooKeeperUtil.java","15850","136321","152171","","304342"
"2013-03-25 06:27","ZooKeeperUtil.java","13144","104660","117804","4","235608"
"2016-04-05 21:52","ZooKeeperUtil.java","47413","73450","120863","","241726"
"2012-11-21 12:24","ZooKeeperUtil.java","9931","59827","69758","2","139516"
"2017-06-05 20:30","LedgerDirsManager.java","3920","21956","25876","","51752"
"2017-03-28 22:35","LedgerDirsManager.java","839","11570","12409","","24818"
"2017-06-28 23:24","LedgerDirsManager.java","4312","25392","29704","","59408"
"2017-07-07 08:19","LedgerDirsManager.java","4946","31822","36768","","73536"
"2013-08-21 13:19","BookKeeperAdmin.java","13723","113668","127391","5","254782"
"2017-10-17 09:32","BookKeeperAdmin.java","51249","135970","187219","","374438"
"2017-06-01 23:58","BookKeeperAdmin.java","48601","109870","158471","","316942"
"2017-04-11 20:19","BookKeeperAdmin.java","47541","102325","149866","","299732"
"2014-02-21 19:01","BookKeeperAdmin.java","15181","122587","137768","7","275536"
"2014-02-05 22:43","BookKeeperAdmin.java","15124","121367","136491","7","272982"
"2017-07-07 05:11","BookKeeperAdmin.java","48731","118915","167646","","335292"
"2013-02-26 04:12","BookKeeperAdmin.java","13216","105465","118681","4","237362"
"2016-11-09 03:05","BookKeeperAdmin.java","47434","83928","131362","","262724"
"2016-11-30 00:07","BookKeeperAdmin.java","47436","84594","132030","","264060"
"2016-09-10 21:01","BookKeeperAdmin.java","47360","80169","127529","","255058"
"2016-07-14 23:02","BookKeeperAdmin.java","47355","76094","123449","","246898"
"2016-10-13 09:27","BookKeeperAdmin.java","47434","83594","131028","","262056"
"2012-11-30 04:54","BookKeeperAdmin.java","10453","63858","74311","2","148622"
"2012-07-18 17:00","BookKeeperAdmin.java","5526","20042","25568","2","51136"
"2013-02-08 19:08","BookKeeperAdmin.java","12399","104620","117019","4","234038"
"2016-03-16 05:03","BookKeeperAdmin.java","47268","71515","118783","","237566"
"2016-03-08 07:18","BookKeeperAdmin.java","16350","144883","161233","","322466"
"2014-12-06 08:03","BookKeeperAdmin.java","15735","137199","152934","","305868"
"2012-09-03 18:54","BookKeeperAdmin.java","6888","39447","46335","2","92670"
"2014-04-24 10:43","BookKeeperAdmin.java","15192","124570","139762","7","279524"
"2012-10-05 16:24","BookKeeperAdmin.java","9262","48890","58152","2","116304"
"2012-09-07 07:04","BookKeeperAdmin.java","6965","40990","47955","2","95910"
"2014-09-06 07:51","BookKeeperAdmin.java","15660","135987","151647","","303294"
"2012-08-19 11:39","BookKeeperAdmin.java","6668","33368","40036","2","80072"
"2012-05-10 14:47","BookKeeperAdmin.java","1071","3022","4093","1","8186"
"2013-05-10 12:45","BookKeeperAdmin.java","13500","107570","121070","5","242140"
"2012-08-24 22:44","BookKeeperAdmin.java","6670","34262","40932","2","81864"
"2017-06-21 19:58","PendingReadOp.java","48652","112051","160703","","321406"
"2017-06-05 21:48","PendingReadOp.java","48602","110613","159215","","318430"
"2017-06-05 22:13","PendingReadOp.java","48598","111022","159620","","319240"
"2017-06-01 11:42","PendingReadOp.java","48073","109375","157448","","314896"
"2017-06-01 22:39","PendingReadOp.java","48621","109505","158126","","316252"
"2013-09-11 00:34","PendingReadOp.java","13757","113797","127554","5","255108"
"2014-02-05 22:43","PendingReadOp.java","15124","121367","136491","7","272982"
"2013-03-25 18:02","PendingReadOp.java","13437","106454","119891","4","239782"
"2017-05-15 19:52","PendingReadOp.java","47939","106015","153954","","307908"
"2012-11-07 17:27","PendingReadOp.java","10263","58984","69247","2","138494"
"2015-04-21 09:17","PendingReadOp.java","15905","139609","155514","","311028"
"2012-12-03 10:46","PendingReadOp.java","10458","64547","75005","2","150010"
"2016-02-09 08:39","PendingReadOp.java","16245","143288","159533","","319066"
"2016-02-09 08:32","PendingReadOp.java","16245","143231","159476","","318952"
"2012-12-13 13:07","PendingReadOp.java","10854","66765","77619","2","155238"
"2017-07-04 06:27","PendingReadOp.java","48734","117238","165972","","331944"
"2014-01-21 05:19","PendingReadOp.java","14755","120195","134950","6","269900"
"2016-11-30 00:19","NoSystemPropertiesConfigurationTest.java","5579","19339","24918","","49836"
"2017-05-15 19:52","AuthHandler.java","8164","39012","47176","","94352"
"2017-04-15 13:58","AuthHandler.java","7043","35237","42280","","84560"
"2017-01-31 02:14","AuthHandler.java","6581","23614","30195","","60390"
"2016-04-27 21:11","AuthHandler.java","205","731","936","","1872"
"2017-08-02 00:49","AuthHandler.java","14670","74152","88822","","177644"
"2017-06-01 23:58","AuthHandler.java","9310","43351","52661","","105322"
"2017-05-16 13:20","BookieProtoEncoding.java","114333","55011","169344","","338688"
"2017-05-16 00:31","BookieProtoEncoding.java","114331","55002","169333","","338666"
"2017-06-01 21:20","BookieProtoEncoding.java","115044","58042","173086","","346172"
"2017-05-17 08:57","BookieProtoEncoding.java","114351","55081","169432","","338864"
"2016-04-05 08:45","BookieProtoEncoding.java","107313","16440","123753","","247506"
"2017-05-15 19:52","BookieProtoEncoding.java","114182","54435","168617","","337234"
"2017-06-05 22:25","BookieProtoEncoding.java","115485","60380","175865","","351730"
"2014-01-22 14:35","LedgerDeleteTest.java","2732","14672","17404","6","34808"
"2016-03-08 06:49","LedgerDeleteTest.java","6121","39820","45941","","91882"
"2014-07-24 01:41","LedgerDeleteTest.java","4302","22134","26436","","52872"
"2012-10-05 16:24","LedgerFragment.java","3887","20494","24381","2","48762"
"2012-09-04 10:39","LedgerFragment.java","1064","10705","11769","2","23538"
"2012-09-12 20:34","LedgerFragment.java","1356","13079","14435","2","28870"
"2012-11-30 04:54","LedgerFragment.java","5312","35696","41008","2","82016"
"2014-02-05 22:43","LedgerFragment.java","11012","94234","105246","7","210492"
"2017-05-15 19:52","BenchBookie.java","112499","45680","158179","","316358"
"2016-07-14 23:02","BenchBookie.java","105839","9683","115522","","231044"
"2017-06-01 23:58","EntryLogger.java","112764","80293","193057","","386114"
"2014-01-21 17:26","EntryLogger.java","2775","14768","17543","6","35086"
"2013-10-02 06:23","EntryLogger.java","805","7116","7921","5","15842"
"2014-01-22 14:35","EntryLogger.java","2909","15278","18187","6","36374"
"2017-11-08 12:27","EntryLogger.java","124608","125609","250217","","500434"
"2013-10-22 07:44","EntryLogger.java","2071","9678","11749","6","23498"
"2017-01-31 02:11","EntryLogger.java","111005","60914","171919","","343838"
"2017-03-23 00:48","EntryLogger.java","111097","67427","178524","","357048"
"2016-07-14 23:02","EntryLogger.java","109632","44631","154263","","308526"
"2016-02-24 00:44","EntryLogger.java","6221","39997","46218","","92436"
"2015-04-21 10:02","EntryLogger.java","5312","35480","40792","","81584"
"2015-04-21 09:44","EntryLogger.java","5300","35284","40584","","81168"
"2016-04-14 00:51","ReadOnlyBookieTest.java","104791","4165","108956","","217912"
"2016-04-07 21:39","ReadOnlyBookieTest.java","104778","4111","108889","","217778"
"2013-02-08 19:08","ZooKeeperWatcherBase.java","4703","52900","57603","4","115206"
"2014-08-18 23:00","ZooKeeperWatcherBase.java","9276","85181","94457","","188914"
"2015-07-10 22:48","ZooKeeperWatcherBase.java","9923","90168","100091","","200182"
"2017-06-01 23:58","ZooKeeperWatcherBase.java","75296","92541","167837","","335674"
"2017-06-05 20:30","LedgerDirsManager.java","3470","10775","14245","","28490"
"2017-06-28 23:24","LedgerDirsManager.java","3878","14227","18105","","36210"
"2017-07-07 08:19","LedgerDirsManager.java","4580","20725","25305","","50610"
"2017-05-16 13:20","BookieProtoEncoding.java","111707","77901","189608","","379216"
"2017-05-16 00:31","BookieProtoEncoding.java","111707","77894","189601","","379202"
"2017-06-01 21:20","BookieProtoEncoding.java","112394","80908","193302","","386604"
"2017-05-17 08:57","BookieProtoEncoding.java","111724","77970","189694","","379388"
"2014-07-25 00:34","BookieProtoEncoding.java","5139","30655","35794","","71588"
"2016-04-05 08:45","BookieProtoEncoding.java","109148","43791","152939","","305878"
"2017-05-15 19:52","BookieProtoEncoding.java","111613","77382","188995","","377990"
"2017-06-05 22:25","BookieProtoEncoding.java","112625","83036","195661","","391322"
"2016-04-27 09:55","GcLedgersTest.java","105436","8619","114055","","228110"
"2017-03-28 22:37","GcLedgersTest.java","111298","41264","152562","","305124"
"2016-03-08 06:49","GcLedgersTest.java","594","3891","4485","","8970"
"2017-07-04 06:27","GcLedgersTest.java","114541","58474","173015","","346030"
"2017-05-16 00:31","GcLedgersTest.java","112686","46609","159295","","318590"
"2017-10-17 09:32","BookKeeperAdmin.java","32507","47044","79551","","159102"
"2013-01-14 16:59","BookieServer.java","263","1327","1590","2","3180"
"2013-02-12 11:16","BookieServer.java","1497","33147","34644","4","69288"
"2013-04-02 17:38","BookieServer.java","1866","34519","36385","5","72770"
"2017-08-16 03:37","BookieServer.java","86529","119428","205957","","411914"
"2017-08-02 00:49","BookieServer.java","85308","111574","196882","","393764"
"2013-07-03 17:39","BookieServer.java","2633","40775","43408","5","86816"
"2013-07-24 16:55","BookieServer.java","2711","41721","44432","5","88864"
"2014-02-05 22:43","BookieServer.java","5196","50995","56191","7","112382"
"2017-06-28 23:24","BookieServer.java","81983","86210","168193","","336386"
"2013-06-15 19:05","BookieServer.java","2586","40411","42997","5","85994"
"2017-06-01 23:58","BookieServer.java","81780","82605","164385","","328770"
"2017-10-17 09:32","BookieServer.java","92357","116634","208991","","417982"
"2014-08-02 20:02","BookieServer.java","6190","64199","70389","","140778"
"2013-12-06 07:39","BookieServer.java","4148","47700","51848","6","103696"
"2014-01-21 05:05","BookieServer.java","4250","48900","53150","6","106300"
"2013-08-21 13:19","BookKeeperAdmin.java","18161","134116","152277","5","304554"
"2017-10-17 09:32","BookKeeperAdmin.java","42961","143692","186653","","373306"
"2017-06-01 23:58","BookKeeperAdmin.java","41147","118426","159573","","319146"
"2017-04-11 20:19","BookKeeperAdmin.java","40849","111643","152492","","304984"
"2014-02-21 19:01","BookKeeperAdmin.java","18731","142147","160878","7","321756"
"2014-02-05 22:43","BookKeeperAdmin.java","18694","140947","159641","7","319282"
"2012-03-31 10:58","BookKeeperAdmin.java","9542","25552","35094","1","70188"
"2017-07-07 05:11","BookKeeperAdmin.java","41219","127413","168632","","337264"
"2013-02-26 04:12","BookKeeperAdmin.java","17728","125987","143715","4","287430"
"2016-11-09 03:05","BookKeeperAdmin.java","40810","93314","134124","","268248"
"2016-11-30 00:07","BookKeeperAdmin.java","40822","93990","134812","","269624"
"2016-09-10 21:01","BookKeeperAdmin.java","40722","89541","130263","","260526"
"2016-07-14 23:02","BookKeeperAdmin.java","40717","85466","126183","","252366"
"2016-10-13 09:27","BookKeeperAdmin.java","40810","92980","133790","","267580"
"2012-11-30 04:54","BookKeeperAdmin.java","16039","85454","101493","2","202986"
"2012-07-18 17:00","BookKeeperAdmin.java","12283","42809","55092","2","110184"
"2013-02-08 19:08","BookKeeperAdmin.java","16980","125211","142191","4","284382"
"2011-11-28 19:25","BookKeeperAdmin.java","482","3226","3708","","7416"
"2016-03-16 05:03","BookKeeperAdmin.java","40669","80926","121595","","243190"
"2016-03-08 07:18","BookKeeperAdmin.java","19230","163773","183003","","366006"
"2014-12-06 08:03","BookKeeperAdmin.java","19113","156587","175700","","351400"
"2012-09-03 18:54","BookKeeperAdmin.java","13082","61651","74733","2","149466"
"2014-04-24 10:43","BookKeeperAdmin.java","18737","144125","162862","7","325724"
"2012-10-05 16:24","BookKeeperAdmin.java","15235","70873","86108","2","172216"
"2012-09-07 07:04","BookKeeperAdmin.java","13106","63141","76247","2","152494"
"2014-09-06 07:51","BookKeeperAdmin.java","19096","155433","174529","","349058"
"2012-08-19 11:39","BookKeeperAdmin.java","12906","55616","68522","2","137044"
"2012-05-10 14:47","BookKeeperAdmin.java","10188","28149","38337","1","76674"
"2013-05-10 12:45","BookKeeperAdmin.java","17960","128040","146000","5","292000"
"2012-08-24 22:44","BookKeeperAdmin.java","12908","56510","69418","2","138836"
"2013-08-21 13:19","BookKeeperAdmin.java","17917","136538","154455","5","308910"
"2017-10-17 09:32","BookKeeperAdmin.java","41743","145140","186883","","373766"
"2017-06-01 23:58","BookKeeperAdmin.java","40130","120075","160205","","320410"
"2017-04-11 20:19","BookKeeperAdmin.java","39856","113316","153172","","306344"
"2014-02-21 19:01","BookKeeperAdmin.java","18356","144438","162794","7","325588"
"2014-02-05 22:43","BookKeeperAdmin.java","18324","143243","161567","7","323134"
"2012-03-31 10:58","BookKeeperAdmin.java","9923","28599","38522","1","77044"
"2017-07-07 05:11","BookKeeperAdmin.java","40179","129039","169218","","338436"
"2011-11-18 11:18","BookKeeperAdmin.java","1065","3731","4796","","9592"
"2013-02-26 04:12","BookKeeperAdmin.java","17504","128429","145933","4","291866"
"2016-11-09 03:05","BookKeeperAdmin.java","39849","95019","134868","","269736"
"2016-11-30 00:07","BookKeeperAdmin.java","39856","95690","135546","","271092"
"2016-09-10 21:01","BookKeeperAdmin.java","39768","91253","131021","","262042"
"2016-07-14 23:02","BookKeeperAdmin.java","39765","87180","126945","","253890"
"2016-10-13 09:27","BookKeeperAdmin.java","39849","94685","134534","","269068"
"2012-11-30 04:54","BookKeeperAdmin.java","15878","87959","103837","2","207674"
"2012-07-18 17:00","BookKeeperAdmin.java","12526","45718","58244","2","116488"
"2013-02-08 19:08","BookKeeperAdmin.java","16790","127687","144477","4","288954"
"2011-11-28 19:25","BookKeeperAdmin.java","1465","6875","8340","","16680"
"2016-03-16 05:03","BookKeeperAdmin.java","39727","82650","122377","","244754"
"2016-03-08 07:18","BookKeeperAdmin.java","18755","165964","184719","","369438"
"2011-11-16 17:05","BookKeeperAdmin.java","128","863","991","","1982"
"2014-12-06 08:03","BookKeeperAdmin.java","18691","158831","177522","","355044"
"2012-09-03 18:54","BookKeeperAdmin.java","13245","64480","77725","2","155450"
"2014-04-24 10:43","BookKeeperAdmin.java","18360","146414","164774","7","329548"
"2012-10-05 16:24","BookKeeperAdmin.java","15089","73393","88482","2","176964"
"2012-09-07 07:04","BookKeeperAdmin.java","13266","65967","79233","2","158466"
"2014-09-06 07:51","BookKeeperAdmin.java","18674","157677","176351","","352702"
"2012-08-19 11:39","BookKeeperAdmin.java","13083","58459","71542","2","143084"
"2012-05-10 14:47","BookKeeperAdmin.java","10517","31144","41661","1","83322"
"2013-05-10 12:45","BookKeeperAdmin.java","17716","130462","148178","5","296356"
"2012-08-24 22:44","BookKeeperAdmin.java","13085","59353","72438","2","144876"
"2013-07-20 19:59","BufferedChannel.java","18369","134743","153112","5","306224"
"2013-10-22 16:21","BufferedChannel.java","18523","137800","156323","6","312646"
"2013-10-12 05:42","BufferedChannel.java","18448","136958","155406","6","310812"
"2014-01-22 14:35","BufferedChannel.java","18665","142310","160975","6","321950"
"2017-06-21 19:58","PendingReadOp.java","113055","83437","196492","","392984"
"2017-06-05 21:48","PendingReadOp.java","112915","81909","194824","","389648"
"2017-06-05 22:13","PendingReadOp.java","112921","82328","195249","","390498"
"2017-06-01 11:42","PendingReadOp.java","112185","80470","192655","","385310"
"2017-06-01 22:39","PendingReadOp.java","112817","80684","193501","","387002"
"2013-09-11 00:34","PendingReadOp.java","1110","8133","9243","5","18486"
"2014-02-05 22:43","PendingReadOp.java","3809","17035","20844","7","41688"
"2017-05-15 19:52","PendingReadOp.java","111989","77048","189037","","378074"
"2015-04-21 09:17","PendingReadOp.java","5466","36153","41619","","83238"
"2016-02-09 08:39","PendingReadOp.java","6269","40295","46564","","93128"
"2016-02-09 08:32","PendingReadOp.java","6269","40238","46507","","93014"
"2017-07-04 06:27","PendingReadOp.java","113338","88825","202163","","404326"
"2014-01-21 05:19","PendingReadOp.java","2907","15330","18237","6","36474"
"2013-02-08 19:08","BenchReadThroughputLatency.java","11847","102184","114031","4","228062"
"2016-02-09 08:12","BenchReadThroughputLatency.java","15980","140909","156889","","313778"
"2016-07-14 23:02","BenchReadThroughputLatency.java","47652","74507","122159","","244318"
"2013-10-29 05:14","BenchReadThroughputLatency.java","14316","114309","128625","6","257250"
"2013-10-14 16:43","BenchReadThroughputLatency.java","14162","113286","127448","6","254896"
"2012-03-13 07:31","FileSystemUpgrade.java","1005","4607","5612","1","11224"
"2016-07-14 23:02","FileSystemUpgrade.java","45263","81086","126349","","252698"
"2017-03-22 22:54","FileSystemUpgrade.java","45383","102485","147868","","295736"
"2013-02-08 19:08","FileSystemUpgrade.java","17723","117028","134751","4","269502"
"2012-12-08 11:18","FileSystemUpgrade.java","16603","77674","94277","2","188554"
"2012-09-07 07:26","FileSystemUpgrade.java","13250","54394","67644","2","135288"
"2014-09-18 06:57","FileSystemUpgrade.java","20152","147725","167877","","335754"
"2012-05-10 14:47","FileSystemUpgrade.java","9245","18280","27525","1","55050"
"2017-07-04 06:27","LedgerManagerTestCase.java","819","6277","7096","","14192"
"2017-05-15 19:52","LedgerHandle.java","7821","37192","45013","","90026"
"2017-05-02 22:07","LedgerHandle.java","6717","33734","40451","","80902"
"2017-03-23 15:55","LedgerHandle.java","6345","27736","34081","","68162"
"2016-09-10 21:01","LedgerHandle.java","3894","7998","11892","","23784"
"2017-05-17 08:57","LedgerHandle.java","8024","37872","45896","","91792"
"2017-05-25 14:23","LedgerHandle.java","8075","39728","47803","","95606"
"2017-06-21 19:50","LedgerHandle.java","9459","44043","53502","","107004"
"2017-06-21 21:00","LedgerHandle.java","9474","44841","54315","","108630"
"2017-06-01 23:58","LedgerHandle.java","8970","41534","50504","","101008"
"2017-07-04 06:27","LedgerHandle.java","10009","49808","59817","","119634"
"2017-06-30 00:12","LedgerHandle.java","9809","47647","57456","","114912"
"2017-01-31 04:01","LedgerHandle.java","6189","27214","33403","","66806"
"2015-10-06 10:05","WriteEntryProcessor.java","1056","2247","3303","","6606"
"2017-05-15 19:52","WriteEntryProcessor.java","113312","47684","160996","","321992"
"2012-08-17 12:41","RoundRobinDistributionSchedule.java","14337","56997","71334","2","142668"
"2012-09-12 11:59","RoundRobinDistributionSchedule.java","14547","68736","83283","2","166566"
"2014-12-05 17:51","RoundRobinDistributionSchedule.java","19410","160224","179634","","359268"
"2017-06-30 00:12","RoundRobinDistributionSchedule.java","40530","126712","167242","","334484"
"2012-02-13 15:46","RoundRobinDistributionSchedule.java","4625","16631","21256","1","42512"
"2017-07-04 06:27","PerChannelBookieClient.java","343","2304","2647","","5294"
"2017-07-28 20:12","PerChannelBookieClient.java","2080","8635","10715","","21430"
"2017-08-02 00:49","PerChannelBookieClient.java","5648","25815","31463","","62926"
"2017-05-15 19:52","ClientConfiguration.java","1608","4262","5870","","11740"
"2017-06-21 19:58","ClientConfiguration.java","3445","11422","14867","","29734"
"2017-06-05 21:48","ClientConfiguration.java","3109","9698","12807","","25614"
"2017-06-21 19:50","ClientConfiguration.java","3437","11304","14741","","29482"
"2017-08-02 00:49","ClientConfiguration.java","9121","40409","49530","","99060"
"2017-08-01 08:34","ClientConfiguration.java","8273","36976","45249","","90498"
"2017-06-30 00:12","ClientConfiguration.java","3844","14965","18809","","37618"
"2017-07-04 06:27","ClientConfiguration.java","4136","17218","21354","","42708"
"2017-06-30 00:12","PerChannelBookieClient.java","113958","69543","183501","","367002"
"2017-07-04 06:27","PerChannelBookieClient.java","114110","71656","185766","","371532"
"2017-01-31 04:01","PerChannelBookieClient.java","111289","50061","161350","","322700"
"2015-10-06 10:05","PerChannelBookieClient.java","3432","17369","20801","","41602"
"2016-04-05 18:47","PerChannelBookieClient.java","107992","24226","132218","","264436"
"2017-04-15 13:58","PerChannelBookieClient.java","111600","56064","167664","","335328"
"2017-05-15 19:52","PerChannelBookieClient.java","112424","59542","171966","","343932"
"2016-04-05 08:45","PerChannelBookieClient.java","107981","23973","131954","","263908"
"2017-07-28 20:12","PerChannelBookieClient.java","115173","77313","192486","","384972"
"2017-01-31 02:14","PerChannelBookieClient.java","111283","44586","155869","","311738"
"2017-03-28 22:35","PerChannelBookieClient.java","111402","54766","166168","","332336"
"2017-03-23 00:48","PerChannelBookieClient.java","111395","50507","161902","","323804"
"2014-07-25 00:34","PerChannelBookieClient.java","1139","8004","9143","","18286"
"2017-08-02 00:49","PerChannelBookieClient.java","117771","93523","211294","","422588"
"2017-06-21 19:58","PerChannelBookieClient.java","113686","66127","179813","","359626"
"2017-06-01 23:58","PerChannelBookieClient.java","113406","63717","177123","","354246"
"2017-04-20 19:55","PerChannelBookieClient.java","111605","56090","167695","","335390"
"2017-06-30 00:12","BookieRecoveryTest.java","113672","68214","181886","","363772"
"2017-04-11 20:15","BookieRecoveryTest.java","111260","54041","165301","","330602"
"2017-05-15 19:52","BookieRecoveryTest.java","112131","58206","170337","","340674"
"2013-08-21 13:19","BookKeeperAdmin.java","1408","9104","10512","5","21024"
"2017-10-17 09:32","BookKeeperAdmin.java","123236","115708","238944","","477888"
"2017-06-01 23:58","BookKeeperAdmin.java","112502","81522","194024","","388048"
"2017-04-11 20:19","BookKeeperAdmin.java","111026","73561","184587","","369174"
"2014-02-21 19:01","BookKeeperAdmin.java","4339","19496","23835","7","47670"
"2014-02-05 22:43","BookKeeperAdmin.java","4178","18172","22350","7","44700"
"2017-07-07 05:11","BookKeeperAdmin.java","112964","90899","203863","","407726"
"2016-11-09 03:05","BookKeeperAdmin.java","110796","55041","165837","","331674"
"2016-11-30 00:07","BookKeeperAdmin.java","110806","55715","166521","","333042"
"2016-09-10 21:01","BookKeeperAdmin.java","110679","51239","161918","","323836"
"2016-07-14 23:02","BookKeeperAdmin.java","109462","45952","155414","","310828"
"2016-10-13 09:27","BookKeeperAdmin.java","110793","54704","165497","","330994"
"2016-03-16 05:03","BookKeeperAdmin.java","109200","41198","150398","","300796"
"2016-03-08 07:18","BookKeeperAdmin.java","6685","42969","49654","","99308"
"2014-12-06 08:03","BookKeeperAdmin.java","5432","34647","40079","","80158"
"2014-04-24 10:43","BookKeeperAdmin.java","4468","21597","26065","7","52130"
"2014-09-06 07:51","BookKeeperAdmin.java","5243","33321","38564","","77128"
"2013-05-10 12:45","BookKeeperAdmin.java","895","2716","3611","5","7222"
"2013-01-07 12:25","ReadOnlyLedgerHandle.java","16595","94808","111403","2","222806"
"2015-10-06 10:05","ReadOnlyLedgerHandle.java","18962","161798","180760","","361520"
"2017-01-31 04:01","ReadOnlyLedgerHandle.java","40097","107768","147865","","295730"
"2012-06-29 18:43","ReadOnlyLedgerHandle.java","11237","40314","51551","2","103102"
"2012-05-25 17:13","ReadOnlyLedgerHandle.java","10849","31995","42844","1","85688"
"2014-01-17 18:13","ReadOnlyLedgerHandle.java","18195","140680","158875","6","317750"
"2017-06-30 00:12","ReadOnlyLedgerHandle.java","40399","124883","165282","","330564"
"2014-02-05 22:43","ReadOnlyLedgerHandle.java","18498","142682","161180","7","322360"
"2017-03-23 15:55","ReadOnlyLedgerHandle.java","40090","108127","148217","","296434"
"2016-04-27 09:00","TestReplicationWorker.java","107591","28603","136194","","272388"
"2015-07-10 22:48","TestReplicationWorker.java","3273","21299","24572","","49144"
"2014-07-24 01:41","TestReplicationWorker.java","1183","6941","8124","","16248"
"2017-05-02 23:04","HierarchicalLedgerManager.java","80510","78649","159159","","318318"
"2017-05-12 16:39","HierarchicalLedgerManager.java","80524","79343","159867","","319734"
"2013-04-04 11:21","HierarchicalLedgerManager.java","3159","37896","41055","5","82110"
"2014-01-17 18:13","HierarchicalLedgerManager.java","5306","51403","56709","6","113418"
"2013-10-12 05:42","JournalChannel.java","1472","3608","5080","6","10160"
"2014-04-29 22:07","JournalChannel.java","3825","14743","18568","7","37136"
"2014-03-07 13:30","JournalChannel.java","3642","12248","15890","7","31780"
"2015-04-21 10:19","TestLedgerChecker.java","3005","20685","23690","","47380"
"2014-07-24 01:41","TestLedgerChecker.java","1183","6941","8124","","16248"
"2017-03-28 22:40","ZkLedgerIdGenerator.java","111187","39139","150326","","300652"
"2017-06-01 23:58","ZkLedgerIdGenerator.java","113431","47887","161318","","322636"
"2017-05-02 23:04","ZkLedgerIdGenerator.java","111764","41537","153301","","306602"
"2016-04-05 18:47","BookieSocketAddress.java","143","3320","3463","","6926"
"2017-05-15 19:52","BookieSocketAddress.java","7509","41570","49079","","98158"
"2016-10-13 07:50","BookieSocketAddress.java","5780","17939","23719","","47438"
"2012-07-23 23:39","LocalBookKeeper.java","13991","48214","62205","2","124410"
"2011-11-17 11:16","LocalBookKeeper.java","2969","5310","8279","","16558"
"2014-12-10 19:43","LocalBookKeeper.java","19422","160690","180112","","360224"
"2013-02-08 19:08","LocalBookKeeper.java","17898","129758","147656","4","295312"
"2012-05-10 14:47","LocalBookKeeper.java","12253","33843","46096","1","92192"
"2015-07-10 22:48","LocalBookKeeper.java","19450","163358","182808","","365616"
"2011-11-18 11:18","LocalBookKeeper.java","3592","7221","10813","","21626"
"2017-05-26 12:38","LocalBookKeeper.java","40482","120513","160995","","321990"
"2017-06-01 11:31","LocalBookKeeper.java","40512","121457","161969","","323938"
"2017-06-01 23:58","LocalBookKeeper.java","40516","121424","161940","","323880"
"2013-01-14 16:59","LocalBookKeeper.java","17784","98931","116715","2","233430"
"2017-06-01 23:58","EntryLogger.java","41147","118426","159573","","319146"
"2014-01-21 17:26","EntryLogger.java","18415","140158","158573","6","317146"
"2013-10-02 06:23","EntryLogger.java","18181","134242","152423","5","304846"
"2014-01-22 14:35","EntryLogger.java","18490","140609","159099","6","318198"
"2017-11-08 12:27","EntryLogger.java","43227","153978","197205","","394410"
"2013-10-22 07:44","EntryLogger.java","18279","135636","153915","6","307830"
"2012-03-16 10:41","EntryLogger.java","8777","22749","31526","1","63052"
"2012-06-13 16:57","EntryLogger.java","10563","31408","41971","","83942"
"2012-02-15 16:11","EntryLogger.java","1618","10007","11625","1","23250"
"2013-05-04 14:22","EntryLogger.java","17936","127686","145622","5","291244"
"2011-12-16 12:43","EntryLogger.java","1036","4245","5281","1","10562"
"2012-03-08 12:13","EntryLogger.java","1901","12128","14029","1","28058"
"2017-01-31 02:11","EntryLogger.java","40843","100502","141345","","282690"
"2017-03-23 00:48","EntryLogger.java","40851","106931","147782","","295564"
"2016-07-14 23:02","EntryLogger.java","40717","85466","126183","","252366"
"2012-12-24 06:23","EntryLogger.java","16428","91107","107535","2","215070"
"2012-12-10 11:04","EntryLogger.java","16195","86291","102486","2","204972"
"2016-02-24 00:44","EntryLogger.java","19221","162747","181968","","363936"
"2015-04-21 10:02","EntryLogger.java","19137","159055","178192","","356384"
"2012-10-18 16:40","EntryLogger.java","15802","74605","90407","2","180814"
"2012-07-26 04:32","EntryLogger.java","12315","42920","55235","2","110470"
"2013-01-04 11:32","EntryLogger.java","16668","92738","109406","2","218812"
"2015-04-21 09:44","EntryLogger.java","19136","158870","178006","","356012"
"2012-05-09 10:39","EntryLogger.java","9937","27612","37549","1","75098"
"2012-05-07 18:48","EntryLogger.java","9928","27179","37107","1","74214"
"2012-05-10 14:47","EntryLogger.java","10188","28149","38337","1","76674"
"2012-05-17 19:07","EntryLogger.java","10474","29490","39964","1","79928"
"2017-03-28 22:35","ClientConfiguration.java","148","4388","4536","","9072"
"2017-04-15 13:58","ClientConfiguration.java","529","5869","6398","","12796"
"2017-05-15 19:52","ClientConfiguration.java","2071","10065","12136","","24272"
"2017-06-21 19:58","ClientConfiguration.java","3854","17171","21025","","42050"
"2017-06-05 21:48","ClientConfiguration.java","3522","15451","18973","","37946"
"2017-06-21 19:50","ClientConfiguration.java","3848","17055","20903","","41806"
"2017-08-02 00:49","ClientConfiguration.java","9174","45802","54976","","109952"
"2017-08-01 08:34","ClientConfiguration.java","8406","42449","50855","","101710"
"2017-06-30 00:12","ClientConfiguration.java","4249","20710","24959","","49918"
"2017-07-04 06:27","ClientConfiguration.java","4520","22942","27462","","54924"
"2017-06-21 19:58","ClientConfiguration.java","1939","7262","9201","","18402"
"2017-06-05 21:48","ClientConfiguration.java","1589","5524","7113","","14226"
"2017-06-21 19:50","ClientConfiguration.java","1929","7142","9071","","18142"
"2017-08-02 00:49","ClientConfiguration.java","7739","36373","44112","","88224"
"2017-08-01 08:34","ClientConfiguration.java","6815","32864","39679","","79358"
"2017-06-30 00:12","ClientConfiguration.java","2341","10808","13149","","26298"
"2017-07-04 06:27","ClientConfiguration.java","2652","13080","15732","","31464"
"2013-04-02 17:38","BookieServer.java","424","1427","1851","5","3702"
"2017-08-16 03:37","BookieServer.java","117257","118506","235763","","471526"
"2017-08-02 00:49","BookieServer.java","116036","110652","226688","","453376"
"2013-07-03 17:39","BookieServer.java","1230","7722","8952","5","17904"
"2013-07-24 16:55","BookieServer.java","1312","8672","9984","5","19968"
"2014-02-05 22:43","BookieServer.java","4173","18322","22495","7","44990"
"2017-06-28 23:24","BookieServer.java","112702","85279","197981","","395962"
"2013-06-15 19:05","BookieServer.java","1180","7355","8535","5","17070"
"2017-06-01 23:58","BookieServer.java","112495","81670","194165","","388330"
"2017-10-17 09:32","BookieServer.java","123185","115812","238997","","477994"
"2014-08-02 20:02","BookieServer.java","5223","31582","36805","","73610"
"2013-12-06 07:39","BookieServer.java","2896","14798","17694","6","35388"
"2014-01-21 05:05","BookieServer.java","3224","16224","19448","6","38896"
"2017-03-28 22:37","GcLedgersTest.java","6680","33463","40143","","80286"
"2017-07-04 06:27","GcLedgersTest.java","10260","51010","61270","","122540"
"2017-05-16 00:31","GcLedgersTest.java","8252","38992","47244","","94488"
"2014-12-10 19:43","ConcurrentLedgerTest.java","1949","11577","13526","","27052"
"2017-05-16 00:31","ConcurrentLedgerTest.java","112271","58764","171035","","342070"
"2014-08-02 20:02","Journal.java","1579","12588","14167","","28334"
"2014-04-29 22:07","Journal.java","251","2563","2814","7","5628"
"2015-04-21 09:23","Journal.java","2872","19136","22008","","44016"
"2016-02-09 08:30","Journal.java","3862","23393","27255","","54510"
"2015-02-23 08:11","Journal.java","2794","18822","21616","","43232"
"2017-05-26 16:52","Journal.java","112067","65035","177102","","354204"
"2017-03-22 22:54","Journal.java","110876","53450","164326","","328652"
"2016-11-12 03:37","Journal.java","110716","39797","150513","","301026"
"2016-07-14 23:02","Journal.java","107887","29182","137069","","274138"
"2017-06-01 23:58","Journal.java","112846","66671","179517","","359034"
"2017-05-09 22:24","Journal.java","111477","60647","172124","","344248"
"2017-05-16 00:31","Journal.java","112010","63060","175070","","350140"
"2014-08-02 20:02","Journal.java","1358","10055","11413","","22826"
"2015-04-21 09:23","Journal.java","2675","16627","19302","","38604"
"2016-02-09 08:30","Journal.java","3666","20885","24551","","49102"
"2015-02-23 08:11","Journal.java","2596","16312","18908","","37816"
"2017-05-26 16:52","Journal.java","112632","63288","175920","","351840"
"2017-03-22 22:54","Journal.java","111408","51670","163078","","326156"
"2016-11-12 03:37","Journal.java","111244","38013","149257","","298514"
"2016-07-14 23:02","Journal.java","108410","27393","135803","","271606"
"2017-06-01 23:58","Journal.java","113411","64924","178335","","356670"
"2017-05-09 22:24","Journal.java","112017","58875","170892","","341784"
"2017-05-16 00:31","Journal.java","112574","61312","173886","","347772"
"2012-12-13 18:34","BookieReadWriteTest.java","14570","97135","111705","2","223410"
"2011-09-05 19:38","BookieReadWriteTest.java","4901","10804","15705","","31410"
"2011-08-11 21:37","BookieReadWriteTest.java","91","358","449","","898"
"2011-08-11 20:36","BookieReadWriteTest.java","61","313","374","","748"
"2014-01-21 05:05","BookieReadWriteTest.java","16113","146749","162862","6","325724"
"2012-06-19 12:39","BookieReadWriteTest.java","10388","41531","51919","2","103838"
"2012-05-25 17:13","BookieReadWriteTest.java","10317","39064","49381","1","98762"
"2014-07-24 01:41","BookieReadWriteTest.java","16446","153989","170435","","340870"
"2012-02-13 11:19","BookieReadWriteTest.java","8637","26466","35103","1","70206"
"2013-05-31 12:02","BookieReadWriteTest.java","15934","135645","151579","5","303158"
"2016-03-08 06:49","LedgerDeleteTest.java","4990","26749","31739","","63478"
"2014-07-24 01:41","LedgerDeleteTest.java","2067","7959","10026","","20052"
"2014-01-21 05:05","BookieReadWriteTest.java","6146","54217","60363","6","120726"
"2014-07-24 01:41","BookieReadWriteTest.java","7672","62650","70322","","140644"
"2013-05-31 12:02","BookieReadWriteTest.java","4512","41658","46170","5","92340"
"2013-10-22 16:21","HandleFactoryImpl.java","14587","115827","130414","6","260828"
"2017-03-28 22:37","HandleFactoryImpl.java","47523","101559","149082","","298164"
"2017-06-01 23:58","EntryLogger.java","42419","116489","158908","","317816"
"2014-01-21 17:26","EntryLogger.java","18821","137355","156176","6","312352"
"2013-10-02 06:23","EntryLogger.java","18548","131400","149948","5","299896"
"2014-01-22 14:35","EntryLogger.java","18891","137801","156692","6","313384"
"2017-11-08 12:27","EntryLogger.java","44986","152528","197514","","395028"
"2013-10-22 07:44","EntryLogger.java","18662","132810","151472","6","302944"
"2012-03-16 10:41","EntryLogger.java","7943","18706","26649","1","53298"
"2012-06-13 16:57","EntryLogger.java","9902","27538","37440","","74880"
"2012-02-15 16:11","EntryLogger.java","617","5797","6414","1","12828"
"2013-05-04 14:22","EntryLogger.java","18284","124825","143109","5","286218"
"2012-03-08 12:13","EntryLogger.java","1018","8036","9054","1","18108"
"2017-01-31 02:11","EntryLogger.java","41901","98351","140252","","280504"
"2017-03-23 00:48","EntryLogger.java","41923","104794","146717","","293434"
"2016-07-14 23:02","EntryLogger.java","41799","83339","125138","","250276"
"2012-12-24 06:23","EntryLogger.java","16756","88226","104982","2","209964"
"2012-12-10 11:04","EntryLogger.java","16337","83224","99561","2","199122"
"2016-02-24 00:44","EntryLogger.java","19781","160098","179879","","359758"
"2015-04-21 10:02","EntryLogger.java","19590","156299","175889","","351778"
"2012-10-18 16:40","EntryLogger.java","15910","71504","87414","2","174828"
"2012-07-26 04:32","EntryLogger.java","12270","39666","51936","2","103872"
"2013-01-04 11:32","EntryLogger.java","17006","89867","106873","2","213746"
"2015-04-21 09:44","EntryLogger.java","19589","156114","175703","","351406"
"2012-05-09 10:39","EntryLogger.java","9208","23674","32882","1","65764"
"2012-05-07 18:48","EntryLogger.java","9197","23239","32436","1","64872"
"2012-05-10 14:47","EntryLogger.java","9466","24218","33684","1","67368"
"2012-05-17 19:07","EntryLogger.java","9787","25594","35381","1","70762"
"2017-07-07 08:19","LedgerDirsManagerTest.java","114509","84002","198511","","397022"
"2017-01-30 23:25","LedgerDirsManagerTest.java","112091","54708","166799","","333598"
"2017-06-05 20:30","LedgerDirsManagerTest.java","114060","74713","188773","","377546"
"2014-12-10 19:43","LedgerDirsManagerTest.java","4587","25242","29829","","59658"
"2014-07-24 01:41","LedgerDirsManagerTest.java","3366","14393","17759","","35518"
"2013-03-25 06:27","TestLedgerManager.java","13860","108681","122541","4","245082"
"2012-11-23 11:49","TestLedgerManager.java","11284","64708","75992","2","151984"
"2012-12-10 10:58","TestLedgerManager.java","11539","67666","79205","2","158410"
"2017-03-28 22:40","TestLedgerManager.java","46547","103459","150006","","300012"
"2015-07-10 22:48","TestLedgerManager.java","15831","142247","158078","","316156"
"2014-07-24 01:41","TestLedgerManager.java","15357","129505","144862","","289724"
"2012-06-19 12:39","TestLedgerManager.java","3496","11244","14740","2","29480"
"2012-02-01 16:19","CRC32DigestManager.java","4463","13280","17743","1","35486"
"2017-05-15 19:52","CRC32DigestManager.java","40437","118152","158589","","317178"
"2013-07-04 14:01","JournalChannel.java","19044","125574","144618","5","289236"
"2013-10-12 05:42","JournalChannel.java","19219","128122","147341","6","294682"
"2013-07-20 19:59","JournalChannel.java","19063","125830","144893","5","289786"
"2012-12-18 13:04","JournalChannel.java","16991","83259","100250","2","200500"
"2014-04-29 22:07","JournalChannel.java","19811","137496","157307","7","314614"
"2014-03-07 13:30","JournalChannel.java","19777","135150","154927","7","309854"
"2012-05-07 18:48","JournalChannel.java","9126","18296","27422","1","54844"
"2014-05-09 14:04","CookieTest.java","20124","134003","154127","7","308254"
"2013-10-12 05:42","CookieTest.java","19402","123858","143260","6","286520"
"2016-11-30 00:02","CookieTest.java","46090","86731","132821","","265642"
"2012-11-23 11:49","CookieTest.java","16413","71172","87585","2","175170"
"2014-12-10 19:43","CookieTest.java","20772","145883","166655","","333310"
"2012-09-07 07:04","CookieTest.java","13103","50610","63713","2","127426"
"2014-09-23 17:53","CookieTest.java","20598","144625","165223","","330446"
"2014-09-18 06:57","CookieTest.java","20581","144552","165133","","330266"
"2012-04-10 05:21","CookieTest.java","8017","11787","19804","1","39608"
"2011-11-17 09:59","BufferedChannel.java","2736","4839","7575","","15150"
"2013-07-20 19:59","BufferedChannel.java","18843","137320","156163","5","312326"
"2013-10-22 16:21","BufferedChannel.java","18973","140353","159326","6","318652"
"2013-10-12 05:42","BufferedChannel.java","18908","139521","158429","6","316858"
"2014-01-22 14:35","BufferedChannel.java","19065","144813","163878","6","327756"
"2017-07-28 20:12","PerChannelBookieClient.java","1802","6396","8198","","16396"
"2017-08-02 00:49","PerChannelBookieClient.java","5371","23577","28948","","57896"
"2017-01-31 04:01","ReadOnlyLedgerHandle.java","111029","35864","146893","","293786"
"2017-06-30 00:12","ReadOnlyLedgerHandle.java","114336","55984","170320","","340640"
"2017-03-23 15:55","ReadOnlyLedgerHandle.java","111183","36384","147567","","295134"
"2016-04-29 05:05","ScanAndCompareGarbageCollector.java","78447","47754","126201","","252402"
"2013-04-04 11:21","ScanAndCompareGarbageCollector.java","3159","37896","41055","5","82110"
"2016-04-27 09:55","ScanAndCompareGarbageCollector.java","78445","47752","126197","","252394"
"2016-03-08 06:49","ScanAndCompareGarbageCollector.java","8550","77971","86521","","173042"
"2017-03-28 22:40","ScanAndCompareGarbageCollector.java","80137","76455","156592","","313184"
"2017-05-25 14:23","LedgerHandleAdv.java","2988","26839","29827","","59654"
"2017-06-01 23:58","LedgerHandleAdv.java","3902","28664","32566","","65132"
"2012-12-24 05:50","InterleavedLedgerStorage.java","796","904","1700","2","3400"
"2016-11-18 00:18","InterleavedLedgerStorage.java","80536","58826","139362","","278724"
"2013-12-02 18:45","InterleavedLedgerStorage.java","5885","51390","57275","6","114550"
"2013-05-04 14:22","InterleavedLedgerStorage.java","4140","39541","43681","5","87362"
"2014-01-15 15:58","InterleavedLedgerStorage.java","5965","51814","57779","6","115558"
"2014-01-21 17:26","InterleavedLedgerStorage.java","6154","53548","59702","6","119404"
"2013-10-02 06:23","InterleavedLedgerStorage.java","4706","46418","51124","5","102248"
"2017-05-16 00:31","InterleavedLedgerStorage.java","81360","81515","162875","","325750"
"2014-08-02 20:02","InterleavedLedgerStorage.java","7815","67929","75744","","151488"
"2017-07-04 06:27","InterleavedLedgerStorage.java","82514","92679","175193","","350386"
"2015-04-21 09:55","InterleavedLedgerStorage.java","8310","73846","82156","","164312"
"2017-01-31 04:01","InterleavedLedgerStorage.java","80590","71981","152571","","305142"
"2016-03-08 06:49","InterleavedLedgerStorage.java","9157","78686","87843","","175686"
"2017-03-28 22:37","InterleavedLedgerStorage.java","80680","76878","157558","","315116"
"2015-04-21 09:17","InterleavedLedgerStorage.java","8290","73655","81945","","163890"
"2014-08-02 20:02","ServerConfiguration.java","1579","12588","14167","","28334"
"2014-05-06 12:30","ServerConfiguration.java","254","2613","2867","7","5734"
"2014-05-15 00:41","ServerConfiguration.java","283","3556","3839","7","7678"
"2014-09-18 06:47","ServerConfiguration.java","2150","15168","17318","","34636"
"2017-07-04 06:27","ServerConfiguration.java","113539","74599","188138","","376276"
"2014-04-29 22:07","ServerConfiguration.java","251","2563","2814","7","5628"
"2016-04-14 00:51","ServerConfiguration.java","107525","27323","134848","","269696"
"2015-01-16 15:57","ServerConfiguration.java","2769","18759","21528","","43056"
"2016-03-08 06:49","ServerConfiguration.java","4083","24507","28590","","57180"
"2016-01-26 22:11","ServerConfiguration.java","3758","23168","26926","","53852"
"2014-03-12 21:26","ServerConfiguration.java","134","1936","2070","7","4140"
"2016-04-05 18:47","ServerConfiguration.java","107499","27247","134746","","269492"
"2016-04-27 09:55","ServerConfiguration.java","107577","27887","135464","","270928"
"2015-04-21 09:55","ServerConfiguration.java","2903","19334","22237","","44474"
"2015-01-12 15:18","ServerConfiguration.java","2761","17813","20574","","41148"
"2015-04-21 10:02","ServerConfiguration.java","2915","19379","22294","","44588"
"2017-05-15 19:52","ServerConfiguration.java","111882","62514","174396","","348792"
"2017-03-22 22:54","ServerConfiguration.java","110876","53450","164326","","328652"
"2017-03-23 00:48","ServerConfiguration.java","110881","53507","164388","","328776"
"2017-01-31 02:11","ServerConfiguration.java","110781","46986","157767","","315534"
"2016-04-05 08:45","ServerConfiguration.java","107489","26995","134484","","268968"
"2016-11-09 03:02","ServerConfiguration.java","110692","39725","150417","","300834"
"2016-11-30 00:02","ServerConfiguration.java","110740","40455","151195","","302390"
"2017-06-05 20:30","ServerConfiguration.java","112959","67142","180101","","360202"
"2016-09-10 20:27","ServerConfiguration.java","109107","34351","143458","","286916"
"2017-08-02 00:49","ServerConfiguration.java","117108","96374","213482","","426964"
"2017-10-03 12:31","ServerConfiguration.java","124677","94100","218777","","437554"
"2017-08-16 03:37","ServerConfiguration.java","118703","104602","223305","","446610"
"2014-05-09 14:04","ServerConfiguration.java","270","3223","3493","7","6986"
"2017-05-26 12:38","ServerConfiguration.java","112065","65013","177078","","354156"
"2017-07-07 08:19","ServerConfiguration.java","113569","76592","190161","","380322"
"2017-06-28 23:24","ServerConfiguration.java","113153","70380","183533","","367066"
"2017-11-08 12:27","ServerConfiguration.java","126583","113880","240463","","480926"
"2014-08-02 20:02","ServerConfiguration.java","1358","10055","11413","","22826"
"2014-05-06 12:30","ServerConfiguration.java","3","50","53","7","106"
"2014-05-15 00:41","ServerConfiguration.java","32","993","1025","7","2050"
"2014-09-18 06:47","ServerConfiguration.java","1939","12645","14584","","29168"
"2017-07-04 06:27","ServerConfiguration.java","114104","72852","186956","","373912"
"2016-04-14 00:51","ServerConfiguration.java","108047","25533","133580","","267160"
"2015-01-16 15:57","ServerConfiguration.java","2571","16249","18820","","37640"
"2016-03-08 06:49","ServerConfiguration.java","3904","22016","25920","","51840"
"2016-01-26 22:11","ServerConfiguration.java","3562","20660","24222","","48444"
"2016-04-05 18:47","ServerConfiguration.java","108021","25457","133478","","266956"
"2016-04-27 09:55","ServerConfiguration.java","108100","26098","134198","","268396"
"2015-04-21 09:55","ServerConfiguration.java","2706","16825","19531","","39062"
"2015-01-12 15:18","ServerConfiguration.java","2563","15303","17866","","35732"
"2015-04-21 10:02","ServerConfiguration.java","2719","16871","19590","","39180"
"2017-05-15 19:52","ServerConfiguration.java","112434","60754","173188","","346376"
"2017-03-22 22:54","ServerConfiguration.java","111408","51670","163078","","326156"
"2017-03-23 00:48","ServerConfiguration.java","111413","51727","163140","","326280"
"2017-01-31 02:11","ServerConfiguration.java","111314","45207","156521","","313042"
"2016-04-05 08:45","ServerConfiguration.java","108011","25205","133216","","266432"
"2016-11-09 03:02","ServerConfiguration.java","111220","37941","149161","","298322"
"2016-11-30 00:02","ServerConfiguration.java","111268","38671","149939","","299878"
"2017-06-05 20:30","ServerConfiguration.java","113523","65394","178917","","357834"
"2016-09-10 20:27","ServerConfiguration.java","109630","32562","142192","","284384"
"2017-08-02 00:49","ServerConfiguration.java","117760","94714","212474","","424948"
"2017-10-03 12:31","ServerConfiguration.java","125346","92457","217803","","435606"
"2017-08-16 03:37","ServerConfiguration.java","119354","102941","222295","","444590"
"2014-05-09 14:04","ServerConfiguration.java","19","660","679","7","1358"
"2017-05-26 12:38","ServerConfiguration.java","112630","63266","175896","","351792"
"2017-07-07 08:19","ServerConfiguration.java","114136","74847","188983","","377966"
"2017-06-28 23:24","ServerConfiguration.java","113718","68633","182351","","364702"
"2017-11-08 12:27","ServerConfiguration.java","127251","112236","239487","","478974"
"2017-08-02 00:49","BookieNettyServer.java","117951","106392","224343","","448686"
"2013-10-02 06:23","BookieNettyServer.java","469","2251","2720","5","5440"
"2017-06-01 09:47","BookieNettyServer.java","113623","76395","190018","","380036"
"2013-10-11 16:18","BookieNettyServer.java","1361","3539","4900","6","9800"
"2017-05-15 19:52","BookieNettyServer.java","113469","73276","186745","","373490"
"2016-09-10 20:27","BookieNettyServer.java","111072","45491","156563","","313126"
"2017-01-31 02:14","BookieNettyServer.java","112582","58574","171156","","342312"
"2016-04-05 08:45","BookieNettyServer.java","109534","38215","147749","","295498"
"2017-03-23 00:48","BookieNettyServer.java","112676","64477","177153","","354306"
"2016-04-05 18:47","BookieNettyServer.java","109536","38459","147995","","295990"
"2014-01-21 05:05","BookieNettyServer.java","2302","9127","11429","6","22858"
"2013-01-07 22:53","AuditorBookieTest.java","1749","3973","5722","2","11444"
"2013-06-15 19:05","AuditorBookieTest.java","4352","44572","48924","5","97848"
"2014-02-05 22:43","AuditorBookieTest.java","6786","54980","61766","7","123532"
"2012-12-13 18:34","BookieReadWriteTest.java","17334","93996","111330","2","222660"
"2014-01-21 05:05","BookieReadWriteTest.java","18987","143720","162707","6","325414"
"2012-06-19 12:39","BookieReadWriteTest.java","12679","37919","50598","2","101196"
"2012-05-25 17:13","BookieReadWriteTest.java","12570","35414","47984","1","95968"
"2014-07-24 01:41","BookieReadWriteTest.java","19365","151005","170370","","340740"
"2012-02-13 11:19","BookieReadWriteTest.java","4520","16446","20966","1","41932"
"2013-05-31 12:02","BookieReadWriteTest.java","18788","132596","151384","5","302768"
"2012-12-13 18:34","BookieReadWriteTest.java","14564","96862","111426","2","222852"
"2011-09-05 19:38","BookieReadWriteTest.java","4875","10511","15386","","30772"
"2014-01-21 05:05","BookieReadWriteTest.java","16123","146492","162615","6","325230"
"2012-06-19 12:39","BookieReadWriteTest.java","10379","41255","51634","2","103268"
"2012-05-25 17:13","BookieReadWriteTest.java","10294","38774","49068","1","98136"
"2014-07-24 01:41","BookieReadWriteTest.java","16459","153735","170194","","340388"
"2012-02-13 11:19","BookieReadWriteTest.java","8611","26173","34784","1","69568"
"2013-05-31 12:02","BookieReadWriteTest.java","15944","135388","151332","5","302664"
"2017-07-17 23:27","FileInfo.java","424","3531","3955","","7910"
"2017-06-01 11:42","LedgerEntry.java","122","1066","1188","","2376"
"2017-05-15 19:52","AuthHandler.java","2090","15905","17995","","35990"
"2017-04-15 13:58","AuthHandler.java","680","11841","12521","","25042"
"2017-08-02 00:49","AuthHandler.java","9032","51481","60513","","121026"
"2017-06-01 23:58","AuthHandler.java","3292","20300","23592","","47184"
"2013-03-25 06:27","BookieZKExpireTest.java","13860","108681","122541","4","245082"
"2012-12-15 03:08","BookieZKExpireTest.java","11756","71510","83266","2","166532"
"2014-12-10 19:43","BookieZKExpireTest.java","15740","139516","155256","","310512"
"2016-01-26 22:11","BookieZKExpireTest.java","16006","145007","161013","","322026"
"2014-07-24 01:41","AuditorLedgerCheckerTest.java","404","889","1293","","2586"
"2016-03-08 07:18","AuditorLedgerCheckerTest.java","3826","20843","24669","","49338"
"2016-12-17 02:44","AuditorLedgerCheckerTest.java","111173","42554","153727","","307454"
"2017-07-07 05:11","AuditorLedgerCheckerTest.java","114055","72723","186778","","373556"
"2017-10-17 09:32","AuditorLedgerCheckerTest.java","126023","99228","225251","","450502"
"2017-05-12 15:20","AuditorLedgerCheckerTest.java","111927","57682","169609","","339218"
"2014-08-02 20:02","Journal.java","3047","17504","20551","","41102"
"2014-03-07 13:14","Journal.java","1831","5279","7110","7","14220"
"2014-04-29 22:07","Journal.java","2079","7839","9918","7","19836"
"2015-04-21 09:23","Journal.java","4042","23754","27796","","55592"
"2016-02-09 08:30","Journal.java","4943","27922","32865","","65730"
"2015-02-23 08:11","Journal.java","3992","23468","27460","","54920"
"2017-05-26 16:52","Journal.java","112795","69211","182006","","364012"
"2017-03-22 22:54","Journal.java","111706","57728","169434","","338868"
"2016-11-12 03:37","Journal.java","111541","44070","155611","","311222"
"2016-07-14 23:02","Journal.java","108861","33604","142465","","284930"
"2017-06-01 23:58","Journal.java","113548","70821","184369","","368738"
"2017-05-09 22:24","Journal.java","112247","64865","177112","","354224"
"2017-05-16 00:31","Journal.java","112739","67237","179976","","359952"
"2012-12-08 11:18","Bookie.java","1886","13080","14966","2","29932"
"2012-10-25 15:35","Bookie.java","313","1450","1763","2","3526"
"2012-10-26 16:25","Bookie.java","596","2682","3278","2","6556"
"2017-01-31 04:01","Bookie.java","72747","79684","152431","","304862"
"2017-03-28 22:37","Bookie.java","72842","84586","157428","","314856"
"2016-01-26 22:11","Bookie.java","10110","94171","104281","","208562"
"2015-03-18 07:38","Bookie.java","9648","90457","100105","","200210"
"2015-04-21 09:17","Bookie.java","9649","90560","100209","","200418"
"2012-12-03 17:59","Bookie.java","1184","12333","13517","2","27034"
"2013-06-21 19:26","Bookie.java","6316","61919","68235","5","136470"
"2014-09-23 17:53","Bookie.java","9331","87083","96414","","192828"
"2017-07-04 06:27","Bookie.java","74466","100177","174643","","349286"
"2017-06-05 22:25","Bookie.java","74247","94172","168419","","336838"
"2014-02-06 09:25","Bookie.java","8445","71903","80348","7","160696"
"2014-04-29 22:07","Bookie.java","8615","75578","84193","7","168386"
"2013-12-06 07:39","Bookie.java","7595","68798","76393","6","152786"
"2014-08-02 20:02","Bookie.java","9204","84864","94068","","188136"
"2013-10-02 07:01","Bookie.java","6555","64003","70558","5","141116"
"2017-06-28 23:24","Bookie.java","74280","96158","170438","","340876"
"2017-07-07 08:19","Bookie.java","74455","102129","176584","","353168"
"2013-09-11 00:34","Bookie.java","6524","63771","70295","5","140590"
"2014-01-21 17:26","Bookie.java","7840","70780","78620","6","157240"
"2013-10-12 05:42","Bookie.java","7324","65505","72829","6","145658"
"2013-10-22 16:21","Bookie.java","7532","66480","74012","6","148024"
"2017-05-16 00:31","Bookie.java","73492","89193","162685","","325370"
"2013-07-24 16:55","Bookie.java","6392","63053","69445","5","138890"
"2014-02-05 22:43","Bookie.java","8443","71893","80336","7","160672"
"2014-08-18 23:03","Bookie.java","9212","86340","95552","","191104"
"2014-05-09 14:04","Bookie.java","8629","76233","84862","7","169724"
"2013-06-15 19:05","Bookie.java","6299","61775","68074","5","136148"
"2017-06-01 23:58","Bookie.java","74177","92653","166830","","333660"
"2017-08-02 00:49","Bookie.java","75891","119808","195699","","391398"
"2013-12-02 18:45","Bookie.java","7581","68632","76213","6","152426"
"2013-05-04 14:22","Bookie.java","6070","57017","63087","5","126174"
"2012-12-18 13:04","Bookie.java","2494","18040","20534","2","41068"
"2016-11-18 00:18","Bookie.java","72694","66530","139224","","278448"
"2017-03-28 22:35","Bookie.java","72824","84353","157177","","314354"
"2016-07-14 23:02","Bookie.java","71542","57488","129030","","258060"
"2017-06-05 20:30","Bookie.java","74230","93064","167294","","334588"
"2016-11-30 00:02","Bookie.java","72711","67077","139788","","279576"
"2012-12-24 05:50","Bookie.java","3115","18769","21884","2","43768"
"2017-03-22 22:54","Bookie.java","72821","80046","152867","","305734"
"2012-12-24 06:23","Bookie.java","3180","19056","22236","2","44472"
"2017-06-05 22:25","BookKeeperServerStats.java","115568","59748","175316","","350632"
"2015-03-18 07:38","BookKeeperServerStats.java","1303","6367","7670","","15340"
"2017-08-16 03:41","BookKeeperServerStats.java","121494","96523","218017","","436034"
"2017-10-03 12:31","BookKeeperServerStats.java","130437","88766","219203","","438406"
"2014-05-12 08:10","InMemoryMetastoreTable.java","9324","68988","78312","7","156624"
"2012-12-03 15:04","InMemoryMetastoreTable.java","945","3490","4435","2","8870"
"2013-10-02 06:40","InMemoryMetastoreTable.java","7168","56252","63420","5","126840"
"2012-12-08 11:18","Bookie.java","1367","1412","2779","2","5558"
"2017-01-31 04:01","Bookie.java","79169","74957","154126","","308252"
"2017-03-28 22:37","Bookie.java","79258","79853","159111","","318222"
"2016-01-26 22:11","Bookie.java","10057","82969","93026","","186052"
"2015-03-18 07:38","Bookie.java","9513","79173","88686","","177372"
"2015-04-21 09:17","Bookie.java","9514","79276","88790","","177580"
"2013-06-21 19:26","Bookie.java","5991","50445","56436","5","112872"
"2014-09-23 17:53","Bookie.java","9185","75788","84973","","169946"
"2017-07-04 06:27","Bookie.java","80938","95500","176438","","352876"
"2017-06-05 22:25","Bookie.java","80716","89492","170208","","340416"
"2014-02-06 09:25","Bookie.java","8257","60566","68823","7","137646"
"2014-04-29 22:07","Bookie.java","8430","64244","72674","7","145348"
"2013-12-06 07:39","Bookie.java","7353","57407","64760","6","129520"
"2014-08-02 20:02","Bookie.java","9052","73563","82615","","165230"
"2013-10-02 07:01","Bookie.java","6258","52557","58815","5","117630"
"2017-06-28 23:24","Bookie.java","80752","91481","172233","","344466"
"2017-07-07 08:19","Bookie.java","80927","97452","178379","","356758"
"2013-09-11 00:34","Bookie.java","6225","52323","58548","5","117096"
"2014-01-21 17:26","Bookie.java","7600","59391","66991","6","133982"
"2013-10-12 05:42","Bookie.java","7114","54146","61260","6","122520"
"2013-10-22 16:21","Bookie.java","7289","55088","62377","6","124754"
"2017-05-16 00:31","Bookie.java","79925","84477","164402","","328804"
"2013-07-24 16:55","Bookie.java","6086","51598","57684","5","115368"
"2014-02-05 22:43","Bookie.java","8255","60556","68811","7","137622"
"2014-08-18 23:03","Bookie.java","9065","75044","84109","","168218"
"2014-05-09 14:04","Bookie.java","8444","64899","73343","7","146686"
"2013-06-15 19:05","Bookie.java","5974","50301","56275","5","112550"
"2017-06-01 23:58","Bookie.java","80641","87968","168609","","337218"
"2017-08-02 00:49","Bookie.java","83924","116692","200616","","401232"
"2013-12-02 18:45","Bookie.java","7339","57241","64580","6","129160"
"2013-05-04 14:22","Bookie.java","5727","45525","51252","5","102504"
"2012-12-18 13:04","Bookie.java","2009","6406","8415","2","16830"
"2016-11-18 00:18","Bookie.java","79115","61802","140917","","281834"
"2017-03-28 22:35","Bookie.java","79240","79620","158860","","317720"
"2016-07-14 23:02","Bookie.java","77962","52759","130721","","261442"
"2017-06-05 20:30","Bookie.java","80694","88379","169073","","338146"
"2016-11-30 00:02","Bookie.java","79133","62350","141483","","282966"
"2012-12-24 05:50","Bookie.java","2638","7143","9781","2","19562"
"2017-03-22 22:54","Bookie.java","79242","75318","154560","","309120"
"2012-12-24 06:23","Bookie.java","2712","7439","10151","2","20302"
"2015-07-10 22:48","ZooKeeperUtil.java","15412","136061","151473","","302946"
"2014-08-18 23:00","ZooKeeperUtil.java","15045","131354","146399","","292798"
"2014-12-10 19:43","ZooKeeperUtil.java","15296","133305","148601","","297202"
"2013-03-25 06:27","ZooKeeperUtil.java","12475","101529","114004","4","228008"
"2016-04-05 21:52","ZooKeeperUtil.java","48174","71749","119923","","239846"
"2012-11-21 12:24","ZooKeeperUtil.java","9154","56588","65742","2","131484"
"2017-06-30 00:12","ReadOnlyLedgerHandle.java","4415","21228","25643","","51286"
"2017-03-23 15:55","ReadOnlyLedgerHandle.java","201","567","768","","1536"
"2014-02-05 22:43","TestReplicationWorker.java","3429","15503","18932","7","37864"
"2013-06-15 19:05","TestReplicationWorker.java","154","4254","4408","5","8816"
"2016-04-27 09:00","TestReplicationWorker.java","109176","42262","151438","","302876"
"2015-07-10 22:48","TestReplicationWorker.java","5389","35489","40878","","81756"
"2014-07-24 01:41","TestReplicationWorker.java","4302","22134","26436","","52872"
"2016-11-12 03:35","PacketProcessorBaseV3.java","112797","31474","144271","","288542"
"2017-05-15 19:52","PacketProcessorBaseV3.java","114182","54435","168617","","337234"
"2015-10-06 10:05","PacketProcessorBaseV3.java","2400","9472","11872","","23744"
"2015-04-21 09:17","PacketProcessorBaseV3.java","1509","7390","8899","","17798"
"2017-06-05 22:25","PacketProcessorBaseV3.java","115485","60380","175865","","351730"
"2014-08-02 20:02","PacketProcessorBaseV3.java","165","795","960","","1920"
"2016-03-08 07:18","AuditorLedgerCheckerTest.java","3454","19986","23440","","46880"
"2016-12-17 02:44","AuditorLedgerCheckerTest.java","110959","41855","152814","","305628"
"2017-07-07 05:11","AuditorLedgerCheckerTest.java","113861","72044","185905","","371810"
"2017-10-17 09:32","AuditorLedgerCheckerTest.java","125860","98580","224440","","448880"
"2017-05-12 15:20","AuditorLedgerCheckerTest.java","111717","56987","168704","","337408"
"2012-12-13 18:34","BookieReadWriteTest.java","14620","96933","111553","2","223106"
"2011-09-05 19:38","BookieReadWriteTest.java","4941","10592","15533","","31066"
"2014-01-21 05:05","BookieReadWriteTest.java","16184","146568","162752","6","325504"
"2012-06-19 12:39","BookieReadWriteTest.java","10435","41326","51761","2","103522"
"2012-05-25 17:13","BookieReadWriteTest.java","10350","38845","49195","1","98390"
"2014-07-24 01:41","BookieReadWriteTest.java","16520","153811","170331","","340662"
"2012-02-13 11:19","BookieReadWriteTest.java","8669","26246","34915","1","69830"
"2013-05-31 12:02","BookieReadWriteTest.java","16005","135464","151469","5","302938"
"2013-10-22 16:21","HandleFactoryImpl.java","14515","117809","132324","6","264648"
"2012-04-17 12:18","HandleFactoryImpl.java","646","2700","3346","1","6692"
"2017-03-28 22:37","HandleFactoryImpl.java","46641","102731","149372","","298744"
"2017-06-01 23:58","EntryLogger.java","46903","113955","160858","","321716"
"2014-01-21 17:26","EntryLogger.java","19696","131212","150908","6","301816"
"2013-10-02 06:23","EntryLogger.java","19314","125148","144462","5","288924"
"2014-01-22 14:35","EntryLogger.java","19789","131681","151470","6","302940"
"2017-11-08 12:27","EntryLogger.java","49703","150227","199930","","399860"
"2013-10-22 07:44","EntryLogger.java","19501","126631","146132","6","292264"
"2012-03-16 10:41","EntryLogger.java","7134","10879","18013","1","36026"
"2012-06-13 16:57","EntryLogger.java","9750","20368","30118","","60236"
"2013-05-04 14:22","EntryLogger.java","19039","118562","137601","5","275202"
"2017-01-31 02:11","EntryLogger.java","45835","95267","141102","","282204"
"2017-03-23 00:48","EntryLogger.java","45859","101712","147571","","295142"
"2016-07-14 23:02","EntryLogger.java","45739","80261","126000","","252000"
"2012-12-24 06:23","EntryLogger.java","17233","81685","98918","2","197836"
"2012-12-10 11:04","EntryLogger.java","16751","76620","93371","2","186742"
"2016-02-24 00:44","EntryLogger.java","20880","154179","175059","","350118"
"2015-04-21 10:02","EntryLogger.java","20660","150351","171011","","342022"
"2012-10-18 16:40","EntryLogger.java","16175","64751","80926","2","161852"
"2012-07-26 04:32","EntryLogger.java","12207","32585","44792","2","89584"
"2013-01-04 11:32","EntryLogger.java","17513","83356","100869","2","201738"
"2015-04-21 09:44","EntryLogger.java","20658","150165","170823","","341646"
"2012-05-09 10:39","EntryLogger.java","8918","16366","25284","1","50568"
"2012-05-07 18:48","EntryLogger.java","8898","15922","24820","1","49640"
"2012-05-10 14:47","EntryLogger.java","9183","16917","26100","1","52200"
"2012-05-17 19:07","EntryLogger.java","9548","18337","27885","1","55770"
"2014-07-24 01:41","BookieReadWriteTest.java","2363","9270","11633","","23266"
"2017-05-15 19:52","AuthHandler.java","8066","38388","46454","","92908"
"2017-04-15 13:58","AuthHandler.java","6945","34613","41558","","83116"
"2017-01-31 02:14","AuthHandler.java","6379","22886","29265","","58530"
"2017-08-02 00:49","AuthHandler.java","14577","73533","88110","","176220"
"2017-06-01 23:58","AuthHandler.java","9212","42727","51939","","103878"
"2014-02-05 22:43","TestReplicationWorker.java","3442","11416","14858","7","29716"
"2016-04-27 09:00","TestReplicationWorker.java","109565","38551","148116","","296232"
"2015-07-10 22:48","TestReplicationWorker.java","5776","31776","37552","","75104"
"2014-07-24 01:41","TestReplicationWorker.java","4324","18056","22380","","44760"
"2015-09-15 10:38","BookKeeper.java","12460","122447","134907","","269814"
"2015-10-22 09:22","BookKeeper.java","12472","123839","136311","","272622"
"2017-01-31 04:01","BookKeeper.java","53961","89107","143068","","286136"
"2012-12-13 13:07","BookKeeper.java","6047","47374","53421","2","106842"
"2015-07-10 22:48","BookKeeper.java","12240","121925","134165","","268330"
"2017-06-30 00:12","BookKeeper.java","55274","107233","162507","","325014"
"2014-02-06 09:21","BookKeeper.java","11180","102843","114023","7","228046"
"2012-09-12 11:59","BookKeeper.java","1820","21786","23606","2","47212"
"2014-01-21 05:19","BookKeeper.java","10715","101571","112286","6","224572"
"2013-10-02 06:40","BookKeeper.java","9601","95152","104753","5","209506"
"2014-02-21 19:01","BookKeeper.java","11270","104092","115362","7","230724"
"2016-10-13 07:50","BookKeeper.java","53840","75430","129270","","258540"
"2017-06-21 21:00","BookKeeper.java","55257","104745","160002","","320004"
"2013-06-12 18:41","BookKeeper.java","9435","92693","102128","5","204256"
"2013-05-06 19:32","BookKeeper.java","9260","88516","97776","5","195552"
"2013-01-10 19:13","BookKeeper.java","7705","54003","61708","2","123416"
"2017-03-28 22:35","BookKeeper.java","54002","93740","147742","","295484"
"2016-07-11 23:01","BookKeeper.java","53391","67512","120903","","241806"
"2016-10-13 09:27","BookKeeper.java","53922","75498","129420","","258840"
"2017-07-28 20:12","BookKeeper.java","55938","114452","170390","","340780"
"2017-05-15 19:52","BookKeeper.java","54522","98014","152536","","305072"
"2013-09-10 15:14","BookKeeper.java","9561","94978","104539","5","209078"
"2014-12-10 19:43","LocalBookKeeper.java","6351","35759","42110","","84220"
"2015-07-10 22:48","LocalBookKeeper.java","6633","38681","45314","","90628"
"2017-05-26 12:38","LocalBookKeeper.java","112362","80533","192895","","385790"
"2017-06-01 11:31","LocalBookKeeper.java","112401","81486","193887","","387774"
"2017-06-01 23:58","LocalBookKeeper.java","113060","82108","195168","","390336"
"2017-06-21 21:00","CleanupLedgerManager.java","115113","57944","173057","","346114"
"2017-08-02 00:49","BookieNettyServer.java","7441","33110","40551","","81102"
"2017-06-01 08:55","PrometheusStatsLogger.java","388","2998","3386","","6772"
"2017-05-16 00:31","InterleavedLedgerStorage.java","2889","24754","27643","","55286"
"2017-07-04 06:27","InterleavedLedgerStorage.java","4948","36823","41771","","83542"
"2017-01-31 04:01","InterleavedLedgerStorage.java","779","13880","14659","","29318"
"2017-03-28 22:37","InterleavedLedgerStorage.java","1057","18965","20022","","40044"
"2017-08-02 00:49","BookieNettyServer.java","117797","104060","221857","","443714"
"2017-06-01 09:47","BookieNettyServer.java","113291","73885","187176","","374352"
"2017-05-15 19:52","BookieNettyServer.java","113129","70758","183887","","367774"
"2016-09-10 20:27","BookieNettyServer.java","110633","42874","153507","","307014"
"2017-01-31 02:14","BookieNettyServer.java","112158","55972","168130","","336260"
"2016-04-05 08:45","BookieNettyServer.java","109085","35588","144673","","289346"
"2017-03-23 00:48","BookieNettyServer.java","112258","61881","174139","","348278"
"2016-04-05 18:47","BookieNettyServer.java","109093","35838","144931","","289862"
"2014-01-21 05:05","BookieNettyServer.java","1289","5936","7225","6","14450"
"2017-05-16 00:31","EntryKeyValue.java","112644","61892","174536","","349072"
"2016-11-12 03:35","PacketProcessorBase.java","112797","31474","144271","","288542"
"2017-05-15 19:52","PacketProcessorBase.java","114182","54435","168617","","337234"
"2015-04-21 09:17","PacketProcessorBase.java","1509","7390","8899","","17798"
"2014-08-02 20:02","PacketProcessorBase.java","165","795","960","","1920"
"2017-05-15 19:52","BookKeeperClusterTestCase.java","8150","39276","47426","","94852"
"2017-08-01 08:34","BookKeeperClusterTestCase.java","13963","71138","85101","","170202"
"2017-11-08 12:27","BookKeeperClusterTestCase.java","29447","97238","126685","","253370"
"2017-07-04 06:27","BookKeeperClusterTestCase.java","10322","51876","62198","","124396"
"2017-06-30 00:12","BookKeeperClusterTestCase.java","10126","49719","59845","","119690"
"2016-04-27 09:55","BookKeeperClusterTestCase.java","242","1046","1288","","2576"
"2015-09-15 10:38","BookKeeper.java","8942","77602","86544","","173088"
"2015-10-22 09:22","BookKeeper.java","8971","79011","87982","","175964"
"2017-01-31 04:01","BookKeeper.java","79442","73261","152703","","305406"
"2015-07-10 22:48","BookKeeper.java","8563","76921","85484","","170968"
"2017-06-30 00:12","BookKeeper.java","81190","91822","173012","","346024"
"2014-02-06 09:21","BookKeeper.java","7026","57362","64388","7","128776"
"2014-01-21 05:19","BookKeeper.java","6235","55764","61999","6","123998"
"2013-10-02 06:40","BookKeeper.java","4929","49153","54082","5","108164"
"2014-02-21 19:01","BookKeeper.java","7134","58629","65763","7","131526"
"2016-10-13 07:50","BookKeeper.java","79281","59544","138825","","277650"
"2017-06-21 21:00","BookKeeper.java","81058","89219","170277","","340554"
"2013-06-12 18:41","BookKeeper.java","4604","46535","51139","5","102278"
"2013-05-06 19:32","BookKeeper.java","4379","42308","46687","5","93374"
"2013-01-10 19:13","BookKeeper.java","2502","7473","9975","2","19950"
"2017-03-28 22:35","BookKeeper.java","79513","77924","157437","","314874"
"2016-07-11 23:01","BookKeeper.java","78171","50965","129136","","258272"
"2016-10-13 09:27","BookKeeper.java","79395","59644","139039","","278078"
"2017-07-28 20:12","BookKeeper.java","81888","99075","180963","","361926"
"2017-05-15 19:52","BookKeeper.java","80125","82290","162415","","324830"
"2013-09-10 15:14","BookKeeper.java","4881","48971","53852","5","107704"
"2012-12-08 11:18","Bookie.java","7364","50163","57527","2","115054"
"2012-09-14 15:42","Bookie.java","3848","27346","31194","2","62388"
"2012-10-25 15:35","Bookie.java","6711","39453","46164","2","92328"
"2012-10-26 16:25","Bookie.java","6912","40603","47515","2","95030"
"2017-01-31 04:01","Bookie.java","51563","90105","141668","","283336"
"2017-03-28 22:37","Bookie.java","51622","94971","146593","","293186"
"2016-01-26 22:11","Bookie.java","13900","129566","143466","","286932"
"2015-03-18 07:38","Bookie.java","13558","125972","139530","","279060"
"2015-04-21 09:17","Bookie.java","13559","126075","139634","","279268"
"2012-10-18 16:40","Bookie.java","6592","38197","44789","2","89578"
"2012-12-03 17:59","Bookie.java","7222","49976","57198","2","114396"
"2012-07-23 23:39","Bookie.java","1880","5276","7156","2","14312"
"2013-06-21 19:26","Bookie.java","10992","98200","109192","5","218384"
"2012-09-07 07:04","Bookie.java","3394","26231","29625","2","59250"
"2014-09-23 17:53","Bookie.java","13329","122686","136015","","272030"
"2017-07-04 06:27","Bookie.java","52955","110271","163226","","326452"
"2017-06-05 22:25","Bookie.java","52819","104349","157168","","314336"
"2014-02-06 09:25","Bookie.java","12667","107730","120397","7","240794"
"2014-04-29 22:07","Bookie.java","12803","111371","124174","7","248348"
"2013-12-06 07:39","Bookie.java","12134","104942","117076","6","234152"
"2012-07-05 14:45","Bookie.java","22","504","526","2","1052"
"2014-08-02 20:02","Bookie.java","13262","120527","133789","","267578"
"2013-10-02 07:01","Bookie.java","11142","100195","111337","5","222674"
"2017-06-28 23:24","Bookie.java","52860","106343","159203","","318406"
"2017-07-07 08:19","Bookie.java","52951","112230","165181","","330362"
"2013-09-11 00:34","Bookie.java","11114","99966","111080","5","222160"
"2014-01-21 17:26","Bookie.java","12248","106793","119041","6","238082"
"2013-10-12 05:42","Bookie.java","11898","101684","113582","6","227164"
"2013-10-22 16:21","Bookie.java","12089","102642","114731","6","229462"
"2017-05-16 00:31","Bookie.java","52185","99491","151676","","303352"
"2013-07-24 16:55","Bookie.java","11042","99308","110350","5","220700"
"2014-02-05 22:43","Bookie.java","12665","107720","120385","7","240770"
"2014-08-18 23:03","Bookie.java","13270","122003","135273","","270546"
"2014-05-09 14:04","Bookie.java","12814","112023","124837","7","249674"
"2013-06-15 19:05","Bookie.java","10989","98070","109059","5","218118"
"2017-06-01 23:58","Bookie.java","52804","102885","155689","","311378"
"2017-08-02 00:49","Bookie.java","54262","129784","184046","","368092"
"2013-12-02 18:45","Bookie.java","12126","104782","116908","6","233816"
"2013-05-04 14:22","Bookie.java","10805","93357","104162","5","208324"
"2012-12-18 13:04","Bookie.java","7712","54863","62575","2","125150"
"2016-11-18 00:18","Bookie.java","51518","76959","128477","","256954"
"2017-03-28 22:35","Bookie.java","51604","94738","146342","","292684"
"2016-07-14 23:02","Bookie.java","51091","68642","119733","","239466"
"2017-06-05 20:30","Bookie.java","52804","103243","156047","","312094"
"2016-11-30 00:02","Bookie.java","51529","77500","129029","","258058"
"2012-12-24 05:50","Bookie.java","8305","55564","63869","2","127738"
"2017-03-22 22:54","Bookie.java","51606","90436","142042","","284084"
"2012-12-24 06:23","Bookie.java","8364","55845","64209","2","128418"
"2012-12-08 11:18","Bookie.java","5783","45186","50969","2","101938"
"2012-09-14 15:42","Bookie.java","2145","22247","24392","2","48784"
"2012-10-25 15:35","Bookie.java","5071","34417","39488","2","78976"
"2012-10-26 16:25","Bookie.java","5280","35575","40855","2","81710"
"2017-01-31 04:01","Bookie.java","53961","89107","143068","","286136"
"2017-03-28 22:37","Bookie.java","54020","93973","147993","","295986"
"2016-01-26 22:11","Bookie.java","12475","124745","137220","","274440"
"2015-03-18 07:38","Bookie.java","12095","121113","133208","","266416"
"2015-04-21 09:17","Bookie.java","12096","121216","133312","","266624"
"2012-10-18 16:40","Bookie.java","4951","33160","38111","2","76222"
"2012-12-03 17:59","Bookie.java","5640","44998","50638","2","101276"
"2013-06-21 19:26","Bookie.java","9447","93259","102706","5","205412"
"2012-09-07 07:04","Bookie.java","1681","21122","22803","2","45606"
"2014-09-23 17:53","Bookie.java","11840","117801","129641","","259282"
"2017-07-04 06:27","Bookie.java","55359","109279","164638","","329276"
"2017-06-05 22:25","Bookie.java","55223","103357","158580","","317160"
"2014-02-06 09:25","Bookie.java","11182","102849","114031","7","228062"
"2014-04-29 22:07","Bookie.java","11320","106492","117812","7","235624"
"2013-12-06 07:39","Bookie.java","10603","100015","110618","6","221236"
"2014-08-02 20:02","Bookie.java","11773","115642","127415","","254830"
"2013-10-02 07:01","Bookie.java","9602","95259","104861","5","209722"
"2017-06-28 23:24","Bookie.java","55264","105351","160615","","321230"
"2017-07-07 08:19","Bookie.java","55358","111241","166599","","333198"
"2013-09-11 00:34","Bookie.java","9573","95029","104602","5","209204"
"2014-01-21 17:26","Bookie.java","10758","101907","112665","6","225330"
"2013-10-12 05:42","Bookie.java","10361","96751","107112","6","214224"
"2013-10-22 16:21","Bookie.java","10553","97710","108263","6","216526"
"2017-05-16 00:31","Bookie.java","54588","98498","153086","","306172"
"2013-07-24 16:55","Bookie.java","9500","94370","103870","5","207740"
"2014-02-05 22:43","Bookie.java","11180","102839","114019","7","228038"
"2014-08-18 23:03","Bookie.java","11781","117118","128899","","257798"
"2014-05-09 14:04","Bookie.java","11331","107144","118475","7","236950"
"2013-06-15 19:05","Bookie.java","9444","93129","102573","5","205146"
"2017-06-01 23:58","Bookie.java","55207","101892","157099","","314198"
"2017-08-02 00:49","Bookie.java","56717","128843","185560","","371120"
"2013-12-02 18:45","Bookie.java","10593","99853","110446","6","220892"
"2013-05-04 14:22","Bookie.java","9260","88416","97676","5","195352"
"2012-12-18 13:04","Bookie.java","6134","49889","56023","2","112046"
"2016-11-18 00:18","Bookie.java","53915","75960","129875","","259750"
"2017-03-28 22:35","Bookie.java","54002","93740","147742","","295484"
"2016-07-14 23:02","Bookie.java","53441","67596","121037","","242074"
"2017-06-05 20:30","Bookie.java","55208","102251","157459","","314918"
"2016-11-30 00:02","Bookie.java","53926","76501","130427","","260854"
"2012-12-24 05:50","Bookie.java","6727","50590","57317","2","114634"
"2017-03-22 22:54","Bookie.java","54004","89438","143442","","286884"
"2012-12-24 06:23","Bookie.java","6786","50871","57657","2","115314"
"2015-09-15 10:38","LedgerManager.java","20183","158020","178203","","356406"
"2012-06-19 12:39","LedgerManager.java","10996","29863","40859","2","81718"
"2014-01-17 18:13","LedgerManager.java","19187","136997","156184","6","312368"
"2013-04-04 11:21","LedgerManager.java","18700","125150","143850","5","287700"
"2012-01-18 15:11","LedgerManager.java","829","2307","3136","1","6272"
"2012-12-24 05:50","LedgerManager.java","17146","88859","106005","2","212010"
"2014-08-18 23:00","ZooKeeperWatcherBase.java","5898","33606","39504","","79008"
"2015-07-10 22:48","ZooKeeperWatcherBase.java","6633","38681","45314","","90628"
"2017-06-01 23:58","ZooKeeperWatcherBase.java","113060","82108","195168","","390336"
"2016-11-09 08:44","LedgerHandleAdv.java","5507","13273","18780","","37560"
"2016-10-13 09:27","LedgerHandleAdv.java","5472","12891","18363","","36726"
"2017-05-25 14:23","LedgerHandleAdv.java","8004","39621","47625","","95250"
"2017-06-01 23:58","LedgerHandleAdv.java","8899","41427","50326","","100652"
"2017-07-04 06:27","GcLedgersTest.java","4475","18442","22917","","45834"
"2017-05-16 00:31","GcLedgersTest.java","2203","6160","8363","","16726"
"2016-04-27 09:55","GcLedgersTest.java","104977","4863","109840","","219680"
"2017-03-28 22:37","GcLedgersTest.java","110849","37518","148367","","296734"
"2017-07-04 06:27","GcLedgersTest.java","114212","54848","169060","","338120"
"2017-05-16 00:31","GcLedgersTest.java","112289","42915","155204","","310408"
"2017-06-12 17:20","LedgerManagerTestCase.java","1617","6169","7786","","15572"
"2017-07-04 06:27","LedgerManagerTestCase.java","2419","12429","14848","","29696"
"2016-11-09 08:44","LedgerHandleAdv.java","53","400","453","","906"
"2017-05-25 14:23","LedgerHandleAdv.java","3036","27234","30270","","60540"
"2017-06-01 23:58","LedgerHandleAdv.java","3946","29055","33001","","66002"
"2012-12-13 18:34","BookieReadWriteTest.java","9070","60492","69562","2","139124"
"2014-01-21 05:05","BookieReadWriteTest.java","13556","113049","126605","6","253210"
"2014-07-24 01:41","BookieReadWriteTest.java","14466","120866","135332","","270664"
"2013-05-31 12:02","BookieReadWriteTest.java","12335","100903","113238","5","226476"
"2017-08-16 03:41","TestRackawareEnsemblePlacementPolicyUsingScript.java","11842","62519","74361","","148722"
"2016-12-20 22:43","TestRackawareEnsemblePlacementPolicyUsingScript.java","24","119","143","","286"
"2012-12-18 13:04","LedgerDescriptorReadOnlyImpl.java","11114","71006","82120","2","164240"
"2012-04-17 12:18","LedgerDescriptorReadOnlyImpl.java","646","2700","3346","1","6692"
"2017-05-16 00:31","LedgerDescriptorReadOnlyImpl.java","47134","107181","154315","","308630"
"2017-01-31 04:01","Bookie.java","112604","63938","176542","","353084"
"2017-03-28 22:37","Bookie.java","112704","68845","181549","","363098"
"2016-01-26 22:11","Bookie.java","6261","34719","40980","","81960"
"2015-03-18 07:38","Bookie.java","5518","30724","36242","","72484"
"2015-04-21 09:17","Bookie.java","5520","30828","36348","","72696"
"2014-09-23 17:53","Bookie.java","5128","27277","32405","","64810"
"2017-07-04 06:27","Bookie.java","114859","84967","199826","","399652"
"2017-06-05 22:25","Bookie.java","114514","78836","193350","","386700"
"2014-02-06 09:25","Bookie.java","3437","11292","14729","7","29458"
"2014-04-29 22:07","Bookie.java","3812","15172","18984","7","37968"
"2013-12-06 07:39","Bookie.java","1959","7559","9518","6","19036"
"2014-08-02 20:02","Bookie.java","4627","24684","29311","","58622"
"2013-10-02 07:01","Bookie.java","498","2343","2841","5","5682"
"2017-06-28 23:24","Bookie.java","114586","80861","195447","","390894"
"2017-07-07 08:19","Bookie.java","114848","86919","201767","","403534"
"2013-09-11 00:34","Bookie.java","445","2089","2534","5","5068"
"2014-01-21 17:26","Bookie.java","2450","9787","12237","6","24474"
"2013-10-12 05:42","Bookie.java","1511","4089","5600","6","11200"
"2013-10-22 16:21","Bookie.java","1880","5225","7105","6","14210"
"2017-05-16 00:31","Bookie.java","113582","73680","187262","","374524"
"2013-07-24 16:55","Bookie.java","208","1266","1474","5","2948"
"2014-02-05 22:43","Bookie.java","3432","11279","14711","7","29422"
"2014-08-18 23:03","Bookie.java","5000","26525","31525","","63050"
"2014-05-09 14:04","Bookie.java","3830","15831","19661","7","39322"
"2017-06-01 23:58","Bookie.java","114359","77232","191591","","383182"
"2017-08-02 00:49","Bookie.java","117969","106283","224252","","448504"
"2013-12-02 18:45","Bookie.java","1942","7390","9332","6","18664"
"2016-11-18 00:18","Bookie.java","112544","50777","163321","","326642"
"2017-03-28 22:35","Bookie.java","112686","68612","181298","","362596"
"2016-07-14 23:02","Bookie.java","109877","40220","150097","","300194"
"2017-06-05 20:30","Bookie.java","114420","77651","192071","","384142"
"2016-11-30 00:02","Bookie.java","112570","51333","163903","","327806"
"2017-03-22 22:54","Bookie.java","112686","64308","176994","","353988"
"2015-10-06 10:05","BenchBookie.java","15890","138901","154791","","309582"
"2013-10-14 16:43","BenchBookie.java","14162","113286","127448","6","254896"
"2014-02-05 22:43","BenchBookie.java","14805","119164","133969","7","267938"
"2017-05-15 19:52","BenchBookie.java","48263","104455","152718","","305436"
"2016-07-14 23:02","BenchBookie.java","47652","74507","122159","","244318"
"2017-06-01 23:58","TopologyAwareEnsemblePlacementPolicy.java","4088","29183","33271","","66542"
"2014-02-05 22:43","AuditorBookieTest.java","3442","11416","14858","7","29716"
"2012-12-14 20:26","BookieShell.java","5443","28960","34403","2","68806"
"2016-02-09 08:28","BookieShell.java","12815","105770","118585","","237170"
"2016-03-16 05:03","BookieShell.java","65932","56154","122086","","244172"
"2014-12-06 07:47","BookieShell.java","12062","99297","111359","","222718"
"2014-12-06 08:03","BookieShell.java","12069","99508","111577","","223154"
"2014-09-29 16:29","BookieShell.java","12035","98917","110952","","221904"
"2014-06-03 12:35","BookieShell.java","11472","89431","100903","7","201806"
"2014-02-05 22:43","BookieShell.java","11186","83404","94590","7","189180"
"2013-10-02 06:54","BookieShell.java","9442","75576","85018","5","170036"
"2015-01-13 13:06","BookieShell.java","12284","101568","113852","","227704"
"2017-06-01 23:58","BookieShell.java","68549","95793","164342","","328684"
"2017-07-07 05:11","BookieShell.java","68758","104917","173675","","347350"
"2013-02-26 04:12","BookieShell.java","8537","66761","75298","4","150596"
"2017-01-11 07:37","BookieShell.java","67190","76581","143771","","287542"
"2016-12-21 01:42","BookieShell.java","67187","76220","143407","","286814"
"2017-01-11 07:34","BookieShell.java","67190","76457","143647","","287294"
"2016-11-30 00:02","BookieShell.java","67167","70301","137468","","274936"
"2017-01-30 23:25","BookieShell.java","67191","76757","143948","","287896"
"2017-03-28 22:35","BookieShell.java","67272","87569","154841","","309682"
"2017-01-30 21:31","BookieShell.java","67190","76648","143838","","287676"
"2017-03-22 22:54","BookieShell.java","67274","83267","150541","","301082"
"2017-06-21 19:58","BookieClientTest.java","3810","12887","16697","","33394"
"2017-05-15 19:52","BookieClientTest.java","2005","5759","7764","","15528"
"2016-02-09 08:12","BenchReadThroughputLatency.java","7186","41778","48964","","97928"
"2016-07-14 23:02","BenchReadThroughputLatency.java","110113","46631","156744","","313488"
"2013-10-29 05:14","BenchReadThroughputLatency.java","3763","13419","17182","6","34364"
"2013-10-14 16:43","BenchReadThroughputLatency.java","3517","12304","15821","6","31642"
"2012-07-27 15:51","TestBKStats.java","34","171","205","2","410"
"2013-01-07 12:25","ReadOnlyLedgerHandle.java","8898","58034","66932","2","133864"
"2015-10-06 10:05","ReadOnlyLedgerHandle.java","13863","127622","141485","","282970"
"2017-01-31 04:01","ReadOnlyLedgerHandle.java","51519","90113","141632","","283264"
"2014-01-17 18:13","ReadOnlyLedgerHandle.java","12152","105560","117712","6","235424"
"2017-06-30 00:12","ReadOnlyLedgerHandle.java","52827","108234","161061","","322122"
"2014-02-05 22:43","ReadOnlyLedgerHandle.java","12641","107748","120389","7","240778"
"2017-03-23 15:55","ReadOnlyLedgerHandle.java","51569","90529","142098","","284196"
"2016-02-23 19:16","LedgerMetadataImpl.java","13955","130303","144258","","288516"
"2012-09-12 11:59","LedgerMetadataImpl.java","3525","27269","30794","2","61588"
"2013-08-13 14:32","LedgerMetadataImpl.java","11051","99914","110965","5","221930"
"2017-06-01 23:58","LedgerMetadataImpl.java","52494","102957","155451","","310902"
"2013-03-25 18:02","LedgerMetadataImpl.java","10596","92807","103403","4","206806"
"2013-04-26 18:38","LedgerMetadataImpl.java","10629","93203","103832","5","207664"
"2017-07-28 20:12","LedgerMetadataImpl.java","53155","115447","168602","","337204"
"2016-07-11 23:01","LedgerMetadataImpl.java","50734","68633","119367","","238734"
"2012-07-18 17:00","LedgerMetadataImpl.java","1835","5545","7380","2","14760"
"2016-05-04 15:55","CompactionTest.java","105047","4956","110003","","220006"
"2017-03-22 22:54","CompactionTest.java","110842","32992","143834","","287668"
"2017-06-21 21:07","CompactionTest.java","113686","50255","163941","","327882"
"2017-11-08 12:27","CompactionTest.java","132573","99446","232019","","464038"
"2017-05-16 00:31","CompactionTest.java","112289","42915","155204","","310408"
"2017-07-07 08:19","CompactionTest.java","114263","56862","171125","","342250"
"2013-07-04 14:01","JournalChannel.java","4455","44717","49172","5","98344"
"2013-10-12 05:42","JournalChannel.java","5654","48289","53943","6","107886"
"2013-07-20 19:59","JournalChannel.java","4487","44986","49473","5","98946"
"2014-04-29 22:07","JournalChannel.java","7141","58558","65699","7","131398"
"2014-03-07 13:30","JournalChannel.java","6994","56099","63093","7","126186"
"2016-10-13 07:50","Node.java","112110","50442","162552","","325104"
"2015-04-21 09:17","CodahaleOpStatsTest.java","578","3316","3894","","7788"
"2017-03-22 22:54","Cookie.java","46132","99632","145764","","291528"
"2016-11-30 00:02","Cookie.java","46090","86731","132821","","265642"
"2014-02-05 22:43","Cookie.java","20024","129749","149773","7","299546"
"2014-05-09 14:04","Cookie.java","20124","134003","154127","7","308254"
"2012-09-07 07:04","Cookie.java","13103","50610","63713","2","127426"
"2014-09-23 17:53","Cookie.java","20598","144625","165223","","330446"
"2014-09-18 06:57","Cookie.java","20581","144552","165133","","330266"
"2014-12-06 08:03","Cookie.java","20624","145570","166194","","332388"
"2012-12-08 11:18","Cookie.java","16620","74089","90709","2","181418"
"2013-02-08 19:08","Cookie.java","17954","113657","131611","4","263222"
"2012-12-08 11:18","Bookie.java","5137","25099","30236","2","60472"
"2012-09-14 15:42","Bookie.java","623","1284","1907","2","3814"
"2012-10-25 15:35","Bookie.java","4206","14111","18317","2","36634"
"2012-10-26 16:25","Bookie.java","4463","15317","19780","2","39560"
"2017-01-31 04:01","Bookie.java","67202","82907","150109","","300218"
"2017-03-28 22:37","Bookie.java","67290","87802","155092","","310184"
"2016-01-26 22:11","Bookie.java","12736","105565","118301","","236602"
"2015-03-18 07:38","Bookie.java","12307","101884","114191","","228382"
"2015-04-21 09:17","Bookie.java","12308","101987","114295","","228590"
"2012-10-18 16:40","Bookie.java","4027","12795","16822","2","33644"
"2012-12-03 17:59","Bookie.java","4967","24884","29851","2","59702"
"2013-06-21 19:26","Bookie.java","9262","73633","82895","5","165790"
"2014-09-23 17:53","Bookie.java","12034","98554","110588","","221176"
"2017-07-04 06:27","Bookie.java","68767","103246","172013","","344026"
"2017-06-05 22:25","Bookie.java","68565","97258","165823","","331646"
"2014-02-06 09:25","Bookie.java","11188","83414","94602","7","189204"
"2014-04-29 22:07","Bookie.java","11339","87070","98409","7","196818"
"2013-12-06 07:39","Bookie.java","10456","80427","90883","6","181766"
"2014-08-02 20:02","Bookie.java","11918","96346","108264","","216528"
"2013-10-02 07:01","Bookie.java","9442","75658","85100","5","170200"
"2017-06-28 23:24","Bookie.java","68608","99254","167862","","335724"
"2017-07-07 08:19","Bookie.java","68758","105200","173958","","347916"
"2013-09-11 00:34","Bookie.java","9413","75428","84841","5","169682"
"2014-01-21 17:26","Bookie.java","10613","82321","92934","6","185868"
"2013-10-12 05:42","Bookie.java","10205","77154","87359","6","174718"
"2013-10-22 16:21","Bookie.java","10406","78122","88528","6","177056"
"2017-05-16 00:31","Bookie.java","67915","92384","160299","","320598"
"2013-07-24 16:55","Bookie.java","9317","74746","84063","5","168126"
"2014-02-05 22:43","Bookie.java","11186","83404","94590","7","189180"
"2014-08-18 23:03","Bookie.java","11926","97822","109748","","219496"
"2014-05-09 14:04","Bookie.java","11353","87725","99078","7","198156"
"2013-06-15 19:05","Bookie.java","9258","73502","82760","5","165520"
"2017-06-01 23:58","Bookie.java","68549","95793","164342","","328684"
"2017-08-02 00:49","Bookie.java","70174","122859","193033","","386066"
"2013-12-02 18:45","Bookie.java","10446","80265","90711","6","181422"
"2013-05-04 14:22","Bookie.java","9042","68757","77799","5","155598"
"2012-12-18 13:04","Bookie.java","5693","30007","35700","2","71400"
"2016-11-18 00:18","Bookie.java","67150","69754","136904","","273808"
"2017-03-28 22:35","Bookie.java","67272","87569","154841","","309682"
"2016-07-14 23:02","Bookie.java","66134","60848","126982","","253964"
"2017-06-05 20:30","Bookie.java","68550","96152","164702","","329404"
"2016-11-30 00:02","Bookie.java","67167","70301","137468","","274936"
"2012-12-24 05:50","Bookie.java","6295","30717","37012","2","74024"
"2017-03-22 22:54","Bookie.java","67274","83267","150541","","301082"
"2012-12-24 06:23","Bookie.java","6359","31003","37362","2","74724"
"2017-01-31 04:01","Bookie.java","112273","41458","153731","","307462"
"2017-03-28 22:37","Bookie.java","112492","46484","158976","","317952"
"2016-01-26 22:11","Bookie.java","1739","8048","9787","","19574"
"2015-03-18 07:38","Bookie.java","530","3587","4117","","8234"
"2015-04-21 09:17","Bookie.java","610","3769","4379","","8758"
"2017-07-04 06:27","Bookie.java","115595","63554","179149","","358298"
"2017-06-05 22:25","Bookie.java","115041","57214","172255","","344510"
"2017-06-28 23:24","Bookie.java","115146","59272","174418","","348836"
"2017-07-07 08:19","Bookie.java","115643","65565","181208","","362416"
"2017-05-16 00:31","Bookie.java","113813","51762","165575","","331150"
"2017-06-01 23:58","Bookie.java","114686","55410","170096","","340192"
"2017-08-02 00:49","Bookie.java","119395","85560","204955","","409910"
"2016-11-18 00:18","Bookie.java","112197","28281","140478","","280956"
"2017-03-28 22:35","Bookie.java","112452","46229","158681","","317362"
"2016-07-14 23:02","Bookie.java","107120","15314","122434","","244868"
"2017-06-05 20:30","Bookie.java","114804","55886","170690","","341380"
"2016-11-30 00:02","Bookie.java","112225","28839","141064","","282128"
"2017-03-22 22:54","Bookie.java","112395","41868","154263","","308526"
"2013-05-04 14:22","LedgerDeleteTest.java","6424","48913","55337","5","110674"
"2013-05-31 12:02","LedgerDeleteTest.java","6571","49489","56060","5","112120"
"2014-01-22 14:35","LedgerDeleteTest.java","8383","63241","71624","6","143248"
"2016-03-08 06:49","LedgerDeleteTest.java","10885","87502","98387","","196774"
"2014-07-24 01:41","LedgerDeleteTest.java","9488","70238","79726","","159452"
"2015-09-15 10:38","BookKeeper.java","492","794","1286","","2572"
"2015-10-22 09:22","BookKeeper.java","579","2261","2840","","5680"
"2017-01-31 04:01","BookKeeper.java","111440","36901","148341","","296682"
"2017-06-30 00:12","BookKeeper.java","114724","56998","171722","","343444"
"2016-10-13 07:50","BookKeeper.java","111182","23087","134269","","268538"
"2017-06-21 21:00","BookKeeper.java","114394","54197","168591","","337182"
"2017-03-28 22:35","BookKeeper.java","111639","41692","153331","","306662"
"2016-07-11 23:01","BookKeeper.java","106203","10639","116842","","233684"
"2016-10-13 09:27","BookKeeper.java","111304","23195","134499","","268998"
"2017-07-28 20:12","BookKeeper.java","116112","64941","181053","","362106"
"2017-05-15 19:52","BookKeeper.java","112885","46692","159577","","319154"
"2014-01-21 05:19","PerChannelBookieClient.java","10715","101571","112286","6","224572"
"2013-10-22 07:35","PerChannelBookieClient.java","10433","96935","107368","6","214736"
"2014-01-09 07:30","PerChannelBookieClient.java","10610","100034","110644","6","221288"
"2017-06-30 00:12","PerChannelBookieClient.java","55274","107233","162507","","325014"
"2014-05-27 13:56","PerChannelBookieClient.java","11368","107742","119110","7","238220"
"2017-07-04 06:27","PerChannelBookieClient.java","55359","109279","164638","","329276"
"2012-08-13 11:38","PerChannelBookieClient.java","576","6471","7047","2","14094"
"2017-01-31 04:01","PerChannelBookieClient.java","53961","89107","143068","","286136"
"2015-10-06 10:05","PerChannelBookieClient.java","12462","122773","135235","","270470"
"2016-04-05 18:47","PerChannelBookieClient.java","53274","65882","119156","","238312"
"2017-04-15 13:58","PerChannelBookieClient.java","54072","94910","148982","","297964"
"2017-05-15 19:52","PerChannelBookieClient.java","54522","98014","152536","","305072"
"2012-12-01 15:04","PerChannelBookieClient.java","5611","44598","50209","2","100418"
"2016-04-05 08:45","PerChannelBookieClient.java","53272","65638","118910","","237820"
"2017-07-28 20:12","PerChannelBookieClient.java","55938","114452","170390","","340780"
"2017-01-31 02:14","PerChannelBookieClient.java","53949","83626","137575","","275150"
"2017-03-28 22:35","PerChannelBookieClient.java","54002","93740","147742","","295484"
"2017-03-23 00:48","PerChannelBookieClient.java","54008","89494","143502","","287004"
"2013-01-10 19:13","PerChannelBookieClient.java","7705","54003","61708","2","123416"
"2014-07-25 00:34","PerChannelBookieClient.java","11758","114997","126755","","253510"
"2017-08-02 00:49","PerChannelBookieClient.java","56717","128843","185560","","371120"
"2017-06-21 19:58","PerChannelBookieClient.java","55254","104069","159323","","318646"
"2017-06-01 23:58","PerChannelBookieClient.java","55207","101892","157099","","314198"
"2013-10-29 05:14","PerChannelBookieClient.java","10592","97885","108477","6","216954"
"2013-06-28 17:27","PerChannelBookieClient.java","9467","93461","102928","5","205856"
"2014-02-21 19:01","PerChannelBookieClient.java","11270","104092","115362","7","230724"
"2014-02-05 22:43","PerChannelBookieClient.java","11180","102839","114019","7","228038"
"2017-04-20 19:55","PerChannelBookieClient.java","54073","94932","149005","","298010"
"2013-09-11 00:34","PerChannelBookieClient.java","9573","95029","104602","5","209204"
"2013-08-20 12:51","PerChannelBookieClient.java","9526","94695","104221","5","208442"
"2017-06-01 23:58","EntryLogger.java","3753","21373","25126","","50252"
"2017-11-08 12:27","EntryLogger.java","32346","83438","115784","","231568"
"2017-03-23 00:48","EntryLogger.java","744","7165","7909","","15818"
"2016-07-11 23:01","LedgerCreateOp.java","107874","30336","138210","","276420"
"2015-09-15 10:38","LedgerCreateOp.java","3701","22029","25730","","51460"
"2015-04-21 09:17","LedgerCreateOp.java","2945","20406","23351","","46702"
"2015-10-22 09:22","LedgerCreateOp.java","3774","23482","27256","","54512"
"2014-01-21 05:19","PerChannelBookieClient.java","10405","95366","105771","6","211542"
"2013-10-22 07:35","PerChannelBookieClient.java","10123","90730","100853","6","201706"
"2014-01-09 07:30","PerChannelBookieClient.java","10300","93829","104129","6","208258"
"2017-06-30 00:12","PerChannelBookieClient.java","61005","107069","168074","","336148"
"2014-05-27 13:56","PerChannelBookieClient.java","11077","101556","112633","7","225266"
"2017-07-04 06:27","PerChannelBookieClient.java","61090","109115","170205","","340410"
"2017-01-31 04:01","PerChannelBookieClient.java","59691","88942","148633","","297266"
"2015-10-06 10:05","PerChannelBookieClient.java","12202","116618","128820","","257640"
"2016-04-05 18:47","PerChannelBookieClient.java","59001","65714","124715","","249430"
"2017-04-15 13:58","PerChannelBookieClient.java","59802","94745","154547","","309094"
"2017-05-15 19:52","PerChannelBookieClient.java","60253","97850","158103","","316206"
"2012-12-01 15:04","PerChannelBookieClient.java","5248","38340","43588","2","87176"
"2016-04-05 08:45","PerChannelBookieClient.java","58999","65470","124469","","248938"
"2017-07-28 20:12","PerChannelBookieClient.java","61669","114288","175957","","351914"
"2017-01-31 02:14","PerChannelBookieClient.java","59679","83461","143140","","286280"
"2017-03-28 22:35","PerChannelBookieClient.java","59732","93575","153307","","306614"
"2017-03-23 00:48","PerChannelBookieClient.java","59738","89329","149067","","298134"
"2013-01-10 19:13","PerChannelBookieClient.java","7372","47775","55147","2","110294"
"2014-07-25 00:34","PerChannelBookieClient.java","11484","108828","120312","","240624"
"2017-08-02 00:49","PerChannelBookieClient.java","62451","128682","191133","","382266"
"2017-06-21 19:58","PerChannelBookieClient.java","60985","103905","164890","","329780"
"2017-06-01 23:58","PerChannelBookieClient.java","60938","101728","162666","","325332"
"2013-10-29 05:14","PerChannelBookieClient.java","10282","91680","101962","6","203924"
"2013-06-28 17:27","PerChannelBookieClient.java","9155","87254","96409","5","192818"
"2014-02-21 19:01","PerChannelBookieClient.java","10969","97896","108865","7","217730"
"2014-02-05 22:43","PerChannelBookieClient.java","10878","96642","107520","7","215040"
"2017-04-20 19:55","PerChannelBookieClient.java","59803","94767","154570","","309140"
"2013-09-11 00:34","PerChannelBookieClient.java","9263","88824","98087","5","196174"
"2013-08-20 12:51","PerChannelBookieClient.java","9216","88490","97706","5","195412"
"2015-09-15 10:38","LedgerManager.java","15234","134204","149438","","298876"
"2014-01-17 18:13","LedgerManager.java","13555","112498","126053","6","252106"
"2013-04-04 11:21","LedgerManager.java","12029","99612","111641","5","223282"
"2012-12-24 05:50","LedgerManager.java","9710","62556","72266","2","144532"
"2017-03-23 00:48","ClientConfiguration.java","1145","15041","16186","","32372"
"2017-03-28 22:35","ClientConfiguration.java","1240","19388","20628","","41256"
"2017-01-31 02:14","ClientConfiguration.java","936","9023","9959","","19918"
"2017-04-15 13:58","ClientConfiguration.java","1575","20823","22398","","44796"
"2017-03-23 00:59","ClientConfiguration.java","1158","15066","16224","","32448"
"2017-05-15 19:52","ClientConfiguration.java","2924","24826","27750","","55500"
"2017-06-21 19:58","ClientConfiguration.java","4584","31809","36393","","72786"
"2017-06-05 21:48","ClientConfiguration.java","4262","30099","34361","","68722"
"2017-06-21 19:50","ClientConfiguration.java","4578","31693","36271","","72542"
"2017-08-02 00:49","ClientConfiguration.java","9547","60083","69630","","139260"
"2017-08-01 08:34","ClientConfiguration.java","8845","56796","65641","","131282"
"2017-06-30 00:12","ClientConfiguration.java","4934","35303","40237","","80474"
"2017-07-04 06:27","ClientConfiguration.java","5141","37471","42612","","85224"
"2017-01-31 04:01","ClientConfiguration.java","1002","14558","15560","","31120"
"2017-08-16 03:41","TestRackawareEnsemblePlacementPolicyUsingScript.java","11823","62405","74228","","148456"
"2017-08-02 00:49","ClientConfiguration.java","5992","29303","35295","","70590"
"2017-08-01 08:34","ClientConfiguration.java","5055","25781","30836","","61672"
"2017-06-30 00:12","ClientConfiguration.java","415","3559","3974","","7948"
"2017-07-04 06:27","ClientConfiguration.java","754","5859","6613","","13226"
"2017-03-23 15:58","LocalBookiesRegistry.java","2580","20047","22627","","45254"
"2017-07-04 06:27","FileInfo.java","75679","99864","175543","","351086"
"2014-12-04 12:28","FileInfo.java","9467","86245","95712","","191424"
"2017-01-31 04:01","FileInfo.java","73947","79358","153305","","306610"
"2017-03-23 15:55","FileInfo.java","74028","79805","153833","","307666"
"2016-11-18 00:18","FileInfo.java","73894","66204","140098","","280196"
"2012-12-18 13:04","FileInfo.java","2483","16503","18986","2","37972"
"2013-05-04 14:22","FileInfo.java","6127","55548","61675","5","123350"
"2017-06-01 23:58","FileInfo.java","75384","92334","167718","","335436"
"2017-07-17 23:27","FileInfo.java","75747","103039","178786","","357572"
"2017-05-16 00:31","FileInfo.java","74698","88873","163571","","327142"
"2013-10-22 16:21","FileInfo.java","7649","65071","72720","6","145440"
"2013-10-11 08:36","FileInfo.java","7349","63463","70812","6","141624"
"2012-12-18 13:04","LedgerDescriptorReadOnlyImpl.java","10762","68600","79362","2","158724"
"2017-05-16 00:31","LedgerDescriptorReadOnlyImpl.java","48024","106017","154041","","308082"
"2013-04-04 11:21","LedgerManagerTestCase.java","3159","37896","41055","5","82110"
"2017-06-12 17:20","LedgerManagerTestCase.java","81715","86314","168029","","336058"
"2017-05-16 00:31","LedgerManagerTestCase.java","80826","80873","161699","","323398"
"2016-11-18 00:18","LedgerManagerTestCase.java","79935","58117","138052","","276104"
"2017-01-31 04:01","LedgerManagerTestCase.java","79989","71272","151261","","302522"
"2017-03-28 22:37","LedgerManagerTestCase.java","80079","76169","156248","","312496"
"2015-09-15 10:38","LedgerManagerTestCase.java","8247","74371","82618","","165236"
"2016-04-27 09:55","LedgerManagerTestCase.java","78445","47752","126197","","252394"
"2017-07-04 06:27","LedgerManagerTestCase.java","81993","92050","174043","","348086"
"2017-07-07 08:19","Bookie.java","141","2104","2245","","4490"
"2017-08-02 00:49","Bookie.java","5371","23577","28948","","57896"
"2017-08-02 00:49","BookieAuthProvider.java","14572","74332","88904","","177808"
"2017-07-28 20:12","BookieAuthProvider.java","11588","57736","69324","","138648"
"2017-01-31 02:14","BookieAuthProvider.java","6577","23888","30465","","60930"
"2017-06-01 23:58","EntryLogger.java","3366","14565","17931","","35862"
"2017-11-08 12:27","EntryLogger.java","35665","80336","116001","","232002"
"2014-07-24 01:41","ConditionalSetTest.java","19016","148315","167331","","334662"
"2011-11-18 11:18","ConditionalSetTest.java","717","2005","2722","","5444"
"2015-10-06 10:05","WriteEntryProcessor.java","2272","8714","10986","","21972"
"2015-04-21 09:17","WriteEntryProcessor.java","1381","6632","8013","","16026"
"2017-05-15 19:52","WriteEntryProcessor.java","114187","53810","167997","","335994"
"2017-03-23 00:48","ClientConfiguration.java","111708","59901","171609","","343218"
"2016-04-05 08:45","ClientConfiguration.java","108492","33565","142057","","284114"
"2017-03-28 22:35","ClientConfiguration.java","111704","64149","175853","","351706"
"2017-01-31 02:14","ClientConfiguration.java","111607","53991","165598","","331196"
"2017-04-15 13:58","ClientConfiguration.java","111850","65395","177245","","354490"
"2017-03-23 00:59","ClientConfiguration.java","111713","59918","171631","","343262"
"2017-05-15 19:52","ClientConfiguration.java","112611","68810","181421","","362842"
"2016-10-13 07:50","ClientConfiguration.java","111429","45726","157155","","314310"
"2017-06-21 19:58","ClientConfiguration.java","113789","75311","189100","","378200"
"2017-06-05 21:48","ClientConfiguration.java","113629","73763","187392","","374784"
"2017-06-21 19:50","ClientConfiguration.java","113783","75195","188978","","377956"
"2017-08-02 00:49","ClientConfiguration.java","117487","102320","219807","","439614"
"2017-08-01 08:34","ClientConfiguration.java","116950","99198","216148","","432296"
"2014-05-27 13:56","ClientConfiguration.java","2318","11399","13717","7","27434"
"2017-06-30 00:12","ClientConfiguration.java","113986","78652","192638","","385276"
"2014-09-18 06:47","ClientConfiguration.java","3557","22142","25699","","51398"
"2017-07-04 06:27","ClientConfiguration.java","114120","80747","194867","","389734"
"2017-01-31 04:01","ClientConfiguration.java","111616","59469","171085","","342170"
"2015-10-06 10:05","ClientConfiguration.java","4815","27833","32648","","65296"
"2015-10-06 10:48","ClientConfiguration.java","4818","28062","32880","","65760"
"2016-02-09 08:32","ClientConfiguration.java","4976","30085","35061","","70122"
"2014-12-06 07:54","ClientConfiguration.java","3677","23180","26857","","53714"
"2016-08-01 08:04","ClientConfiguration.java","108882","36409","145291","","290582"
"2013-01-07 12:25","ReadOnlyLedgerHandle.java","10906","67973","78879","2","157758"
"2015-10-06 10:05","ReadOnlyLedgerHandle.java","15584","137274","152858","","305716"
"2017-01-31 04:01","ReadOnlyLedgerHandle.java","48182","94707","142889","","285778"
"2012-06-29 18:43","ReadOnlyLedgerHandle.java","2417","10348","12765","2","25530"
"2014-01-17 18:13","ReadOnlyLedgerHandle.java","14025","115364","129389","6","258778"
"2017-06-30 00:12","ReadOnlyLedgerHandle.java","49423","112761","162184","","324368"
"2014-02-05 22:43","ReadOnlyLedgerHandle.java","14477","117515","131992","7","263984"
"2017-03-23 15:55","ReadOnlyLedgerHandle.java","48220","95111","143331","","286662"
"2012-09-12 11:59","RoundRobinDistributionSchedule.java","1356","12885","14241","2","28482"
"2014-12-05 17:51","RoundRobinDistributionSchedule.java","11747","109901","121648","","243296"
"2017-06-30 00:12","RoundRobinDistributionSchedule.java","61527","105049","166576","","333152"
"2017-06-21 19:58","ClientConfiguration.java","363","1751","2114","","4228"
"2017-06-21 19:50","ClientConfiguration.java","353","1631","1984","","3968"
"2017-08-02 00:49","ClientConfiguration.java","6331","31030","37361","","74722"
"2017-08-01 08:34","ClientConfiguration.java","5394","27508","32902","","65804"
"2017-06-30 00:12","ClientConfiguration.java","764","5296","6060","","12120"
"2017-07-04 06:27","ClientConfiguration.java","1096","7589","8685","","17370"
"2017-08-02 00:49","ClientConfiguration.java","6003","29424","35427","","70854"
"2017-08-01 08:34","ClientConfiguration.java","5066","25902","30968","","61936"
"2017-06-30 00:12","ClientConfiguration.java","428","3682","4110","","8220"
"2017-07-04 06:27","ClientConfiguration.java","765","5980","6745","","13490"
"2013-10-12 05:42","BookieJournalRollingTest.java","1664","8469","10133","6","20266"
"2014-07-24 01:41","BookieJournalRollingTest.java","4302","22134","26436","","52872"
"2015-10-06 10:05","BenchBookie.java","16188","140909","157097","","314194"
"2012-05-09 13:20","BenchBookie.java","918","2628","3546","1","7092"
"2013-10-14 16:43","BenchBookie.java","14508","115342","129850","6","259700"
"2014-02-05 22:43","BenchBookie.java","15142","121211","136353","7","272706"
"2017-05-15 19:52","BenchBookie.java","47971","105873","153844","","307688"
"2016-07-14 23:02","BenchBookie.java","47388","75953","123341","","246682"
"2016-02-09 08:28","BookieShell.java","1840","7913","9753","","19506"
"2016-03-16 05:03","BookieShell.java","106624","9964","116588","","233176"
"2014-12-06 07:47","BookieShell.java","75","428","503","","1006"
"2014-12-06 08:03","BookieShell.java","87","644","731","","1462"
"2015-01-13 13:06","BookieShell.java","467","2869","3336","","6672"
"2017-06-01 23:58","BookieShell.java","114699","55061","169760","","339520"
"2017-07-07 05:11","BookieShell.java","115644","64921","180565","","361130"
"2017-01-11 07:37","BookieShell.java","112275","34784","147059","","294118"
"2016-12-21 01:42","BookieShell.java","112264","34415","146679","","293358"
"2017-01-11 07:34","BookieShell.java","112275","34660","146935","","293870"
"2016-11-30 00:02","BookieShell.java","112231","28483","140714","","281428"
"2017-01-30 23:25","BookieShell.java","112280","34964","147244","","294488"
"2017-03-28 22:35","BookieShell.java","112464","45879","158343","","316686"
"2017-01-30 21:31","BookieShell.java","112277","34853","147130","","294260"
"2017-03-22 22:54","BookieShell.java","112407","41518","153925","","307850"
"2016-03-08 06:49","CompactionTest.java","1726","6160","7886","","15772"
"2015-04-21 09:55","CompactionTest.java","191","632","823","","1646"
"2016-05-04 15:55","CompactionTest.java","106502","10845","117347","","234694"
"2017-03-22 22:54","CompactionTest.java","112112","38696","150808","","301616"
"2017-06-21 21:07","CompactionTest.java","114856","55859","170715","","341430"
"2017-11-08 12:27","CompactionTest.java","132737","104044","236781","","473562"
"2017-05-16 00:31","CompactionTest.java","113536","48596","162132","","324264"
"2017-07-07 08:19","CompactionTest.java","115408","62441","177849","","355698"
"2014-02-05 22:43","TestReplicationWorker.java","6786","54980","61766","7","123532"
"2013-05-31 12:02","TestReplicationWorker.java","4249","40369","44618","5","89236"
"2013-06-15 19:05","TestReplicationWorker.java","4352","44572","48924","5","97848"
"2013-01-14 16:59","TestReplicationWorker.java","2346","5805","8151","2","16302"
"2016-04-27 09:00","TestReplicationWorker.java","78924","48130","127054","","254108"
"2015-07-10 22:48","TestReplicationWorker.java","8421","74641","83062","","166124"
"2014-07-24 01:41","TestReplicationWorker.java","7530","61482","69012","","138024"
"2015-10-06 10:05","TestPerChannelBookieClient.java","2948","15842","18790","","37580"
"2017-05-16 00:31","TestPerChannelBookieClient.java","112271","58764","171035","","342070"
"2017-01-31 02:14","TestPerChannelBookieClient.java","110985","43245","154230","","308460"
"2016-04-05 08:45","TestPerChannelBookieClient.java","107629","22578","130207","","260414"
"2017-05-15 19:52","TestPerChannelBookieClient.java","112131","58206","170337","","340674"
"2017-10-17 09:32","AuditorElector.java","28066","84048","112114","","224228"
"2016-09-10 21:01","AuditorElector.java","3819","7889","11708","","23416"
"2017-03-28 22:40","AuditorElector.java","6459","32485","38944","","77888"
"2017-10-17 09:32","AuditorElector.java","31303","83215","114518","","229036"
"2017-03-28 22:40","AuditorElector.java","2750","24706","27456","","54912"
"2017-06-01 23:58","SASLBookieAuthProviderFactory.java","1148","2055","3203","","6406"
"2017-08-02 00:49","BookieNettyServer.java","7739","36373","44112","","88224"
"2017-06-01 09:47","BookieNettyServer.java","411","3376","3787","","7574"
"2016-02-24 00:44","TestEntryLog.java","1545","7432","8977","","17954"
"2017-05-16 00:31","TestEntryLog.java","113453","50318","163771","","327542"
"2017-07-07 08:19","TestEntryLog.java","115313","64151","179464","","358928"
"2017-06-05 22:25","BookKeeperServerStats.java","114806","53922","168728","","337456"
"2017-08-16 03:41","BookKeeperServerStats.java","121546","91511","213057","","426114"
"2017-10-03 12:31","BookKeeperServerStats.java","130621","83886","214507","","429014"
"2012-07-23 23:39","LocalBookKeeper.java","4751","17384","22135","2","44270"
"2014-12-10 19:43","LocalBookKeeper.java","15598","135276","150874","","301748"
"2013-02-08 19:08","LocalBookKeeper.java","11785","102055","113840","4","227680"
"2015-07-10 22:48","LocalBookKeeper.java","15701","138019","153720","","307440"
"2017-05-26 12:38","LocalBookKeeper.java","48366","106807","155173","","310346"
"2017-06-01 11:31","LocalBookKeeper.java","48401","107756","156157","","312314"
"2017-06-01 23:58","LocalBookKeeper.java","48943","108261","157204","","314408"
"2013-01-14 16:59","LocalBookKeeper.java","11634","71191","82825","2","165650"
"2017-03-22 22:54","FileSystemUpgrade.java","6252","27531","33783","","67566"
"2012-12-18 12:00","BookKeeperClusterTestCase.java","11770","71966","83736","2","167472"
"2017-05-15 19:52","BookKeeperClusterTestCase.java","46945","107168","154113","","308226"
"2013-01-09 17:18","BookKeeperClusterTestCase.java","12663","75254","87917","2","175834"
"2016-04-05 08:45","BookKeeperClusterTestCase.java","46282","75379","121661","","243322"
"2012-03-31 10:58","BookKeeperClusterTestCase.java","1252","3399","4651","1","9302"
"2017-08-01 08:34","BookKeeperClusterTestCase.java","48398","134670","183068","","366136"
"2013-10-12 05:42","BookKeeperClusterTestCase.java","14365","117486","131851","6","263702"
"2014-02-05 22:43","BookKeeperClusterTestCase.java","14988","123378","138366","7","276732"
"2017-11-08 12:27","BookKeeperClusterTestCase.java","50530","147418","197948","","395896"
"2013-06-15 19:05","BookKeeperClusterTestCase.java","14113","114529","128642","5","257284"
"2014-05-09 14:04","BookKeeperClusterTestCase.java","15089","127633","142722","7","285444"
"2012-12-12 11:20","BookKeeperClusterTestCase.java","11558","68845","80403","2","160806"
"2012-09-12 11:59","BookKeeperClusterTestCase.java","8007","44704","52711","2","105422"
"2017-07-04 06:27","BookKeeperClusterTestCase.java","47683","118334","166017","","332034"
"2014-07-24 01:41","BookKeeperClusterTestCase.java","15357","129505","144862","","289724"
"2014-05-23 18:46","BookKeeperClusterTestCase.java","15089","127963","143052","7","286104"
"2017-06-30 00:12","BookKeeperClusterTestCase.java","47619","116309","163928","","327856"
"2014-04-24 10:43","BookKeeperClusterTestCase.java","15054","126579","141633","7","283266"
"2012-12-13 12:33","BookKeeperClusterTestCase.java","11711","69239","80950","2","161900"
"2013-01-07 12:25","BookKeeperClusterTestCase.java","12405","74824","87229","2","174458"
"2016-04-27 09:55","BookKeeperClusterTestCase.java","46300","76201","122501","","245002"
"2013-01-03 11:06","BookKeeperClusterTestCase.java","12361","73753","86114","2","172228"
"2015-10-06 10:48","BookKeeperClusterTestCase.java","15992","143260","159252","","318504"
"2014-12-10 19:43","BookKeeperClusterTestCase.java","15740","139516","155256","","310512"
"2014-07-24 01:41","TestWatchEnsembleChange.java","1183","6941","8124","","16248"
"2014-05-12 08:10","TestWatchEnsembleChange.java","523","4995","5518","7","11036"
"2015-09-15 10:38","TestWatchEnsembleChange.java","3701","22029","25730","","51460"
"2017-06-01 23:58","ReplicationWorker.java","5430","33890","39320","","78640"
"2017-04-11 20:14","ReplicationWorker.java","2808","24780","27588","","55176"
"2017-05-26 16:52","ReplicationWorker.java","4545","32148","36693","","73386"
"2017-05-16 00:31","BookieProtocol.java","8327","39871","48198","","96396"
"2017-06-01 21:20","BookieProtocol.java","9111","42982","52093","","104186"
"2017-05-15 19:52","BookieProtocol.java","8150","39276","47426","","94852"
"2017-06-05 22:25","BookieProtocol.java","9705","45473","55178","","110356"
"2016-02-09 08:28","BookieShell.java","3472","18468","21940","","43880"
"2016-03-16 05:03","BookieShell.java","107839","20102","127941","","255882"
"2014-12-06 07:47","BookieShell.java","1941","11217","13158","","26316"
"2014-12-06 08:03","BookieShell.java","1949","11429","13378","","26756"
"2014-09-29 16:29","BookieShell.java","1868","10791","12659","","25318"
"2015-01-13 13:06","BookieShell.java","2319","13644","15963","","31926"
"2017-06-01 23:58","BookieShell.java","113325","62610","175935","","351870"
"2017-07-07 05:11","BookieShell.java","114068","72268","186336","","372672"
"2017-01-11 07:37","BookieShell.java","111195","42627","153822","","307644"
"2016-12-21 01:42","BookieShell.java","111186","42260","153446","","306892"
"2017-01-11 07:34","BookieShell.java","111195","42503","153698","","307396"
"2016-11-30 00:02","BookieShell.java","111153","36328","147481","","294962"
"2017-01-30 23:25","BookieShell.java","111200","42807","154007","","308014"
"2017-03-28 22:35","BookieShell.java","111317","53655","164972","","329944"
"2017-01-30 21:31","BookieShell.java","111197","42696","153893","","307786"
"2017-03-22 22:54","BookieShell.java","111309","49343","160652","","321304"
"2017-08-16 03:41","NetUtils.java","12047","69440","81487","","162974"
"2016-07-14 23:02","BenchReadThroughputLatency.java","105630","7556","113186","","226372"
"2012-12-24 05:50","LedgerCacheImpl.java","11441","71575","83016","2","166032"
"2016-11-18 00:18","LedgerCacheImpl.java","46669","84985","131654","","263308"
"2012-12-18 13:04","LedgerCacheImpl.java","11232","71258","82490","2","164980"
"2012-03-29 15:18","LedgerCacheImpl.java","499","1348","1847","1","3694"
"2017-05-16 00:31","LedgerCacheImpl.java","47209","107390","154599","","309198"
"2013-10-11 08:36","LedgerCacheImpl.java","14374","116494","130868","6","261736"
"2017-06-01 23:58","LedgerCacheImpl.java","47818","110774","158592","","317184"
"2014-08-02 20:02","LedgerCacheImpl.java","15609","135749","151358","","302716"
"2012-05-07 18:48","LedgerCacheImpl.java","1259","4187","5446","1","10892"
"2017-07-04 06:27","LedgerCacheImpl.java","47942","118133","166075","","332150"
"2012-10-26 12:51","LedgerCacheImpl.java","10373","56379","66752","2","133504"
"2017-01-31 04:01","LedgerCacheImpl.java","46710","98127","144837","","289674"
"2017-05-15 19:52","UpgradeTest.java","113296","49743","163039","","326078"
"2016-07-11 23:01","BookieWriteLedgerTest.java","107874","30336","138210","","276420"
"2014-07-24 01:41","BookieWriteLedgerTest.java","1183","6941","8124","","16248"
"2015-10-22 09:22","BookieWriteLedgerTest.java","3774","23482","27256","","54512"
"2017-08-02 00:49","BookieAuthProvider.java","3657","17269","20926","","41852"
"2013-10-12 05:42","LedgerDirsManagerTest.java","5965","51670","57635","6","115270"
"2017-07-07 08:19","LedgerDirsManagerTest.java","81276","96474","177750","","355500"
"2017-01-30 23:25","LedgerDirsManagerTest.java","79491","67813","147304","","294608"
"2017-06-05 20:30","LedgerDirsManagerTest.java","81037","87395","168432","","336864"
"2014-12-10 19:43","LedgerDirsManagerTest.java","8427","74787","83214","","166428"
"2014-07-24 01:41","LedgerDirsManagerTest.java","7798","64530","72328","","144656"
"2014-09-22 12:11","CodahaleMetricsProvider.java","3519","18564","22083","","44166"
"2014-09-06 07:27","CodahaleMetricsProvider.java","3280","18146","21426","","42852"
"2016-12-17 02:43","CodahaleMetricsProvider.java","111661","49109","160770","","321540"
"2017-05-26 16:52","CodahaleMetricsProvider.java","112899","67865","180764","","361528"
"2014-02-05 22:43","TestReplicationWorker.java","5084","49819","54903","7","109806"
"2013-05-31 12:02","TestReplicationWorker.java","2225","34886","37111","5","74222"
"2013-06-15 19:05","TestReplicationWorker.java","2361","39122","41483","5","82966"
"2016-04-27 09:00","TestReplicationWorker.java","79273","45020","124293","","248586"
"2015-07-10 22:48","TestReplicationWorker.java","6861","69622","76483","","152966"
"2014-07-24 01:41","TestReplicationWorker.java","5910","56403","62313","","124626"
"2012-12-13 18:34","BookieReadWriteTest.java","9860","63678","73538","2","147076"
"2014-01-21 05:05","BookieReadWriteTest.java","14026","115915","129941","6","259882"
"2012-06-19 12:39","BookieReadWriteTest.java","952","3348","4300","2","8600"
"2014-07-24 01:41","BookieReadWriteTest.java","14876","123672","138548","","277096"
"2013-05-31 12:02","BookieReadWriteTest.java","12877","103841","116718","5","233436"
"2017-07-04 06:27","Bookie.java","833","6619","7452","","14904"
"2017-06-28 23:24","Bookie.java","182","2135","2317","","4634"
"2017-07-07 08:19","Bookie.java","972","8721","9693","","19386"
"2017-08-02 00:49","Bookie.java","6070","30062","36132","","72264"
"2017-07-28 20:12","BookKeeper.java","2080","8635","10715","","21430"
"2012-12-24 05:50","LedgerCacheImpl.java","11090","70375","81465","2","162930"
"2016-11-18 00:18","LedgerCacheImpl.java","47108","84575","131683","","263366"
"2012-12-18 13:04","LedgerCacheImpl.java","10879","70056","80935","2","161870"
"2017-05-16 00:31","LedgerCacheImpl.java","47675","107007","154682","","309364"
"2013-10-11 08:36","LedgerCacheImpl.java","14075","115346","129421","6","258842"
"2017-06-01 23:58","LedgerCacheImpl.java","48286","110393","158679","","317358"
"2014-08-02 20:02","LedgerCacheImpl.java","15335","134626","149961","","299922"
"2012-05-07 18:48","LedgerCacheImpl.java","824","2903","3727","1","7454"
"2017-07-04 06:27","LedgerCacheImpl.java","48415","117757","166172","","332344"
"2012-10-26 12:51","LedgerCacheImpl.java","10009","55166","65175","2","130350"
"2017-01-31 04:01","LedgerCacheImpl.java","47150","97718","144868","","289736"
"2016-07-14 23:02","BenchThroughputLatency.java","45986","79106","125092","","250184"
"2013-10-29 05:14","BenchThroughputLatency.java","19717","125975","145692","6","291384"
"2013-10-14 16:43","BenchThroughputLatency.java","19589","124978","144567","6","289134"
"2012-09-12 11:59","BenchThroughputLatency.java","13411","52342","65753","2","131506"
"2012-05-09 13:20","BenchThroughputLatency.java","9134","15399","24533","1","49066"
"2012-05-04 20:11","BenchThroughputLatency.java","8863","14401","23264","1","46528"
"2012-06-12 17:37","BenchThroughputLatency.java","9780","17877","27657","1","55314"
"2014-07-15 09:09","BenchThroughputLatency.java","20307","136713","157020","","314040"
"2013-02-08 19:08","BenchThroughputLatency.java","18130","114732","132862","4","265724"
"2017-08-16 03:37","BookieServer.java","117659","117905","235564","","471128"
"2017-08-02 00:49","BookieServer.java","116409","110022","226431","","452862"
"2013-07-03 17:39","BookieServer.java","815","6304","7119","5","14238"
"2013-07-24 16:55","BookieServer.java","897","7254","8151","5","16302"
"2014-02-05 22:43","BookieServer.java","3807","16953","20760","7","41520"
"2017-06-28 23:24","BookieServer.java","113070","84644","197714","","395428"
"2013-06-15 19:05","BookieServer.java","764","5936","6700","5","13400"
"2017-06-01 23:58","BookieServer.java","112853","81025","193878","","387756"
"2017-10-17 09:32","BookieServer.java","123718","115342","239060","","478120"
"2014-08-02 20:02","BookieServer.java","4956","30312","35268","","70536"
"2013-12-06 07:39","BookieServer.java","2501","13400","15901","6","31802"
"2014-01-21 05:05","BookieServer.java","2832","14829","17661","6","35322"
"2015-10-06 10:05","TestPerChannelBookieClient.java","3432","17369","20801","","41602"
"2014-07-24 01:41","TestPerChannelBookieClient.java","517","1560","2077","","4154"
"2017-05-16 00:31","TestPerChannelBookieClient.java","112564","60100","172664","","345328"
"2017-01-31 02:14","TestPerChannelBookieClient.java","111283","44586","155869","","311738"
"2016-04-05 08:45","TestPerChannelBookieClient.java","107981","23973","131954","","263908"
"2017-05-15 19:52","TestPerChannelBookieClient.java","112424","59542","171966","","343932"
"2017-10-17 09:32","BookieServer.java","27155","18533","45688","","91376"
"2017-08-02 00:49","PendingAddOp.java","5648","25815","31463","","62926"
"2012-09-03 18:54","TestLedgerFragmentReplication.java","426","6285","6711","2","13422"
"2012-09-04 10:39","TestLedgerFragmentReplication.java","459","6421","6880","2","13760"
"2012-10-05 16:24","TestLedgerFragmentReplication.java","3417","16345","19762","2","39524"
"2014-07-24 01:41","TestLedgerFragmentReplication.java","11175","96476","107651","","215302"
"2014-02-05 22:43","TestLedgerFragmentReplication.java","10685","90228","100913","7","201826"
"2017-05-15 19:52","PacketProcessorBase.java","2703","24279","26982","","53964"
"2017-08-16 03:37","BookieServer.java","4701","11334","16035","","32070"
"2017-10-17 09:32","BookieServer.java","30953","28964","59917","","119834"
"2015-09-15 10:38","GcLedgersTest.java","15234","134204","149438","","298876"
"2016-04-27 09:55","GcLedgersTest.java","47977","70130","118107","","236214"
"2017-03-28 22:37","GcLedgersTest.java","48247","97183","145430","","290860"
"2016-03-08 06:49","GcLedgersTest.java","15444","137711","153155","","306310"
"2017-07-04 06:27","GcLedgersTest.java","49576","112479","162055","","324110"
"2014-07-24 01:41","GcLedgersTest.java","14466","120866","135332","","270664"
"2013-04-04 11:21","GcLedgersTest.java","12029","99612","111641","5","223282"
"2013-07-29 12:30","GcLedgersTest.java","12462","106359","118821","5","237642"
"2017-05-16 00:31","GcLedgersTest.java","48805","101698","150503","","301006"
"2012-12-24 05:50","GcLedgersTest.java","9710","62556","72266","2","144532"
"2013-01-14 16:59","BookieServer.java","16676","96860","113536","2","227072"
"2013-01-09 17:18","BookieServer.java","16587","95707","112294","2","224588"
"2013-02-12 11:16","BookieServer.java","17508","128278","145786","4","291572"
"2013-04-02 17:38","BookieServer.java","17679","129452","147131","5","294262"
"2017-08-16 03:37","BookieServer.java","41279","153298","194577","","389154"
"2017-08-02 00:49","BookieServer.java","40816","146202","187018","","374036"
"2011-11-18 11:18","BookieServer.java","1065","3731","4796","","9592"
"2012-02-15 16:11","BookieServer.java","2523","13578","16101","1","32202"
"2012-03-08 19:24","BookieServer.java","2833","15770","18603","1","37206"
"2013-07-03 17:39","BookieServer.java","17889","135151","153040","5","306080"
"2013-07-24 16:55","BookieServer.java","17901","136031","153932","5","307864"
"2014-02-05 22:43","BookieServer.java","18324","143243","161567","7","323134"
"2017-06-28 23:24","BookieServer.java","40150","123497","163647","","327294"
"2013-06-15 19:05","BookieServer.java","17880","134825","152705","5","305410"
"2017-06-01 23:58","BookieServer.java","40130","120075","160205","","320410"
"2017-10-17 09:32","BookieServer.java","41743","145140","186883","","373766"
"2014-08-02 20:02","BookieServer.java","18672","155801","174473","","348946"
"2012-05-09 09:43","BookieServer.java","10270","30556","40826","1","81652"
"2013-12-06 07:39","BookieServer.java","18054","140726","158780","6","317560"
"2012-07-23 23:39","BookieServer.java","12552","45812","58364","2","116728"
"2012-07-09 04:09","BookieServer.java","11196","41547","52743","2","105486"
"2012-10-18 16:40","BookieServer.java","15648","77117","92765","2","185530"
"2011-11-17 11:16","BookieServer.java","382","1760","2142","","4284"
"2012-02-01 12:58","BookieServer.java","2182","11027","13209","1","26418"
"2014-01-21 05:05","BookieServer.java","18057","141827","159884","6","319768"
"2015-09-15 10:38","BookKeeper.java","3694","22018","25712","","51424"
"2015-10-22 09:22","BookKeeper.java","3767","23471","27238","","54476"
"2017-01-31 04:01","BookKeeper.java","110823","54306","165129","","330258"
"2015-07-10 22:48","BookKeeper.java","3266","21288","24554","","49108"
"2017-06-30 00:12","BookKeeper.java","113336","73632","186968","","373936"
"2014-02-21 19:01","BookKeeper.java","194","1353","1547","7","3094"
"2016-10-13 07:50","BookKeeper.java","110613","40540","151153","","302306"
"2017-06-21 21:00","BookKeeper.java","113109","70934","184043","","368086"
"2017-03-28 22:35","BookKeeper.java","110925","59000","169925","","339850"
"2016-07-11 23:01","BookKeeper.java","107867","30325","138192","","276384"
"2016-10-13 09:27","BookKeeper.java","110728","40641","151369","","302738"
"2017-07-28 20:12","BookKeeper.java","114465","81316","195781","","391562"
"2017-05-15 19:52","BookKeeper.java","111872","63701","175573","","351146"
"2014-07-24 01:41","BookieShutdownTest.java","4318","17923","22241","","44482"
"2013-11-22 10:40","BookieShutdownTest.java","1928","7284","9212","6","18424"
"2013-01-14 16:59","BookieServer.java","16862","94380","111242","2","222484"
"2013-01-09 17:18","BookieServer.java","16773","93227","110000","2","220000"
"2013-02-12 11:16","BookieServer.java","17732","125836","143568","4","287136"
"2013-04-02 17:38","BookieServer.java","17918","127025","144943","5","289886"
"2017-08-16 03:37","BookieServer.java","42387","151740","194127","","388254"
"2017-08-02 00:49","BookieServer.java","41852","144572","186424","","372848"
"2012-02-15 16:11","BookieServer.java","1618","10007","11625","1","23250"
"2012-03-08 19:24","BookieServer.java","1949","12220","14169","1","28338"
"2013-07-03 17:39","BookieServer.java","18128","132724","150852","5","301704"
"2013-07-24 16:55","BookieServer.java","18145","133609","151754","5","303508"
"2014-02-05 22:43","BookieServer.java","18694","140947","159641","7","319282"
"2017-06-28 23:24","BookieServer.java","41183","121864","163047","","326094"
"2013-06-15 19:05","BookieServer.java","18124","132403","150527","5","301054"
"2017-06-01 23:58","BookieServer.java","41147","118426","159573","","319146"
"2017-10-17 09:32","BookieServer.java","42961","143692","186653","","373306"
"2014-08-02 20:02","BookieServer.java","19095","153558","172653","","345306"
"2012-05-09 09:43","BookieServer.java","9935","27555","37490","1","74980"
"2013-12-06 07:39","BookieServer.java","18354","138360","156714","6","313428"
"2012-07-23 23:39","BookieServer.java","12315","42909","55224","2","110448"
"2012-07-09 04:09","BookieServer.java","10940","38625","49565","2","99130"
"2012-10-18 16:40","BookieServer.java","15802","74605","90407","2","180814"
"2012-02-01 12:58","BookieServer.java","1243","7422","8665","1","17330"
"2014-01-21 05:05","BookieServer.java","18369","139473","157842","6","315684"
"2016-11-18 00:18","InterleavedLedgerStorage.java","111559","44344","155903","","311806"
"2014-01-15 15:58","InterleavedLedgerStorage.java","112","456","568","6","1136"
"2014-01-21 17:26","InterleavedLedgerStorage.java","568","2457","3025","6","6050"
"2017-05-16 00:31","InterleavedLedgerStorage.java","112757","67407","180164","","360328"
"2014-08-02 20:02","InterleavedLedgerStorage.java","3072","17681","20753","","41506"
"2017-07-04 06:27","InterleavedLedgerStorage.java","114161","78821","192982","","385964"
"2015-04-21 09:55","InterleavedLedgerStorage.java","4087","24118","28205","","56410"
"2017-01-31 04:01","InterleavedLedgerStorage.java","111630","57516","169146","","338292"
"2016-03-08 06:49","InterleavedLedgerStorage.java","5185","29209","34394","","68788"
"2017-03-28 22:37","InterleavedLedgerStorage.java","111765","62458","174223","","348446"
"2015-04-21 09:17","InterleavedLedgerStorage.java","4061","23921","27982","","55964"
"2014-12-05 17:51","RoundRobinDistributionSchedule.java","12008","98633","110641","","221282"
"2017-06-30 00:12","RoundRobinDistributionSchedule.java","68690","100683","169373","","338746"
"2017-03-23 15:59","TestZooKeeperClient.java","111130","34697","145827","","291654"
"2016-11-18 00:18","InterleavedLedgerStorage.java","110963","53852","164815","","329630"
"2013-12-02 18:45","InterleavedLedgerStorage.java","2271","12375","14646","6","29292"
"2014-01-15 15:58","InterleavedLedgerStorage.java","2351","12799","15150","6","30300"
"2014-01-21 17:26","InterleavedLedgerStorage.java","2775","14768","17543","6","35086"
"2013-10-02 06:23","InterleavedLedgerStorage.java","805","7116","7921","5","15842"
"2017-05-16 00:31","InterleavedLedgerStorage.java","111989","76743","188732","","377464"
"2014-08-02 20:02","InterleavedLedgerStorage.java","4771","29484","34255","","68510"
"2017-07-04 06:27","InterleavedLedgerStorage.java","113249","88013","201262","","402524"
"2015-04-21 09:55","InterleavedLedgerStorage.java","5302","35437","40739","","81478"
"2017-01-31 04:01","InterleavedLedgerStorage.java","111011","67001","178012","","356024"
"2016-03-08 06:49","InterleavedLedgerStorage.java","6272","40400","46672","","93344"
"2017-03-28 22:37","InterleavedLedgerStorage.java","111109","71906","183015","","366030"
"2015-04-21 09:17","InterleavedLedgerStorage.java","5282","35246","40528","","81056"
"2017-05-25 14:23","LedgerEntry.java","361","2643","3004","","6008"
"2017-06-01 11:42","LedgerEntry.java","482","3708","4190","","8380"
"2014-05-12 08:10","MetastoreTable.java","9324","68988","78312","7","156624"
"2016-07-14 23:02","MetastoreTable.java","77574","55262","132836","","265672"
"2017-03-28 22:35","RackawareEnsemblePlacementPolicyImpl.java","1240","19388","20628","","41256"
"2017-08-16 03:41","RackawareEnsemblePlacementPolicyImpl.java","12047","69440","81487","","162974"
"2014-07-24 01:41","BookieJournalRollingTest.java","3366","14393","17759","","35518"
"2014-09-09 05:57","TestTryReadLastConfirmed.java","1653","10773","12426","","24852"
"2017-05-16 13:20","BookieProtoEncoding.java","111735","78142","189877","","379754"
"2017-05-16 00:31","BookieProtoEncoding.java","111735","78135","189870","","379740"
"2017-06-01 21:20","BookieProtoEncoding.java","112413","81140","193553","","387106"
"2017-05-17 08:57","BookieProtoEncoding.java","111752","78211","189963","","379926"
"2014-07-25 00:34","BookieProtoEncoding.java","5200","30929","36129","","72258"
"2013-03-18 00:31","BookieProtoEncoding.java","187","400","587","4","1174"
"2016-04-05 08:45","BookieProtoEncoding.java","109189","44045","153234","","306468"
"2017-05-15 19:52","BookieProtoEncoding.java","111646","77628","189274","","378548"
"2017-06-05 22:25","BookieProtoEncoding.java","112641","83265","195906","","391812"
"2017-08-02 00:49","BookieAuthProvider.java","9032","51481","60513","","121026"
"2017-07-28 20:12","BookieAuthProvider.java","5908","34745","40653","","81306"
"2017-05-15 19:52","PacketProcessorBaseV3.java","2703","24279","26982","","53964"
"2017-06-05 22:25","PacketProcessorBaseV3.java","4292","30510","34802","","69604"
"2017-01-31 04:01","Bookie.java","110818","54297","165115","","330230"
"2017-03-28 22:37","Bookie.java","110960","59246","170206","","340412"
"2016-01-26 22:11","Bookie.java","3802","24405","28207","","56414"
"2015-03-18 07:38","Bookie.java","2891","20242","23133","","46266"
"2015-04-21 09:17","Bookie.java","2933","20386","23319","","46638"
"2014-09-23 17:53","Bookie.java","2414","16708","19122","","38244"
"2017-07-04 06:27","Bookie.java","113468","75721","189189","","378378"
"2017-06-05 22:25","Bookie.java","113030","69497","182527","","365054"
"2014-04-29 22:07","Bookie.java","479","3984","4463","7","8926"
"2014-08-02 20:02","Bookie.java","1777","13979","15756","","31512"
"2017-06-28 23:24","Bookie.java","113125","71545","184670","","369340"
"2017-07-07 08:19","Bookie.java","113498","77714","191212","","382424"
"2017-05-16 00:31","Bookie.java","111992","64235","176227","","352454"
"2014-08-18 23:03","Bookie.java","2151","15821","17972","","35944"
"2014-05-09 14:04","Bookie.java","498","4644","5142","7","10284"
"2017-06-01 23:58","Bookie.java","112818","67836","180654","","361308"
"2017-08-02 00:49","Bookie.java","117033","97492","214525","","429050"
"2016-11-18 00:18","Bookie.java","110749","41127","151876","","303752"
"2017-03-28 22:35","Bookie.java","110920","58991","169911","","339822"
"2016-07-14 23:02","Bookie.java","107931","30419","138350","","276700"
"2017-06-05 20:30","Bookie.java","112931","68307","181238","","362476"
"2016-11-30 00:02","Bookie.java","110774","41682","152456","","304912"
"2017-03-22 22:54","Bookie.java","110910","54677","165587","","331174"
"2014-09-17 16:32","MultipleThreadReadTest.java","38","14","52","","104"
"2017-07-04 06:27","SyncThreadTest.java","4684","23458","28142","","56284"
"2017-03-28 22:37","SyncThreadTest.java","375","5182","5557","","11114"
"2017-05-16 00:31","SyncThreadTest.java","2479","11243","13722","","27444"
"2016-03-16 04:43","LedgerCloseTest.java","106516","8976","115492","","230984"
"2017-05-16 00:31","LedgerCloseTest.java","113794","50733","164527","","329054"
"2017-06-01 22:39","TestSpeculativeRead.java","112759","67400","180159","","360318"
"2014-07-24 01:41","TestSpeculativeRead.java","1183","6941","8124","","16248"
"2014-07-24 01:41","TestEntryLog.java","19845","144849","164694","","329388"
"2012-05-09 10:39","TestEntryLog.java","9737","24405","34142","1","68284"
"2014-12-10 19:43","TestEntryLog.java","20041","154673","174714","","349428"
"2016-02-24 00:44","TestEntryLog.java","20240","160759","180999","","361998"
"2014-03-12 21:26","TestEntryLog.java","19602","141851","161453","7","322906"
"2012-10-18 16:40","TestEntryLog.java","16373","72169","88542","2","177084"
"2013-10-12 05:42","TestEntryLog.java","19067","133044","152111","6","304222"
"2017-05-16 00:31","TestEntryLog.java","42734","114231","156965","","313930"
"2017-07-07 08:19","TestEntryLog.java","42903","126373","169276","","338552"
"2011-12-16 15:32","TestEntryLog.java","566","779","1345","1","2690"
"2012-03-08 12:13","TestEntryLog.java","1568","8788","10356","1","20712"
"2012-03-13 07:31","TestEntryLog.java","2080","11601","13681","1","27362"
"2012-03-16 10:41","TestEntryLog.java","8493","19458","27951","1","55902"
"2012-03-21 06:13","TestEntryLog.java","9087","20535","29622","1","59244"
"2017-05-15 19:52","SlowBookieTest.java","112611","68810","181421","","362842"
"2014-02-05 22:43","SlowBookieTest.java","1712","6078","7790","7","15580"
"2014-01-03 18:12","SlowBookieTest.java","138","2261","2399","6","4798"
"2014-01-21 05:05","SlowBookieTest.java","466","3683","4149","6","8298"
"2013-01-04 11:32","ServerConfiguration.java","3833","21100","24933","2","49866"
"2014-08-02 20:02","ServerConfiguration.java","9204","84864","94068","","188136"
"2014-05-06 12:30","ServerConfiguration.java","8615","75625","84240","7","168480"
"2014-05-15 00:41","ServerConfiguration.java","8631","76555","85186","7","170372"
"2014-09-18 06:47","ServerConfiguration.java","9266","86935","96201","","192402"
"2017-07-04 06:27","ServerConfiguration.java","74466","100177","174643","","349286"
"2014-03-07 13:14","ServerConfiguration.java","8549","73200","81749","7","163498"
"2014-04-29 22:07","ServerConfiguration.java","8615","75578","84193","7","168386"
"2016-04-14 00:51","ServerConfiguration.java","71321","55770","127091","","254182"
"2015-01-16 15:57","ServerConfiguration.java","9625","90266","99891","","199782"
"2013-02-08 19:08","ServerConfiguration.java","4651","54079","58730","4","117460"
"2016-03-08 06:49","ServerConfiguration.java","10318","95393","105711","","211422"
"2016-01-26 22:11","ServerConfiguration.java","10110","94171","104281","","208562"
"2014-01-21 05:05","ServerConfiguration.java","7691","69992","77683","6","155366"
"2014-03-12 21:26","ServerConfiguration.java","8575","75028","83603","7","167206"
"2016-04-05 18:47","ServerConfiguration.java","71303","55702","127005","","254010"
"2016-04-27 09:55","ServerConfiguration.java","71357","56318","127675","","255350"
"2015-04-21 09:55","ServerConfiguration.java","9669","90751","100420","","200840"
"2015-01-12 15:18","ServerConfiguration.java","9623","89326","98949","","197898"
"2015-04-21 10:02","ServerConfiguration.java","9665","90780","100445","","200890"
"2013-01-14 16:59","ServerConfiguration.java","4435","23150","27585","2","55170"
"2012-11-30 04:54","ServerConfiguration.java","1134","11746","12880","2","25760"
"2017-05-15 19:52","ServerConfiguration.java","73420","88703","162123","","324246"
"2017-03-22 22:54","ServerConfiguration.java","72821","80046","152867","","305734"
"2012-12-11 18:59","ServerConfiguration.java","1988","13556","15544","2","31088"
"2017-03-23 00:48","ServerConfiguration.java","72825","80102","152927","","305854"
"2017-01-31 02:11","ServerConfiguration.java","72734","73590","146324","","292648"
"2013-02-19 16:19","ServerConfiguration.java","5532","54913","60445","4","120890"
"2013-02-19 16:15","ServerConfiguration.java","5527","54889","60416","4","120832"
"2016-04-05 08:45","ServerConfiguration.java","71301","55458","126759","","253518"
"2016-11-09 03:02","ServerConfiguration.java","72702","66386","139088","","278176"
"2016-11-30 00:02","ServerConfiguration.java","72711","67077","139788","","279576"
"2017-06-05 20:30","ServerConfiguration.java","74230","93064","167294","","334588"
"2016-09-10 20:27","ServerConfiguration.java","72578","62473","135051","","270102"
"2017-08-02 00:49","ServerConfiguration.java","75891","119808","195699","","391398"
"2017-10-03 12:31","ServerConfiguration.java","81539","115613","197152","","394304"
"2017-08-16 03:37","ServerConfiguration.java","76920","127470","204390","","408780"
"2013-07-20 19:59","ServerConfiguration.java","6368","62413","68781","5","137562"
"2013-12-02 18:45","ServerConfiguration.java","7581","68632","76213","6","152426"
"2014-05-09 14:04","ServerConfiguration.java","8629","76233","84862","7","169724"
"2017-05-26 12:38","ServerConfiguration.java","73537","91136","164673","","329346"
"2013-06-15 19:05","ServerConfiguration.java","6299","61775","68074","5","136148"
"2014-01-15 15:58","ServerConfiguration.java","7660","69055","76715","6","153430"
"2013-10-22 07:44","ServerConfiguration.java","7432","65986","73418","6","146836"
"2017-07-07 08:19","ServerConfiguration.java","74455","102129","176584","","353168"
"2017-06-28 23:24","ServerConfiguration.java","74280","96158","170438","","340876"
"2017-11-08 12:27","ServerConfiguration.java","82721","134669","217390","","434780"
"2014-01-22 14:35","ServerConfiguration.java","7953","71269","79222","6","158444"
"2013-10-12 05:42","ServerConfiguration.java","7324","65505","72829","6","145658"
"2017-07-28 20:12","BKException.java","114568","80260","194828","","389656"
"2016-07-11 22:53","BKException.java","107836","28228","136064","","272128"
"2017-05-02 23:04","BKException.java","111509","60689","172198","","344396"
"2017-08-02 00:49","BKException.java","117144","96448","213592","","427184"
"2015-09-15 10:38","BKException.java","3675","20840","24515","","49030"
"2017-01-31 04:01","BKException.java","110821","53145","163966","","327932"
"2015-10-06 10:48","BKException.java","3727","21442","25169","","50338"
"2015-10-22 09:22","BKException.java","3755","22300","26055","","52110"
"2017-08-01 08:34","BookieInfoReader.java","2688","13715","16403","","32806"
"2017-05-15 19:52","LedgerHandle.java","45709","111418","157127","","314254"
"2017-05-02 22:07","LedgerHandle.java","45337","108692","154029","","308058"
"2017-03-23 15:55","LedgerHandle.java","45323","103052","148375","","296750"
"2012-12-28 12:32","LedgerHandle.java","17256","83358","100614","2","201228"
"2016-09-10 21:01","LedgerHandle.java","45205","85647","130852","","261704"
"2016-07-11 23:01","LedgerHandle.java","45196","81534","126730","","253460"
"2012-03-31 10:58","LedgerHandle.java","8513","16146","24659","1","49318"
"2013-04-26 18:38","LedgerHandle.java","18721","119734","138455","5","276910"
"2013-10-14 18:32","LedgerHandle.java","19154","127854","147008","6","294016"
"2014-02-05 22:43","LedgerHandle.java","19635","133511","153146","7","306292"
"2014-02-21 19:01","LedgerHandle.java","19675","134714","154389","7","308778"
"2017-05-17 08:57","LedgerHandle.java","45761","111947","157708","","315416"
"2017-05-25 14:23","LedgerHandle.java","45789","113780","159569","","319138"
"2017-06-21 19:50","LedgerHandle.java","46358","117280","163638","","327276"
"2017-06-21 21:00","LedgerHandle.java","46360","118065","164425","","328850"
"2017-06-01 23:58","LedgerHandle.java","46313","115215","161528","","323056"
"2012-06-29 18:43","LedgerHandle.java","10620","29389","40009","2","80018"
"2012-05-25 17:13","LedgerHandle.java","9682","20520","30202","1","60404"
"2012-05-10 14:47","LedgerHandle.java","9250","18834","28084","1","56168"
"2012-09-12 11:59","LedgerHandle.java","13319","55502","68821","2","137642"
"2012-06-19 12:39","LedgerHandle.java","10425","23659","34084","2","68168"
"2014-01-21 05:19","LedgerHandle.java","19329","132402","151731","6","303462"
"2012-06-27 15:35","LedgerHandle.java","10611","29050","39661","2","79322"
"2014-09-18 06:47","LedgerHandle.java","20119","148214","168333","","336666"
"2014-12-09 19:57","LedgerHandle.java","20144","149332","169476","","338952"
"2017-07-04 06:27","LedgerHandle.java","46411","122548","168959","","337918"
"2017-06-30 00:12","LedgerHandle.java","46370","120546","166916","","333832"
"2014-05-30 14:01","LedgerHandle.java","19745","138718","158463","7","316926"
"2014-05-30 15:07","LedgerHandle.java","19758","138770","158528","7","317056"
"2014-01-17 18:13","LedgerHandle.java","19275","131452","150727","6","301454"
"2013-01-07 12:25","LedgerHandle.java","17403","85308","102711","2","205422"
"2012-08-28 10:51","LedgerHandle.java","13179","51778","64957","2","129914"
"2012-09-14 11:53","LedgerHandle.java","13397","55815","69212","2","138424"
"2016-02-09 08:32","LedgerHandle.java","20419","155038","175457","","350914"
"2016-03-16 05:03","LedgerHandle.java","45146","77026","122172","","244344"
"2015-10-22 09:22","LedgerHandle.java","20421","154005","174426","","348852"
"2015-10-06 10:05","LedgerHandle.java","20410","152938","173348","","346696"
"2017-01-31 04:01","LedgerHandle.java","45315","102678","147993","","295986"
"2015-04-21 09:39","LedgerHandle.java","20217","151574","171791","","343582"
"2015-10-06 11:12","LedgerHandle.java","20412","153180","173592","","347184"
"2014-12-05 14:10","LedgerHandle.java","20127","148866","168993","","337986"
"2017-07-04 06:27","LedgerEntryPage.java","114075","80838","194913","","389826"
"2017-05-15 19:52","LedgerHandle.java","43143","113134","156277","","312554"
"2017-05-02 22:07","LedgerHandle.java","42786","110423","153209","","306418"
"2017-03-23 15:55","LedgerHandle.java","42779","104790","147569","","295138"
"2012-12-28 12:32","LedgerHandle.java","16894","87278","104172","2","208344"
"2016-09-10 21:01","LedgerHandle.java","42658","87382","130040","","260080"
"2016-07-11 23:01","LedgerHandle.java","42649","83269","125918","","251836"
"2012-02-13 15:46","LedgerHandle.java","426","4708","5134","1","10268"
"2012-02-01 16:19","LedgerHandle.java","77","1170","1247","1","2494"
"2012-02-13 11:19","LedgerHandle.java","296","4498","4794","1","9588"
"2012-03-31 10:58","LedgerHandle.java","8656","20571","29227","1","58454"
"2013-04-26 18:38","LedgerHandle.java","18282","123577","141859","5","283718"
"2013-10-14 18:32","LedgerHandle.java","18673","131655","150328","6","300656"
"2014-02-05 22:43","LedgerHandle.java","19117","137275","156392","7","312784"
"2014-02-21 19:01","LedgerHandle.java","19156","138477","157633","7","315266"
"2017-05-17 08:57","LedgerHandle.java","43183","113651","156834","","313668"
"2017-05-25 14:23","LedgerHandle.java","43210","115483","158693","","317386"
"2017-06-21 19:50","LedgerHandle.java","43313","118517","161830","","323660"
"2017-06-21 21:00","LedgerHandle.java","43315","119302","162617","","325234"
"2017-06-01 23:58","LedgerHandle.java","43273","116457","159730","","319460"
"2012-06-29 18:43","LedgerHandle.java","10612","33663","44275","2","88550"
"2012-05-25 17:13","LedgerHandle.java","9732","24852","34584","1","69168"
"2012-05-10 14:47","LedgerHandle.java","9335","23201","32536","1","65072"
"2012-09-12 11:59","LedgerHandle.java","13070","59535","72605","2","145210"
"2012-06-19 12:39","LedgerHandle.java","10418","27934","38352","2","76704"
"2014-01-21 05:19","LedgerHandle.java","18826","136181","155007","6","310014"
"2012-06-27 15:35","LedgerHandle.java","10603","33324","43927","2","87854"
"2014-09-18 06:47","LedgerHandle.java","19563","151940","171503","","343006"
"2014-12-09 19:57","LedgerHandle.java","19575","153045","172620","","345240"
"2017-07-04 06:27","LedgerHandle.java","43351","123770","167121","","334242"
"2017-06-30 00:12","LedgerHandle.java","43319","121777","165096","","330192"
"2014-05-30 14:01","LedgerHandle.java","19197","142452","161649","7","323298"
"2014-05-30 15:07","LedgerHandle.java","19199","142493","161692","7","323384"
"2014-01-17 18:13","LedgerHandle.java","18784","135243","154027","6","308054"
"2013-01-07 12:25","LedgerHandle.java","17030","89217","106247","2","212494"
"2012-08-28 10:51","LedgerHandle.java","12928","55809","68737","2","137474"
"2012-09-14 11:53","LedgerHandle.java","13148","59848","72996","2","145992"
"2016-02-09 08:32","LedgerHandle.java","19803","158704","178507","","357014"
"2016-03-16 05:03","LedgerHandle.java","42601","78763","121364","","242728"
"2015-10-22 09:22","LedgerHandle.java","19804","157670","177474","","354948"
"2015-10-06 10:05","LedgerHandle.java","19793","156603","176396","","352792"
"2017-01-31 04:01","LedgerHandle.java","42771","104416","147187","","294374"
"2015-04-21 09:39","LedgerHandle.java","19607","155246","174853","","349706"
"2015-10-06 11:12","LedgerHandle.java","19795","156845","176640","","353280"
"2014-12-05 14:10","LedgerHandle.java","19570","152591","172161","","344322"
"2017-01-31 04:01","Bookie.java","111317","51291","162608","","325216"
"2017-03-28 22:37","Bookie.java","111460","56241","167701","","335402"
"2016-01-26 22:11","Bookie.java","3562","20660","24222","","48444"
"2015-03-18 07:38","Bookie.java","2623","16469","19092","","38184"
"2015-04-21 09:17","Bookie.java","2666","16614","19280","","38560"
"2014-09-23 17:53","Bookie.java","2133","12922","15055","","30110"
"2017-07-04 06:27","Bookie.java","114104","72852","186956","","373912"
"2017-06-05 22:25","Bookie.java","113622","66584","180206","","360412"
"2014-08-02 20:02","Bookie.java","1358","10055","11413","","22826"
"2017-06-28 23:24","Bookie.java","113718","68633","182351","","364702"
"2017-07-07 08:19","Bookie.java","114136","74847","188983","","377966"
"2017-05-16 00:31","Bookie.java","112574","61312","173886","","347772"
"2014-08-18 23:03","Bookie.java","1732","11897","13629","","27258"
"2014-05-09 14:04","Bookie.java","19","660","679","7","1358"
"2017-06-01 23:58","Bookie.java","113411","64924","178335","","356670"
"2017-08-02 00:49","Bookie.java","117760","94714","212474","","424948"
"2016-11-18 00:18","Bookie.java","111243","38116","149359","","298718"
"2017-03-28 22:35","Bookie.java","111420","55986","167406","","334812"
"2016-07-14 23:02","Bookie.java","108410","27393","135803","","271606"
"2017-06-05 20:30","Bookie.java","113523","65394","178917","","357834"
"2016-11-30 00:02","Bookie.java","111268","38671","149939","","299878"
"2017-03-22 22:54","Bookie.java","111408","51670","163078","","326156"
"2017-07-28 20:12","LocalBookieEnsemblePlacementPolicy.java","6033","24809","30842","","61684"
"2016-03-16 04:51","AutoRecoveryMain.java","79246","41782","121028","","242056"
"2013-10-02 06:23","AutoRecoveryMain.java","2692","41235","43927","5","87854"
"2014-03-10 03:14","AutoRecoveryMain.java","5309","51931","57240","7","114480"
"2014-04-24 10:43","AutoRecoveryMain.java","5372","53242","58614","7","117228"
"2014-09-06 07:58","AutoRecoveryMain.java","6169","65120","71289","","142578"
"2013-12-06 07:39","AutoRecoveryMain.java","4028","46516","50544","6","101088"
"2012-12-03 06:23","BookKeeperTest.java","9354","59338","68692","2","137384"
"2016-02-09 08:39","BookKeeperTest.java","15673","139096","154769","","309538"
"2015-10-16 07:00","BookKeeperTest.java","15584","137111","152695","","305390"
"2016-04-08 19:43","BookKeeperTest.java","48176","71776","119952","","239904"
"2017-01-31 04:01","BookKeeperTest.java","48396","94506","142902","","285804"
"2014-07-24 01:41","BookKeeperTest.java","14879","123260","138139","","276278"
"2017-05-15 19:52","BookKeeperTest.java","48892","103348","152240","","304480"
"2012-07-18 17:00","BookKeeperTest.java","4124","15020","19144","2","38288"
"2017-05-02 22:07","BookKeeperTest.java","48493","100595","149088","","298176"
"2013-05-06 19:32","BookKeeperTest.java","12713","102933","115646","5","231292"
"2013-01-10 19:13","BookKeeperTest.java","11210","68472","79682","2","159364"
"2016-04-05 08:45","BookieClient.java","108492","33565","142057","","284114"
"2017-03-28 22:35","BookieClient.java","111704","64149","175853","","351706"
"2014-02-05 22:43","BookieClient.java","1712","6078","7790","7","15580"
"2017-01-31 04:01","BookieClient.java","111616","59469","171085","","342170"
"2014-08-02 20:02","Journal.java","9204","84864","94068","","188136"
"2014-03-07 13:14","Journal.java","8549","73200","81749","7","163498"
"2014-04-29 22:07","Journal.java","8615","75578","84193","7","168386"
"2013-12-06 07:39","Journal.java","7595","68798","76393","6","152786"
"2015-04-21 09:23","Journal.java","9649","90564","100213","","200426"
"2016-02-09 08:30","Journal.java","10190","94372","104562","","209124"
"2015-02-23 08:11","Journal.java","9644","90323","99967","","199934"
"2017-05-26 16:52","Journal.java","73537","91156","164693","","329386"
"2017-03-22 22:54","Journal.java","72821","80046","152867","","305734"
"2016-11-12 03:37","Journal.java","72702","66434","139136","","278272"
"2016-07-14 23:02","Journal.java","71542","57488","129030","","258060"
"2013-05-04 14:22","Journal.java","6070","57017","63087","5","126174"
"2013-07-20 19:59","Journal.java","6368","62413","68781","5","137562"
"2013-07-04 14:01","Journal.java","6341","62149","68490","5","136980"
"2017-06-01 23:58","Journal.java","74177","92653","166830","","333660"
"2017-05-09 22:24","Journal.java","73204","87025","160229","","320458"
"2013-10-12 05:42","Journal.java","7324","65505","72829","6","145658"
"2013-10-02 06:23","Journal.java","6524","63782","70306","5","140612"
"2017-05-16 00:31","Journal.java","73492","89193","162685","","325370"
"2012-09-14 15:42","LedgerLayout.java","5284","34369","39653","2","79306"
"2012-09-07 07:04","LedgerLayout.java","4844","33268","38112","2","76224"
"2017-06-01 23:58","LedgerLayout.java","49427","105095","154522","","309044"
"2016-07-14 23:02","LedgerLayout.java","48071","71209","119280","","238560"
"2017-05-15 19:52","LedgerHandle.java","43342","112240","155582","","311164"
"2017-05-02 22:07","LedgerHandle.java","42976","109520","152496","","304992"
"2017-03-23 15:55","LedgerHandle.java","42969","103887","146856","","293712"
"2012-12-28 12:32","LedgerHandle.java","16997","86288","103285","2","206570"
"2016-09-10 21:01","LedgerHandle.java","42848","86479","129327","","258654"
"2016-07-11 23:01","LedgerHandle.java","42839","82366","125205","","250410"
"2012-02-13 15:46","LedgerHandle.java","351","3540","3891","1","7782"
"2012-02-13 11:19","LedgerHandle.java","221","3330","3551","1","7102"
"2012-03-31 10:58","LedgerHandle.java","8685","19507","28192","1","56384"
"2013-04-26 18:38","LedgerHandle.java","18425","122627","141052","5","282104"
"2013-10-14 18:32","LedgerHandle.java","18827","130716","149543","6","299086"
"2014-02-05 22:43","LedgerHandle.java","19294","136359","155653","7","311306"
"2014-02-21 19:01","LedgerHandle.java","19334","137562","156896","7","313792"
"2017-05-17 08:57","LedgerHandle.java","43384","112759","156143","","312286"
"2017-05-25 14:23","LedgerHandle.java","43412","114592","158004","","316008"
"2017-06-21 19:50","LedgerHandle.java","43977","118088","162065","","324130"
"2017-06-21 21:00","LedgerHandle.java","43979","118873","162852","","325704"
"2017-06-01 23:58","LedgerHandle.java","43937","116028","159965","","319930"
"2012-06-29 18:43","LedgerHandle.java","10701","32659","43360","2","86720"
"2012-05-25 17:13","LedgerHandle.java","9780","23807","33587","1","67174"
"2012-05-10 14:47","LedgerHandle.java","9382","22155","31537","1","63074"
"2012-09-12 11:59","LedgerHandle.java","13168","58540","71708","2","143416"
"2012-06-19 12:39","LedgerHandle.java","10506","26929","37435","2","74870"
"2014-01-21 05:19","LedgerHandle.java","18988","135250","154238","6","308476"
"2012-06-27 15:35","LedgerHandle.java","10692","32320","43012","2","86024"
"2014-09-18 06:47","LedgerHandle.java","19749","151033","170782","","341564"
"2014-12-09 19:57","LedgerHandle.java","19761","152138","171899","","343798"
"2017-07-04 06:27","LedgerHandle.java","44019","123345","167364","","334728"
"2017-06-30 00:12","LedgerHandle.java","43983","121348","165331","","330662"
"2014-05-30 14:01","LedgerHandle.java","19375","141537","160912","7","321824"
"2014-05-30 15:07","LedgerHandle.java","19384","141585","160969","7","321938"
"2014-01-17 18:13","LedgerHandle.java","18943","134309","153252","6","306504"
"2013-01-07 12:25","LedgerHandle.java","17134","88228","105362","2","210724"
"2012-08-28 10:51","LedgerHandle.java","13024","54812","67836","2","135672"
"2012-09-14 11:53","LedgerHandle.java","13246","58853","72099","2","144198"
"2016-02-09 08:32","LedgerHandle.java","19991","157799","177790","","355580"
"2016-03-16 05:03","LedgerHandle.java","42789","77858","120647","","241294"
"2015-10-22 09:22","LedgerHandle.java","19993","156766","176759","","353518"
"2015-10-06 10:05","LedgerHandle.java","19982","155699","175681","","351362"
"2017-01-31 04:01","LedgerHandle.java","42961","103513","146474","","292948"
"2015-04-21 09:39","LedgerHandle.java","19793","154339","174132","","348264"
"2015-10-06 11:12","LedgerHandle.java","19984","155941","175925","","351850"
"2014-12-05 14:10","LedgerHandle.java","19756","151684","171440","","342880"
"2017-10-17 09:32","BookKeeperAdmin.java","30063","78290","108353","","216706"
"2017-06-01 23:58","BookKeeperAdmin.java","3904","28679","32583","","65166"
"2017-04-11 20:19","BookKeeperAdmin.java","1299","19589","20888","","41776"
"2017-07-07 05:11","BookKeeperAdmin.java","5006","38696","43702","","87404"
"2016-11-30 00:07","BookKeeperAdmin.java","151","815","966","","1932"
"2017-01-31 04:01","Bookie.java","111611","57345","168956","","337912"
"2017-03-28 22:37","Bookie.java","111746","62287","174033","","348066"
"2016-01-26 22:11","Bookie.java","4848","27706","32554","","65108"
"2015-03-18 07:38","Bookie.java","4014","23620","27634","","55268"
"2015-04-21 09:17","Bookie.java","4036","23744","27780","","55560"
"2014-09-23 17:53","Bookie.java","3555","20104","23659","","47318"
"2017-07-04 06:27","Bookie.java","114145","78653","192798","","385596"
"2017-06-05 22:25","Bookie.java","113740","72462","186202","","372404"
"2014-02-06 09:25","Bookie.java","1613","3868","5481","7","10962"
"2014-04-29 22:07","Bookie.java","2079","7839","9918","7","19836"
"2014-08-02 20:02","Bookie.java","3047","17504","20551","","41102"
"2017-06-28 23:24","Bookie.java","113836","74511","188347","","376694"
"2017-07-07 08:19","Bookie.java","114143","80614","194757","","389514"
"2014-01-21 17:26","Bookie.java","533","2270","2803","6","5606"
"2017-05-16 00:31","Bookie.java","112739","67237","179976","","359952"
"2014-02-05 22:43","Bookie.java","1608","3855","5463","7","10926"
"2014-08-18 23:03","Bookie.java","3420","19345","22765","","45530"
"2014-05-09 14:04","Bookie.java","2097","8498","10595","7","21190"
"2017-06-01 23:58","Bookie.java","113548","70821","184369","","368738"
"2017-08-02 00:49","Bookie.java","117608","100322","217930","","435860"
"2016-11-18 00:18","Bookie.java","111540","44173","155713","","311426"
"2017-03-28 22:35","Bookie.java","111707","62033","173740","","347480"
"2016-07-14 23:02","Bookie.java","108861","33604","142465","","284930"
"2017-06-05 20:30","Bookie.java","113644","71275","184919","","369838"
"2016-11-30 00:02","Bookie.java","111565","44728","156293","","312586"
"2017-03-22 22:54","Bookie.java","111706","57728","169434","","338868"
"2017-05-16 00:31","BookieProtocol.java","111735","78135","189870","","379740"
"2017-06-01 21:20","BookieProtocol.java","112413","81140","193553","","387106"
"2013-03-18 00:31","BookieProtocol.java","187","400","587","4","1174"
"2016-04-05 08:45","BookieProtocol.java","109189","44045","153234","","306468"
"2017-05-15 19:52","BookieProtocol.java","111646","77628","189274","","378548"
"2017-06-05 22:25","BookieProtocol.java","112641","83265","195906","","391812"
"2017-05-15 19:52","LedgerHandle.java","45779","111568","157347","","314694"
"2017-05-02 22:07","LedgerHandle.java","45407","108842","154249","","308498"
"2017-03-23 15:55","LedgerHandle.java","45393","103202","148595","","297190"
"2012-12-28 12:32","LedgerHandle.java","17360","83542","100902","2","201804"
"2016-09-10 21:01","LedgerHandle.java","45275","85797","131072","","262144"
"2016-07-11 23:01","LedgerHandle.java","45266","81684","126950","","253900"
"2012-03-31 10:58","LedgerHandle.java","8627","16340","24967","1","49934"
"2013-04-26 18:38","LedgerHandle.java","18814","119907","138721","5","277442"
"2013-10-14 18:32","LedgerHandle.java","19245","128025","147270","6","294540"
"2014-02-05 22:43","LedgerHandle.java","19726","133682","153408","7","306816"
"2014-02-21 19:01","LedgerHandle.java","19765","134884","154649","7","309298"
"2017-05-17 08:57","LedgerHandle.java","45831","112097","157928","","315856"
"2017-05-25 14:23","LedgerHandle.java","45859","113930","159789","","319578"
"2017-06-21 19:50","LedgerHandle.java","46423","117425","163848","","327696"
"2017-06-21 21:00","LedgerHandle.java","46425","118210","164635","","329270"
"2017-06-01 23:58","LedgerHandle.java","46383","115365","161748","","323496"
"2012-06-29 18:43","LedgerHandle.java","10722","29571","40293","2","80586"
"2012-05-25 17:13","LedgerHandle.java","9784","20702","30486","1","60972"
"2012-05-10 14:47","LedgerHandle.java","9353","19017","28370","1","56740"
"2012-09-12 11:59","LedgerHandle.java","13426","55689","69115","2","138230"
"2012-06-19 12:39","LedgerHandle.java","10527","23841","34368","2","68736"
"2014-01-21 05:19","LedgerHandle.java","19420","132573","151993","6","303986"
"2012-06-27 15:35","LedgerHandle.java","10713","29232","39945","2","79890"
"2014-09-18 06:47","LedgerHandle.java","20202","148377","168579","","337158"
"2014-12-09 19:57","LedgerHandle.java","20215","149483","169698","","339396"
"2017-07-04 06:27","LedgerHandle.java","46470","122687","169157","","338314"
"2017-06-30 00:12","LedgerHandle.java","46429","120685","167114","","334228"
"2014-05-30 14:01","LedgerHandle.java","19832","138885","158717","7","317434"
"2014-05-30 15:07","LedgerHandle.java","19841","138933","158774","7","317548"
"2014-01-17 18:13","LedgerHandle.java","19366","131623","150989","6","301978"
"2013-01-07 12:25","LedgerHandle.java","17505","85490","102995","2","205990"
"2012-08-28 10:51","LedgerHandle.java","13282","51961","65243","2","130486"
"2012-09-14 11:53","LedgerHandle.java","13504","56002","69506","2","139012"
"2016-02-09 08:32","LedgerHandle.java","20489","155188","175677","","351354"
"2016-03-16 05:03","LedgerHandle.java","45216","77176","122392","","244784"
"2015-10-22 09:22","LedgerHandle.java","20491","154155","174646","","349292"
"2015-10-06 10:05","LedgerHandle.java","20480","153088","173568","","347136"
"2017-01-31 04:01","LedgerHandle.java","45385","102828","148213","","296426"
"2015-04-21 09:39","LedgerHandle.java","20288","151725","172013","","344026"
"2015-10-06 11:12","LedgerHandle.java","20482","153330","173812","","347624"
"2014-12-05 14:10","LedgerHandle.java","20210","149029","169239","","338478"
"2017-07-04 06:27","BookieRequestProcessor.java","833","6619","7452","","14904"
"2017-08-02 00:49","BookieRequestProcessor.java","6070","30062","36132","","72264"
"2017-05-16 00:31","TestEntryLog.java","112410","43388","155798","","311596"
"2017-07-07 08:19","TestEntryLog.java","114361","57312","171673","","343346"
"2014-07-25 00:34","PerChannelBookieClientPool.java","1139","8004","9143","","18286"
"2017-05-15 19:52","PerChannelBookieClientPool.java","112424","59542","171966","","343932"
"2017-07-04 06:27","SyncThreadTest.java","10334","51596","61930","","123860"
"2017-01-31 04:01","SyncThreadTest.java","6625","29113","35738","","71476"
"2017-03-28 22:37","SyncThreadTest.java","6764","34059","40823","","81646"
"2016-11-18 00:18","SyncThreadTest.java","6055","15442","21497","","42994"
"2017-05-16 00:31","SyncThreadTest.java","8330","39582","47912","","95824"
"2017-07-04 06:27","SyncThreadTest.java","114212","54848","169060","","338120"
"2017-01-31 04:01","SyncThreadTest.java","110707","32569","143276","","286552"
"2016-04-14 00:51","SyncThreadTest.java","104791","4165","108956","","217912"
"2017-03-28 22:37","SyncThreadTest.java","110849","37518","148367","","296734"
"2016-11-18 00:18","SyncThreadTest.java","110603","19364","129967","","259934"
"2017-05-16 00:31","SyncThreadTest.java","112289","42915","155204","","310408"
"2017-07-04 06:27","SyncThreadTest.java","4475","18442","22917","","45834"
"2017-05-16 00:31","SyncThreadTest.java","2203","6160","8363","","16726"
"2017-04-20 19:55","BookieInfoReader.java","450","1571","2021","","4042"
"2017-06-01 23:58","BookieInfoReader.java","3302","10249","13551","","27102"
"2017-08-01 08:34","BookieInfoReader.java","8602","38405","47007","","94014"
"2017-07-28 20:12","BookieInfoReader.java","6033","24809","30842","","61684"
"2015-09-15 10:38","AbstractConfiguration.java","10866","95809","106675","","213350"
"2017-03-28 22:40","AbstractConfiguration.java","71042","86179","157221","","314442"
"2012-12-12 11:20","AbstractConfiguration.java","2991","18503","21494","2","42988"
"2017-08-02 00:49","AbstractConfiguration.java","73958","121040","194998","","389996"
"2013-06-12 18:41","AbstractConfiguration.java","7201","65415","72616","5","145232"
"2016-07-31 07:53","AbstractConfiguration.java","69813","59024","128837","","257674"
"2017-01-31 02:14","AbstractConfiguration.java","70878","75511","146389","","292778"
"2016-07-31 07:56","AbstractConfiguration.java","69813","59358","129171","","258342"
"2017-05-02 23:04","AbstractConfiguration.java","71343","88301","159644","","319288"
"2017-03-23 00:48","AbstractConfiguration.java","70967","81409","152376","","304752"
"2012-11-30 04:54","AbstractConfiguration.java","2161","15938","18099","2","36198"
"2017-07-07 05:11","Auditor.java","82359","94494","176853","","353706"
"2014-02-05 22:43","Auditor.java","6786","54980","61766","7","123532"
"2013-08-21 13:19","Auditor.java","4546","46442","50988","5","101976"
"2017-05-26 16:52","Auditor.java","81321","83684","165005","","330010"
"2013-03-25 06:27","Auditor.java","3735","38360","42095","4","84190"
"2016-09-10 21:01","Auditor.java","80343","55103","135446","","270892"
"2016-11-09 03:02","Auditor.java","80459","58887","139346","","278692"
"2016-03-08 07:18","Auditor.java","9056","79540","88596","","177192"
"2013-01-04 11:32","Auditor.java","1657","3668","5325","2","10650"
"2014-04-24 10:43","Auditor.java","7017","58346","65363","7","130726"
"2014-06-02 11:54","Auditor.java","7219","60686","67905","7","135810"
"2014-05-06 12:30","Auditor.java","7058","58812","65870","7","131740"
"2014-05-23 18:48","Auditor.java","7078","59756","66834","7","133668"
"2013-01-04 11:32","ServerConfiguration.java","6730","32046","38776","2","77552"
"2014-08-02 20:02","ServerConfiguration.java","11757","95466","107223","","214446"
"2014-05-06 12:30","ServerConfiguration.java","11175","86234","97409","7","194818"
"2014-05-15 00:41","ServerConfiguration.java","11191","87164","98355","7","196710"
"2014-09-18 06:47","ServerConfiguration.java","11818","97536","109354","","218708"
"2017-07-04 06:27","ServerConfiguration.java","68716","102476","171192","","342384"
"2014-03-07 13:14","ServerConfiguration.java","11115","83815","94930","7","189860"
"2014-04-29 22:07","ServerConfiguration.java","11175","86187","97362","7","194724"
"2012-10-18 16:40","ServerConfiguration.java","3765","11814","15579","2","31158"
"2016-04-14 00:51","ServerConfiguration.java","65830","58328","124158","","248316"
"2015-01-16 15:57","ServerConfiguration.java","12158","100848","113006","","226012"
"2013-02-08 19:08","ServerConfiguration.java","7481","64958","72439","4","144878"
"2016-03-08 06:49","ServerConfiguration.java","12818","105942","118760","","237520"
"2016-01-26 22:11","ServerConfiguration.java","12610","104720","117330","","234660"
"2014-01-21 05:05","ServerConfiguration.java","10316","80666","90982","6","181964"
"2014-03-12 21:26","ServerConfiguration.java","11135","85637","96772","7","193544"
"2016-04-05 18:47","ServerConfiguration.java","65813","58261","124074","","248148"
"2016-04-27 09:55","ServerConfiguration.java","65854","58864","124718","","249436"
"2015-04-21 09:55","ServerConfiguration.java","12193","101324","113517","","227034"
"2015-01-12 15:18","ServerConfiguration.java","12156","99908","112064","","224128"
"2015-04-21 10:02","ServerConfiguration.java","12193","101357","113550","","227100"
"2013-01-14 16:59","ServerConfiguration.java","7291","34055","41346","2","82692"
"2012-11-30 04:54","ServerConfiguration.java","4665","23326","27991","2","55982"
"2017-05-15 19:52","ServerConfiguration.java","67783","91115","158898","","317796"
"2017-03-22 22:54","ServerConfiguration.java","67187","82461","149648","","299296"
"2012-12-11 18:59","ServerConfiguration.java","4960","24577","29537","2","59074"
"2017-03-23 00:48","ServerConfiguration.java","67191","82517","149708","","299416"
"2017-01-31 02:11","ServerConfiguration.java","67103","76008","143111","","286222"
"2013-02-19 16:19","ServerConfiguration.java","8336","65766","74102","4","148204"
"2013-02-19 16:15","ServerConfiguration.java","8336","65747","74083","4","148166"
"2016-04-05 08:45","ServerConfiguration.java","65811","58017","123828","","247656"
"2016-11-09 03:02","ServerConfiguration.java","67070","68803","135873","","271746"
"2016-11-30 00:02","ServerConfiguration.java","67080","69495","136575","","273150"
"2017-06-05 20:30","ServerConfiguration.java","68483","95366","163849","","327698"
"2016-09-10 20:27","ServerConfiguration.java","66946","64890","131836","","263672"
"2017-08-02 00:49","ServerConfiguration.java","70126","122092","192218","","384436"
"2017-10-03 12:31","ServerConfiguration.java","75437","117560","192997","","385994"
"2017-08-16 03:37","ServerConfiguration.java","71124","129723","200847","","401694"
"2013-07-20 19:59","ServerConfiguration.java","9113","73207","82320","5","164640"
"2013-12-02 18:45","ServerConfiguration.java","10251","79351","89602","6","179204"
"2014-05-09 14:04","ServerConfiguration.java","11189","86842","98031","7","196062"
"2017-05-26 12:38","ServerConfiguration.java","67894","93542","161436","","322872"
"2013-06-15 19:05","ServerConfiguration.java","9057","72582","81639","5","163278"
"2014-01-15 15:58","ServerConfiguration.java","10286","79730","90016","6","180032"
"2013-10-22 07:44","ServerConfiguration.java","10111","76714","86825","6","173650"
"2017-07-07 08:19","ServerConfiguration.java","68707","104430","173137","","346274"
"2017-06-28 23:24","ServerConfiguration.java","68541","98468","167009","","334018"
"2017-11-08 12:27","ServerConfiguration.java","76560","136557","213117","","426234"
"2014-01-22 14:35","ServerConfiguration.java","10542","81907","92449","6","184898"
"2013-10-12 05:42","ServerConfiguration.java","10007","76237","86244","6","172488"
"2017-03-28 22:40","TestLedgerManager.java","111151","73242","184393","","368786"
"2015-07-10 22:48","TestLedgerManager.java","5783","37378","43161","","86322"
"2014-07-24 01:41","TestLedgerManager.java","4725","24052","28777","","57554"
"2017-06-01 23:58","ReadEntryProcessorV3.java","1414","4607","6021","","12042"
"2017-05-16 00:31","ReadEntryProcessorV3.java","263","681","944","","1888"
"2017-06-05 22:25","ReadEntryProcessorV3.java","1852","6494","8346","","16692"
"2017-07-04 06:27","LedgerDescriptorImpl.java","2419","12429","14848","","29696"
"2017-06-05 22:25","LedgerDescriptorImpl.java","1604","5828","7432","","14864"
"2017-05-16 13:20","BookieProtoEncoding.java","8333","39884","48217","","96434"
"2017-05-16 00:31","BookieProtoEncoding.java","8327","39871","48198","","96396"
"2017-06-01 21:20","BookieProtoEncoding.java","9111","42982","52093","","104186"
"2017-05-17 08:57","BookieProtoEncoding.java","8351","39954","48305","","96610"
"2017-05-15 19:52","BookieProtoEncoding.java","8150","39276","47426","","94852"
"2017-06-05 22:25","BookieProtoEncoding.java","9705","45473","55178","","110356"
"2015-03-12 08:21","AuditorPeriodicCheckTest.java","2653","16747","19400","","38800"
"2017-05-16 00:31","AuditorPeriodicCheckTest.java","112608","61722","174330","","348660"
"2014-07-25 00:34","AuditorPeriodicCheckTest.java","1347","9790","11137","","22274"
"2016-09-10 21:01","AuditorPeriodicCheckTest.java","109696","33125","142821","","285642"
"2017-06-01 08:55","NullStatsLogger.java","112801","71410","184211","","368422"
"2015-04-21 09:17","NullStatsLogger.java","4074","25340","29414","","58828"
"2016-12-21 01:48","LedgerCacheTest.java","112699","56288","168987","","337974"
"2019-02-20 11:43","LedgerCacheTest.java","133310","415576","548886","","1097772"
"2013-10-12 05:42","LedgerCacheTest.java","1319","2716","4035","6","8070"
"2017-05-16 00:31","LedgerCacheTest.java","113732","72649","186381","","372762"
"2013-12-02 18:45","LedgerCacheTest.java","1732","5999","7731","6","15462"
"2014-07-24 01:41","LedgerCacheTest.java","4187","16611","20798","","41596"
"2014-12-10 19:43","LedgerCacheTest.java","5348","27400","32748","","65496"
"2016-03-08 06:49","LedgerCacheTest.java","6399","34690","41089","","82178"
"2014-03-12 21:26","LedgerCacheTest.java","3573","13242","16815","7","33630"
"2017-05-16 00:31","LedgerCloseTest.java","7685","42164","49849","","99698"
"2013-01-07 12:25","LedgerRecoveryTest.java","2060","6951","9011","2","18022"
"2013-06-12 18:41","LedgerRecoveryTest.java","4600","47061","51661","5","103322"
"2013-03-25 18:02","LedgerRecoveryTest.java","4103","41739","45842","4","91684"
"2014-02-05 22:43","LedgerRecoveryTest.java","6987","57849","64836","7","129672"
"2017-05-16 00:31","LedgerRecoveryTest.java","80134","83247","163381","","326762"
"2017-06-21 19:50","LedgerRecoveryTest.java","80972","88880","169852","","339704"
"2014-08-02 20:02","Journal.java","11773","115642","127415","","254830"
"2014-03-07 13:14","Journal.java","11273","104133","115406","7","230812"
"2014-04-29 22:07","Journal.java","11320","106492","117812","7","235624"
"2013-12-06 07:39","Journal.java","10603","100015","110618","6","221236"
"2012-10-18 16:40","Journal.java","4951","33160","38111","2","76222"
"2015-04-21 09:23","Journal.java","12096","121220","133316","","266632"
"2012-10-16 23:20","Journal.java","4262","29900","34162","2","68324"
"2016-02-09 08:30","Journal.java","12555","124946","137501","","275002"
"2015-02-23 08:11","Journal.java","12093","120981","133074","","266148"
"2017-05-26 16:52","Journal.java","54630","100458","155088","","310176"
"2017-03-22 22:54","Journal.java","54004","89438","143442","","286884"
"2016-11-12 03:37","Journal.java","53922","75863","129785","","259570"
"2016-07-14 23:02","Journal.java","53441","67596","121037","","242074"
"2013-05-04 14:22","Journal.java","9260","88416","97676","5","195352"
"2013-07-20 19:59","Journal.java","9497","93751","103248","5","206496"
"2013-07-04 14:01","Journal.java","9472","93489","102961","5","205922"
"2017-06-01 23:58","Journal.java","55207","101892","157099","","314198"
"2017-05-09 22:24","Journal.java","54316","96346","150662","","301324"
"2013-10-12 05:42","Journal.java","10361","96751","107112","6","214224"
"2013-10-02 06:23","Journal.java","9574","95041","104615","5","209230"
"2017-05-16 00:31","Journal.java","54588","98498","153086","","306172"
"2014-12-10 19:43","BookieZKExpireTest.java","5497","34452","39949","","79898"
"2016-01-26 22:11","BookieZKExpireTest.java","6252","40432","46684","","93368"
"2017-07-07 08:19","DiskChecker.java","116119","68133","184252","","368504"
"2017-06-05 20:30","DiskChecker.java","115331","58505","173836","","347672"
"2017-07-28 20:12","MacDigestManager.java","114175","95052","209227","","418454"
"2017-05-15 19:52","MacDigestManager.java","112230","78085","190315","","380630"
"2017-05-17 08:57","MacDigestManager.java","112326","78658","190984","","381968"
"2013-01-14 16:59","BookieServer.java","17572","86701","104273","2","208546"
"2013-01-09 17:18","BookieServer.java","17475","85540","103015","2","206030"
"2013-02-12 11:16","BookieServer.java","18486","118201","136687","4","273374"
"2013-04-02 17:38","BookieServer.java","18710","119428","138138","5","276276"
"2017-08-16 03:37","BookieServer.java","47905","148869","196774","","393548"
"2017-08-02 00:49","BookieServer.java","47122","141453","188575","","377150"
"2012-03-08 19:24","BookieServer.java","529","2411","2940","1","5880"
"2013-07-03 17:39","BookieServer.java","18919","125126","144045","5","288090"
"2013-07-24 16:55","BookieServer.java","18940","126015","144955","5","289910"
"2014-02-05 22:43","BookieServer.java","19626","133490","153116","7","306232"
"2017-06-28 23:24","BookieServer.java","46367","118659","165026","","330052"
"2013-06-15 19:05","BookieServer.java","18903","124793","143696","5","287392"
"2017-06-01 23:58","BookieServer.java","46313","115203","161516","","323032"
"2017-10-17 09:32","BookieServer.java","48668","141010","189678","","379356"
"2014-08-02 20:02","BookieServer.java","20099","146173","166272","","332544"
"2012-05-09 09:43","BookieServer.java","8970","18201","27171","1","54342"
"2013-12-06 07:39","BookieServer.java","19237","130854","150091","6","300182"
"2012-07-23 23:39","BookieServer.java","12171","34376","46547","2","93094"
"2012-07-09 04:09","BookieServer.java","10631","29927","40558","2","81116"
"2012-10-18 16:40","BookieServer.java","16104","66518","82622","2","165244"
"2014-01-21 05:05","BookieServer.java","19267","131982","151249","6","302498"
"2017-06-21 19:58","BookieClientTest.java","4277","25071","29348","","58696"
"2017-03-28 22:35","BookieClientTest.java","886","12603","13489","","26978"
"2017-05-15 19:52","BookieClientTest.java","2598","18069","20667","","41334"
"2014-04-24 10:43","BookieAutoRecoveryTest.java","5685","55818","61503","7","123006"
"2014-05-23 18:46","BookieAutoRecoveryTest.java","5749","57231","62980","7","125960"
"2013-06-15 19:05","BookieAutoRecoveryTest.java","2922","41946","44868","5","89736"
"2014-05-09 14:04","BookieAutoRecoveryTest.java","5743","56895","62638","7","125276"
"2014-02-05 22:43","BookieAutoRecoveryTest.java","5425","52423","57848","7","115696"
"2014-02-05 22:43","TestSpeculativeRead.java","1712","6078","7790","7","15580"
"2017-06-01 22:39","TestSpeculativeRead.java","113478","72485","185963","","371926"
"2014-07-24 01:41","TestSpeculativeRead.java","2768","12892","15660","","31320"
"2017-05-15 19:52","SlowBookieTest.java","111874","63707","175581","","351162"
"2013-06-12 18:41","LedgerRecoveryTest.java","2879","40449","43328","5","86656"
"2013-03-25 18:02","LedgerRecoveryTest.java","2242","34987","37229","4","74458"
"2014-02-05 22:43","LedgerRecoveryTest.java","5529","51500","57029","7","114058"
"2017-05-16 00:31","LedgerRecoveryTest.java","81076","79298","160374","","320748"
"2017-06-21 19:50","LedgerRecoveryTest.java","82002","85019","167021","","334042"
"2017-05-04 20:58","AbstractZkLedgerManager.java","80512","78677","159189","","318378"
"2013-07-29 12:30","AbstractZkLedgerManager.java","3832","44883","48715","5","97430"
"2017-06-01 23:58","AbstractZkLedgerManager.java","81562","84384","165946","","331892"
"2017-06-12 17:20","AbstractZkLedgerManager.java","81715","86314","168029","","336058"
"2013-03-25 06:27","AbstractZkLedgerManager.java","2995","37222","40217","4","80434"
"2017-03-28 22:40","AbstractZkLedgerManager.java","80137","76455","156592","","313184"
"2016-02-09 08:23","AbstractZkLedgerManager.java","8385","76754","85139","","170278"
"2015-09-15 10:38","AbstractZkLedgerManager.java","8247","74371","82618","","165236"
"2016-02-23 19:16","AbstractZkLedgerManager.java","8406","77113","85519","","171038"
"2014-05-12 08:10","AbstractZkLedgerManager.java","6474","58742","65216","7","130432"
"2014-01-17 18:13","AbstractZkLedgerManager.java","5306","51403","56709","6","113418"
"2016-12-17 02:43","CodahaleMetricsProvider.java","112279","34682","146961","","293922"
"2017-05-26 16:52","CodahaleMetricsProvider.java","113906","53827","167733","","335466"
"2014-12-10 19:43","BookieInitializationTest.java","2293","11929","14222","","28444"
"2015-07-10 22:48","BookieInitializationTest.java","2759","15035","17794","","35588"
"2017-07-07 08:19","BookieInitializationTest.java","114062","72536","186598","","373196"
"2017-06-28 23:24","BookieInitializationTest.java","113624","66302","179926","","359852"
"2017-07-28 06:39","BookieInitializationTest.java","115063","75426","190489","","380978"
"2017-08-02 00:49","BookieInitializationTest.java","117706","92423","210129","","420258"
"2017-06-05 20:30","BookieInitializationTest.java","113425","63059","176484","","352968"
"2017-05-15 19:52","BookieInitializationTest.java","112329","58412","170741","","341482"
"2017-05-16 00:31","BookKeeperCloseTest.java","1998","5708","7706","","15412"
"2017-10-17 09:32","BookKeeperAdmin.java","30004","77567","107571","","215142"
"2017-06-01 23:58","BookKeeperAdmin.java","3793","27904","31697","","63394"
"2017-04-11 20:19","BookKeeperAdmin.java","1177","18803","19980","","39960"
"2017-07-07 05:11","BookKeeperAdmin.java","4911","37937","42848","","85696"
"2017-10-03 12:31","IndexPersistenceMgr.java","32583","50956","83539","","167078"
"2017-07-04 06:27","IndexPersistenceMgr.java","2419","12429","14848","","29696"
"2017-10-17 09:32","AuditorElector.java","123238","115705","238943","","477886"
"2013-08-21 13:19","AuditorElector.java","1408","9099","10507","5","21014"
"2016-07-14 23:02","AuditorElector.java","109462","45947","155409","","310818"
"2016-09-10 21:01","AuditorElector.java","110679","51234","161913","","323826"
"2017-03-28 22:40","AuditorElector.java","110991","73502","184493","","368986"
"2014-06-02 11:54","AuditorElector.java","4690","23952","28642","7","57284"
"2014-04-24 10:43","AuditorElector.java","4468","21592","26060","7","52120"
"2014-09-06 07:58","AuditorElector.java","5281","33486","38767","","77534"
"2016-07-14 23:02","IndexPersistenceMgr.java","108831","35829","144660","","289320"
"2016-11-18 00:18","IndexPersistenceMgr.java","111510","46398","157908","","315816"
"2017-05-16 00:31","IndexPersistenceMgr.java","112683","69436","182119","","364238"
"2017-10-03 12:31","IndexPersistenceMgr.java","124844","99970","224814","","449628"
"2017-07-04 06:27","IndexPersistenceMgr.java","114075","80838","194913","","389826"
"2014-08-02 20:02","IndexPersistenceMgr.java","3086","19798","22884","","45768"
"2016-03-08 06:49","IndexPersistenceMgr.java","5154","31281","36435","","72870"
"2017-01-31 04:01","IndexPersistenceMgr.java","111574","59563","171137","","342274"
"2016-04-05 08:45","BookieClient.java","107546","28253","135799","","271598"
"2017-03-28 22:35","BookieClient.java","110928","59007","169935","","339870"
"2017-01-31 04:01","BookieClient.java","110826","54313","165139","","330278"
"2016-07-14 23:02","IndexPersistenceMgr.java","109433","37739","147172","","294344"
"2016-11-18 00:18","IndexPersistenceMgr.java","112105","48301","160406","","320812"
"2017-05-16 00:31","IndexPersistenceMgr.java","113235","71296","184531","","369062"
"2013-10-22 16:21","IndexPersistenceMgr.java","878","2186","3064","6","6128"
"2017-10-03 12:31","IndexPersistenceMgr.java","125074","101508","226582","","453164"
"2017-07-04 06:27","IndexPersistenceMgr.java","114576","82647","197223","","394446"
"2014-08-02 20:02","IndexPersistenceMgr.java","3814","21834","25648","","51296"
"2016-03-08 06:49","IndexPersistenceMgr.java","5810","33245","39055","","78110"
"2017-01-31 04:01","IndexPersistenceMgr.java","112168","61465","173633","","347266"
"2016-03-08 06:49","CompactionTest.java","1660","7899","9559","","19118"
"2015-01-16 15:57","CompactionTest.java","24","1829","1853","","3706"
"2015-04-21 09:55","CompactionTest.java","204","2450","2654","","5308"
"2016-05-04 15:55","CompactionTest.java","106436","12584","119020","","238040"
"2017-03-22 22:54","CompactionTest.java","112029","40418","152447","","304894"
"2017-06-21 21:07","CompactionTest.java","114772","57580","172352","","344704"
"2017-11-08 12:27","CompactionTest.java","131976","105088","237064","","474128"
"2017-05-16 00:31","CompactionTest.java","113453","50318","163771","","327542"
"2017-07-07 08:19","CompactionTest.java","115313","64151","179464","","358928"
"2017-08-16 03:41","StaticDNSResolver.java","119164","114889","234053","","468106"
"2016-10-13 07:50","StaticDNSResolver.java","112110","50442","162552","","325104"
"2017-05-15 19:52","LedgerHandle.java","47939","106015","153954","","307908"
"2017-05-02 22:07","LedgerHandle.java","47547","103269","150816","","301632"
"2017-03-23 15:55","LedgerHandle.java","47485","97581","145066","","290132"
"2012-12-28 12:32","LedgerHandle.java","11629","70098","81727","2","163454"
"2016-09-10 21:01","LedgerHandle.java","47360","80169","127529","","255058"
"2016-07-11 23:01","LedgerHandle.java","47323","76028","123351","","246702"
"2013-04-26 18:38","LedgerHandle.java","13454","106834","120288","5","240576"
"2013-10-14 18:32","LedgerHandle.java","14525","115592","130117","6","260234"
"2014-02-05 22:43","LedgerHandle.java","15124","121367","136491","7","272982"
"2014-02-21 19:01","LedgerHandle.java","15181","122587","137768","7","275536"
"2017-05-17 08:57","LedgerHandle.java","47999","106552","154551","","309102"
"2017-05-25 14:23","LedgerHandle.java","48028","108386","156414","","312828"
"2017-06-21 19:50","LedgerHandle.java","48652","111941","160593","","321186"
"2017-06-21 21:00","LedgerHandle.java","48653","112725","161378","","322756"
"2017-06-01 23:58","LedgerHandle.java","48601","109870","158471","","316942"
"2012-06-29 18:43","LedgerHandle.java","3911","15047","18958","2","37916"
"2012-05-25 17:13","LedgerHandle.java","1521","4726","6247","1","12494"
"2012-05-10 14:47","LedgerHandle.java","1071","3022","4093","1","8186"
"2012-09-12 11:59","LedgerHandle.java","7052","41602","48654","2","97308"
"2012-06-19 12:39","LedgerHandle.java","2455","8056","10511","2","21022"
"2014-01-21 05:19","LedgerHandle.java","14755","120195","134950","6","269900"
"2012-06-27 15:35","LedgerHandle.java","3902","14708","18610","2","37220"
"2014-09-18 06:47","LedgerHandle.java","15670","136132","151802","","303604"
"2014-12-09 19:57","LedgerHandle.java","15735","137290","153025","","306050"
"2017-07-04 06:27","LedgerHandle.java","48734","117238","165972","","331944"
"2017-06-30 00:12","LedgerHandle.java","48666","115209","163875","","327750"
"2014-05-30 14:01","LedgerHandle.java","15263","126603","141866","7","283732"
"2014-05-30 15:07","LedgerHandle.java","15278","126657","141935","7","283870"
"2014-01-17 18:13","LedgerHandle.java","14700","119244","133944","6","267888"
"2013-01-07 12:25","LedgerHandle.java","11886","72158","84044","2","168088"
"2012-08-28 10:51","LedgerHandle.java","6857","37823","44680","2","89360"
"2012-09-14 11:53","LedgerHandle.java","7133","41918","49051","2","98102"
"2016-02-09 08:32","LedgerHandle.java","16245","143231","159476","","318952"
"2016-03-16 05:03","LedgerHandle.java","47268","71515","118783","","237566"
"2015-10-22 09:22","LedgerHandle.java","16166","142117","158283","","316566"
"2015-10-06 10:05","LedgerHandle.java","16154","141049","157203","","314406"
"2017-01-31 04:01","LedgerHandle.java","47471","97201","144672","","289344"
"2015-04-21 09:39","LedgerHandle.java","15906","139630","155536","","311072"
"2015-10-06 11:12","LedgerHandle.java","16156","141291","157447","","314894"
"2014-12-05 14:10","LedgerHandle.java","15718","136824","152542","","305084"
"2013-01-14 16:59","BookieServer.java","17818","85065","102883","2","205766"
"2013-01-09 17:18","BookieServer.java","17718","83901","101619","2","203238"
"2013-02-12 11:16","BookieServer.java","18735","116568","135303","4","270606"
"2013-04-02 17:38","BookieServer.java","18951","117787","136738","5","273476"
"2017-08-16 03:37","BookieServer.java","48534","147616","196150","","392300"
"2017-08-02 00:49","BookieServer.java","47710","140159","187869","","375738"
"2013-07-03 17:39","BookieServer.java","19180","123505","142685","5","285370"
"2013-07-24 16:55","BookieServer.java","19201","124394","143595","5","287190"
"2014-02-05 22:43","BookieServer.java","19957","131939","151896","7","303792"
"2017-06-28 23:24","BookieServer.java","46903","117313","164216","","328432"
"2013-06-15 19:05","BookieServer.java","19155","123163","142318","5","284636"
"2017-06-01 23:58","BookieServer.java","46856","113864","160720","","321440"
"2017-10-17 09:32","BookieServer.java","49365","139825","189190","","378380"
"2014-08-02 20:02","BookieServer.java","20460","144652","165112","","330224"
"2012-05-09 09:43","BookieServer.java","8846","16195","25041","1","50082"
"2013-12-06 07:39","BookieServer.java","19534","129269","148803","6","297606"
"2012-07-23 23:39","BookieServer.java","12141","32464","44605","2","89210"
"2012-07-09 04:09","BookieServer.java","10586","28000","38586","2","77172"
"2012-10-18 16:40","BookieServer.java","16107","64639","80746","2","161492"
"2014-01-21 05:05","BookieServer.java","19574","130407","149981","6","299962"
"2017-05-15 19:52","LedgerHandle.java","42402","113699","156101","","312202"
"2017-05-02 22:07","LedgerHandle.java","42045","110988","153033","","306066"
"2017-03-23 15:55","LedgerHandle.java","42038","105355","147393","","294786"
"2012-12-28 12:32","LedgerHandle.java","17034","88724","105758","2","211516"
"2016-09-10 21:01","LedgerHandle.java","41911","87941","129852","","259704"
"2016-07-11 23:01","LedgerHandle.java","41902","83828","125730","","251460"
"2012-02-13 15:46","LedgerHandle.java","795","6383","7178","1","14356"
"2012-01-17 16:52","LedgerHandle.java","375","1681","2056","1","4112"
"2012-02-01 16:19","LedgerHandle.java","452","2851","3303","1","6606"
"2012-02-13 11:19","LedgerHandle.java","668","6176","6844","1","13688"
"2012-03-31 10:58","LedgerHandle.java","8983","22204","31187","1","62374"
"2013-04-26 18:38","LedgerHandle.java","18402","125003","143405","5","286810"
"2013-10-14 18:32","LedgerHandle.java","18794","133082","151876","6","303752"
"2014-02-05 22:43","LedgerHandle.java","19238","138702","157940","7","315880"
"2014-02-21 19:01","LedgerHandle.java","19277","139904","159181","7","318362"
"2017-05-17 08:57","LedgerHandle.java","42442","114216","156658","","313316"
"2017-05-25 14:23","LedgerHandle.java","42469","116048","158517","","317034"
"2017-06-21 19:50","LedgerHandle.java","42572","119082","161654","","323308"
"2017-06-21 21:00","LedgerHandle.java","42574","119867","162441","","324882"
"2017-06-01 23:58","LedgerHandle.java","42532","117022","159554","","319108"
"2012-06-29 18:43","LedgerHandle.java","10866","35223","46089","2","92178"
"2012-05-25 17:13","LedgerHandle.java","10001","26427","36428","1","72856"
"2012-05-10 14:47","LedgerHandle.java","9643","24815","34458","1","68916"
"2012-09-12 11:59","LedgerHandle.java","13308","61079","74387","2","148774"
"2012-06-19 12:39","LedgerHandle.java","10674","29496","40170","2","80340"
"2014-01-21 05:19","LedgerHandle.java","18947","137608","156555","6","313110"
"2012-06-27 15:35","LedgerHandle.java","10857","34884","45741","2","91482"
"2014-09-18 06:47","LedgerHandle.java","19697","153380","173077","","346154"
"2014-12-09 19:57","LedgerHandle.java","19704","154480","174184","","348368"
"2017-07-04 06:27","LedgerHandle.java","42610","124335","166945","","333890"
"2017-06-30 00:12","LedgerHandle.java","42578","122342","164920","","329840"
"2014-05-30 14:01","LedgerHandle.java","19318","143879","163197","7","326394"
"2014-05-30 15:07","LedgerHandle.java","19320","143920","163240","7","326480"
"2014-01-17 18:13","LedgerHandle.java","18905","136670","155575","6","311150"
"2013-01-07 12:25","LedgerHandle.java","17166","90659","107825","2","215650"
"2012-08-28 10:51","LedgerHandle.java","13166","57353","70519","2","141038"
"2012-09-14 11:53","LedgerHandle.java","13386","61392","74778","2","149556"
"2016-02-09 08:32","LedgerHandle.java","19931","160138","180069","","360138"
"2016-03-16 05:03","LedgerHandle.java","41855","79323","121178","","242356"
"2015-10-22 09:22","LedgerHandle.java","19932","159104","179036","","358072"
"2015-10-06 10:05","LedgerHandle.java","19921","158037","177958","","355916"
"2017-01-31 04:01","LedgerHandle.java","42030","104981","147011","","294022"
"2015-04-21 09:39","LedgerHandle.java","19735","156680","176415","","352830"
"2015-10-06 11:12","LedgerHandle.java","19923","158279","178202","","356404"
"2014-12-05 14:10","LedgerHandle.java","19699","154026","173725","","347450"
"2017-10-17 09:32","BookKeeperAdmin.java","31303","83215","114518","","229036"
"2017-06-01 23:58","BookKeeperAdmin.java","5430","33890","39320","","78640"
"2017-04-11 20:19","BookKeeperAdmin.java","2854","24829","27683","","55366"
"2017-07-07 05:11","BookKeeperAdmin.java","6514","43889","50403","","100806"
"2016-11-09 03:05","BookKeeperAdmin.java","1684","5369","7053","","14106"
"2016-11-30 00:07","BookKeeperAdmin.java","1753","6102","7855","","15710"
"2016-10-13 09:27","BookKeeperAdmin.java","1654","5005","6659","","13318"
"2017-07-04 06:27","LedgerCache.java","48920","116183","165103","","330206"
"2017-05-16 00:31","LedgerCache.java","48163","105416","153579","","307158"
"2012-12-18 13:04","LedgerCache.java","10585","67683","78268","2","156536"
"2016-11-18 00:18","LedgerCache.java","47561","82949","130510","","261020"
"2017-10-17 09:32","BookKeeperAdmin.java","28066","84048","112114","","224228"
"2017-06-01 23:58","BookKeeperAdmin.java","8899","41429","50328","","100656"
"2017-04-11 20:19","BookKeeperAdmin.java","6557","32602","39159","","78318"
"2017-07-07 05:11","BookKeeperAdmin.java","9973","51418","61391","","122782"
"2016-11-09 03:05","BookKeeperAdmin.java","5501","13256","18757","","37514"
"2016-11-30 00:07","BookKeeperAdmin.java","5570","13989","19559","","39118"
"2016-09-10 21:01","BookKeeperAdmin.java","3819","7889","11708","","23416"
"2016-10-13 09:27","BookKeeperAdmin.java","5473","12894","18367","","36734"
"2016-02-09 08:12","TestBenchmark.java","3906","24476","28382","","56764"
"2012-12-24 05:50","InterleavedLedgerStorage.java","11147","69093","80240","2","160480"
"2012-12-18 13:04","InterleavedLedgerStorage.java","10762","68600","79362","2","158724"
"2016-11-18 00:18","InterleavedLedgerStorage.java","47444","83572","131016","","262032"
"2013-12-02 18:45","InterleavedLedgerStorage.java","14607","117950","132557","6","265114"
"2013-05-04 14:22","InterleavedLedgerStorage.java","13424","106663","120087","5","240174"
"2012-06-13 16:57","InterleavedLedgerStorage.java","1494","5828","7322","","14644"
"2014-01-15 15:58","InterleavedLedgerStorage.java","14625","118312","132937","6","265874"
"2014-01-21 17:26","InterleavedLedgerStorage.java","14718","119950","134668","6","269336"
"2013-10-02 06:23","InterleavedLedgerStorage.java","13703","113253","126956","5","253912"
"2017-05-16 00:31","InterleavedLedgerStorage.java","48024","106017","154041","","308082"
"2012-05-25 17:13","InterleavedLedgerStorage.java","1333","4037","5370","1","10740"
"2012-05-09 13:00","InterleavedLedgerStorage.java","537","1701","2238","1","4476"
"2012-05-07 18:48","InterleavedLedgerStorage.java","478","1218","1696","1","3392"
"2014-08-02 20:02","InterleavedLedgerStorage.java","15637","133589","149226","","298452"
"2017-07-04 06:27","InterleavedLedgerStorage.java","48796","116799","165595","","331190"
"2012-10-18 16:40","InterleavedLedgerStorage.java","9733","52025","61758","2","123516"
"2015-04-21 09:55","InterleavedLedgerStorage.java","15911","139285","155196","","310392"
"2017-01-31 04:01","InterleavedLedgerStorage.java","47489","96718","144207","","288414"
"2016-03-08 06:49","InterleavedLedgerStorage.java","16348","143715","160063","","320126"
"2017-03-28 22:37","InterleavedLedgerStorage.java","47523","101559","149082","","298164"
"2015-04-21 09:17","InterleavedLedgerStorage.java","15900","139103","155003","","310006"
"2012-12-18 12:00","BookKeeperClusterTestCase.java","10907","68956","79863","2","159726"
"2017-05-15 19:52","BookKeeperClusterTestCase.java","47939","106015","153954","","307908"
"2013-01-09 17:18","BookKeeperClusterTestCase.java","12149","72593","84742","2","169484"
"2016-04-05 08:45","BookKeeperClusterTestCase.java","47261","74211","121472","","242944"
"2017-08-01 08:34","BookKeeperClusterTestCase.java","49450","133575","183025","","366050"
"2013-10-12 05:42","BookKeeperClusterTestCase.java","14464","115438","129902","6","259804"
"2014-02-05 22:43","BookKeeperClusterTestCase.java","15124","121367","136491","7","272982"
"2017-11-08 12:27","BookKeeperClusterTestCase.java","51638","146379","198017","","396034"
"2013-06-15 19:05","BookKeeperClusterTestCase.java","13651","111920","125571","5","251142"
"2014-05-09 14:04","BookKeeperClusterTestCase.java","15227","125624","140851","7","281702"
"2012-12-12 11:20","BookKeeperClusterTestCase.java","10678","65818","76496","2","152992"
"2012-09-12 11:59","BookKeeperClusterTestCase.java","7052","41602","48654","2","97308"
"2017-07-04 06:27","BookKeeperClusterTestCase.java","48734","117238","165972","","331944"
"2014-07-24 01:41","BookKeeperClusterTestCase.java","15496","127497","142993","","285986"
"2014-05-23 18:46","BookKeeperClusterTestCase.java","15227","125954","141181","7","282362"
"2017-06-30 00:12","BookKeeperClusterTestCase.java","48666","115209","163875","","327750"
"2014-04-24 10:43","BookKeeperClusterTestCase.java","15192","124570","139762","7","279524"
"2012-12-13 12:33","BookKeeperClusterTestCase.java","10844","66225","77069","2","154138"
"2013-01-07 12:25","BookKeeperClusterTestCase.java","11886","72158","84044","2","168088"
"2016-04-27 09:55","BookKeeperClusterTestCase.java","47280","75034","122314","","244628"
"2013-01-03 11:06","BookKeeperClusterTestCase.java","11824","71069","82893","2","165786"
"2015-10-06 10:48","BookKeeperClusterTestCase.java","16156","141277","157433","","314866"
"2014-12-10 19:43","BookKeeperClusterTestCase.java","15891","137520","153411","","306822"
"2017-06-01 23:58","ExplicitLacFlushPolicy.java","1414","4607","6021","","12042"
"2017-06-01 23:58","ExplicitLacFlushPolicy.java","3348","14535","17883","","35766"
"2017-05-15 19:52","ExplicitLacFlushPolicy.java","2071","10065","12136","","24272"
"2016-12-21 01:48","LedgerCacheTest.java","112086","54278","166364","","332728"
"2019-02-20 11:43","LedgerCacheTest.java","133359","414228","547587","","1095174"
"2017-05-16 00:31","LedgerCacheTest.java","113176","70696","183872","","367744"
"2013-12-02 18:45","LedgerCacheTest.java","761","3631","4392","6","8784"
"2014-07-24 01:41","LedgerCacheTest.java","3366","14393","17759","","35518"
"2014-12-10 19:43","LedgerCacheTest.java","4587","25242","29829","","59658"
"2016-03-08 06:49","LedgerCacheTest.java","5721","32615","38336","","76672"
"2014-03-12 21:26","LedgerCacheTest.java","2716","10988","13704","7","27408"
"2014-07-24 01:41","BookieFailureTest.java","7601","61255","68856","","137712"
"2014-07-24 01:41","TestFencing.java","18739","148681","167420","","334840"
"2012-06-19 12:39","TestFencing.java","11045","34587","45632","2","91264"
"2012-12-18 13:04","TestFencing.java","16282","92562","108844","2","217688"
"2014-02-05 22:43","TestFencing.java","18498","142682","161180","7","322360"
"2011-11-18 11:18","TestFencing.java","939","2870","3809","","7618"
"2012-03-31 10:58","TestFencing.java","9907","27848","37755","1","75510"
"2013-08-23 18:48","TestFencing.java","18040","135935","153975","5","307950"
"2012-01-11 15:46","TestFencing.java","2013","7984","9997","1","19994"
"2012-03-13 07:31","TestFencing.java","2832","17291","20123","1","40246"
"2011-11-29 18:45","TestFencing.java","1385","6226","7611","","15222"
"2012-04-02 12:38","TestFencing.java","9922","28001","37923","1","75846"
"2017-08-02 00:49","BookieRequestProcessor.java","5371","23577","28948","","57896"
"2017-06-05 20:30","LedgerDirsManager.java","113661","71444","185105","","370210"
"2017-01-30 23:25","LedgerDirsManager.java","111620","51367","162987","","325974"
"2017-03-28 22:35","LedgerDirsManager.java","111726","62204","173930","","347860"
"2014-01-15 15:58","LedgerDirsManager.java","112","456","568","6","1136"
"2017-06-28 23:24","LedgerDirsManager.java","113852","74679","188531","","377062"
"2017-07-07 08:19","LedgerDirsManager.java","114157","80780","194937","","389874"
"2014-01-21 17:26","LedgerDirsManager.java","568","2457","3025","6","6050"
"2014-08-02 20:02","LedgerDirsManager.java","3072","17681","20753","","41506"
"2012-12-24 05:50","InterleavedLedgerStorage.java","10199","63811","74010","2","148020"
"2012-12-18 13:04","InterleavedLedgerStorage.java","9806","63310","73116","2","146232"
"2016-11-18 00:18","InterleavedLedgerStorage.java","48550","80344","128894","","257788"
"2013-12-02 18:45","InterleavedLedgerStorage.java","13961","112970","126931","6","253862"
"2013-05-04 14:22","InterleavedLedgerStorage.java","12681","101586","114267","5","228534"
"2014-01-15 15:58","InterleavedLedgerStorage.java","13983","113336","127319","6","254638"
"2014-01-21 17:26","InterleavedLedgerStorage.java","14077","114975","129052","6","258104"
"2013-10-02 06:23","InterleavedLedgerStorage.java","12976","108192","121168","5","242336"
"2017-05-16 00:31","InterleavedLedgerStorage.java","49163","102822","151985","","303970"
"2014-08-02 20:02","InterleavedLedgerStorage.java","15065","128683","143748","","287496"
"2017-07-04 06:27","InterleavedLedgerStorage.java","49927","113596","163523","","327046"
"2012-10-18 16:40","InterleavedLedgerStorage.java","8726","46684","55410","2","110820"
"2015-04-21 09:55","InterleavedLedgerStorage.java","15365","134405","149770","","299540"
"2017-01-31 04:01","InterleavedLedgerStorage.java","48592","93487","142079","","284158"
"2016-03-08 06:49","InterleavedLedgerStorage.java","15848","138881","154729","","309458"
"2017-03-28 22:37","InterleavedLedgerStorage.java","48647","98349","146996","","293992"
"2015-04-21 09:17","InterleavedLedgerStorage.java","15349","134218","149567","","299134"
"2017-05-26 16:52","Value.java","8016","39689","47705","","95410"
"2014-12-05 17:51","RoundRobinDistributionScheduleTest.java","12008","98633","110641","","221282"
"2017-06-30 00:12","RoundRobinDistributionScheduleTest.java","68690","100683","169373","","338746"
"2013-10-14 16:43","RoundRobinDistributionScheduleTest.java","10169","76627","86796","6","173592"
"2014-07-24 01:41","TestEntryLog.java","834","3589","4423","","8846"
"2014-12-10 19:43","TestEntryLog.java","2653","15036","17689","","35378"
"2016-02-24 00:44","TestEntryLog.java","3893","22163","26056","","52112"
"2017-05-16 00:31","TestEntryLog.java","112644","61892","174536","","349072"
"2017-07-07 08:19","TestEntryLog.java","114205","75426","189631","","379262"
"2017-06-30 00:12","ReadLastConfirmedOp.java","65050","103885","168935","","337870"
"2012-09-14 15:42","ReadLastConfirmedOp.java","1198","8176","9374","2","18748"
"2017-05-15 19:52","ReadLastConfirmedOp.java","64266","94634","158900","","317800"
"2017-06-01 23:58","ReadLastConfirmedOp.java","64960","98521","163481","","326962"
"2014-02-21 19:01","ReadLastConfirmedOp.java","11012","90710","101722","7","203444"
"2013-02-08 19:08","MacDigestManager.java","17898","129758","147656","4","295312"
"2017-07-28 20:12","MacDigestManager.java","40782","133519","174301","","348602"
"2017-05-15 19:52","MacDigestManager.java","40437","118152","158589","","317178"
"2017-05-17 08:57","MacDigestManager.java","40463","118655","159118","","318236"
"2012-02-01 16:19","MacDigestManager.java","4463","13280","17743","1","35486"
"2013-05-04 14:22","GarbageCollectorThread.java","3430","38723","42153","5","84306"
"2013-09-11 00:34","GarbageCollectorThread.java","4001","45594","49595","5","99190"
"2014-01-15 15:58","GarbageCollectorThread.java","5272","51013","56285","6","112570"
"2013-10-22 07:44","GarbageCollectorThread.java","5071","47971","53042","6","106084"
"2017-05-09 23:06","GarbageCollectorThread.java","80512","78677","159189","","318378"
"2014-01-21 17:26","GarbageCollectorThread.java","5464","52750","58214","6","116428"
"2013-10-02 06:23","GarbageCollectorThread.java","4002","45606","49608","5","99216"
"2017-11-08 12:27","GarbageCollectorThread.java","92613","128907","221520","","443040"
"2017-03-28 22:39","GarbageCollectorThread.java","80119","76228","156347","","312694"
"2017-01-30 23:25","GarbageCollectorThread.java","79977","65121","145098","","290196"
"2016-05-04 15:55","GarbageCollectorThread.java","78450","47780","126230","","252460"
"2016-03-08 06:49","GarbageCollectorThread.java","8550","77971","86521","","173042"
"2016-02-24 00:44","GarbageCollectorThread.java","8508","77577","86085","","172170"
"2015-04-21 09:55","GarbageCollectorThread.java","7623","73051","80674","","161348"
"2013-10-30 16:23","GarbageCollectorThread.java","5177","50050","55227","6","110454"
"2014-07-24 01:41","ConditionalSetTest.java","19449","150859","170308","","340616"
"2011-11-17 11:16","ConditionalSetTest.java","2939","5050","7989","","15978"
"2011-11-18 11:18","ConditionalSetTest.java","3574","6973","10547","","21094"
"2016-03-16 04:51","AutoRecoveryMain.java","78897","44892","123789","","247578"
"2013-10-02 06:23","AutoRecoveryMain.java","4644","46646","51290","5","102580"
"2013-01-14 16:59","AutoRecoveryMain.java","2346","5805","8151","2","16302"
"2014-03-10 03:14","AutoRecoveryMain.java","6964","57045","64009","7","128018"
"2014-04-24 10:43","AutoRecoveryMain.java","7017","58346","65363","7","130726"
"2014-09-06 07:58","AutoRecoveryMain.java","7782","70192","77974","","155948"
"2013-12-06 07:39","AutoRecoveryMain.java","5817","51764","57581","6","115162"
"2017-07-07 05:11","Auditor.java","2380","12152","14532","","29064"
"2017-04-11 20:19","BookKeeperCloseTest.java","111117","58495","169612","","339224"
"2017-05-16 00:31","BookKeeperCloseTest.java","112047","63135","175182","","350364"
"2014-09-18 06:53","BookKeeperCloseTest.java","2318","15250","17568","","35136"
"2014-12-06 07:38","BookKeeperCloseTest.java","2460","16295","18755","","37510"
"2016-03-08 06:49","CompactionTest.java","1555","5548","7103","","14206"
"2016-05-04 15:55","CompactionTest.java","106379","10281","116660","","233320"
"2017-03-22 22:54","CompactionTest.java","112026","38169","150195","","300390"
"2017-06-21 21:07","CompactionTest.java","114815","55377","170192","","340384"
"2017-11-08 12:27","CompactionTest.java","132826","103692","236518","","473036"
"2017-05-16 00:31","CompactionTest.java","113474","48093","161567","","323134"
"2017-07-07 08:19","CompactionTest.java","115376","61968","177344","","354688"
"2015-07-10 22:48","ZooKeeperUtil.java","681","3321","4002","","8004"
"2016-04-05 21:52","ZooKeeperUtil.java","106307","11873","118180","","236360"
"2017-11-08 12:27","BookKeeperClusterTestCase.java","33149","43765","76914","","153828"
"2017-05-09 23:06","GarbageCollectorThread.java","824","2880","3704","","7408"
"2017-11-08 12:27","GarbageCollectorThread.java","37457","77642","115099","","230198"
"2017-05-15 19:52","LedgerHandle.java","111946","76642","188588","","377176"
"2017-05-02 22:07","LedgerHandle.java","111266","73608","184874","","369748"
"2017-03-23 15:55","LedgerHandle.java","111156","67872","179028","","358056"
"2016-09-10 21:01","LedgerHandle.java","110917","50346","161263","","322526"
"2016-07-11 23:01","LedgerHandle.java","109633","44958","154591","","309182"
"2013-10-14 18:32","LedgerHandle.java","2134","9821","11955","6","23910"
"2014-02-05 22:43","LedgerHandle.java","3706","16569","20275","7","40550"
"2014-02-21 19:01","LedgerHandle.java","3869","17895","21764","7","43528"
"2017-05-17 08:57","LedgerHandle.java","112061","77234","189295","","378590"
"2017-05-25 14:23","LedgerHandle.java","112093","79071","191164","","382328"
"2017-06-21 19:50","LedgerHandle.java","113014","82923","195937","","391874"
"2017-06-21 21:00","LedgerHandle.java","113021","83713","196734","","393468"
"2017-06-01 23:58","LedgerHandle.java","112815","80704","193519","","387038"
"2014-01-21 05:19","LedgerHandle.java","2801","14861","17662","6","35324"
"2014-09-18 06:47","LedgerHandle.java","4931","32013","36944","","73888"
"2014-12-09 19:57","LedgerHandle.java","5062","33237","38299","","76598"
"2017-07-04 06:27","LedgerHandle.java","113300","88424","201724","","403448"
"2017-06-30 00:12","LedgerHandle.java","113195","86358","199553","","399106"
"2014-05-30 14:01","LedgerHandle.java","4137","22097","26234","7","52468"
"2014-05-30 15:07","LedgerHandle.java","4155","22154","26309","7","52618"
"2014-01-17 18:13","LedgerHandle.java","2497","13661","16158","6","32316"
"2016-02-09 08:32","LedgerHandle.java","6169","39775","45944","","91888"
"2016-03-16 05:03","LedgerHandle.java","109364","40231","149595","","299190"
"2015-10-22 09:22","LedgerHandle.java","6053","38624","44677","","89354"
"2015-10-06 10:05","LedgerHandle.java","6023","37538","43561","","87122"
"2017-01-31 04:01","LedgerHandle.java","111074","67424","178498","","356996"
"2015-04-21 09:39","LedgerHandle.java","5371","35715","41086","","82172"
"2015-10-06 11:12","LedgerHandle.java","6026","37781","43807","","87614"
"2014-12-05 14:10","LedgerHandle.java","5021","32747","37768","","75536"
"2019-02-20 11:43","LedgerCacheTest.java","51839","375188","427027","","854054"
"2017-10-17 09:32","BookKeeperAdmin.java","30089","78650","108739","","217478"
"2017-06-01 23:58","BookKeeperAdmin.java","3946","29055","33001","","66002"
"2017-04-11 20:19","BookKeeperAdmin.java","1345","19969","21314","","42628"
"2017-07-07 05:11","BookKeeperAdmin.java","5038","39062","44100","","88200"
"2016-11-09 03:05","BookKeeperAdmin.java","46","380","426","","852"
"2016-11-30 00:07","BookKeeperAdmin.java","197","1195","1392","","2784"
"2014-09-22 12:11","CodahaleMetricsProvider.java","387","566","953","","1906"
"2016-12-17 02:43","CodahaleMetricsProvider.java","112627","35209","147836","","295672"
"2017-05-26 16:52","CodahaleMetricsProvider.java","114234","54334","168568","","337136"
"2013-03-25 06:27","BookieZKExpireTest.java","3976","39043","43019","4","86038"
"2014-12-10 19:43","BookieZKExpireTest.java","8298","72320","80618","","161236"
"2016-01-26 22:11","BookieZKExpireTest.java","8974","78221","87195","","174390"
"2017-06-01 23:58","EntryLogger.java","8899","41429","50328","","100656"
"2017-11-08 12:27","EntryLogger.java","29951","95953","125904","","251808"
"2017-01-31 02:11","EntryLogger.java","5623","20533","26156","","52312"
"2017-03-23 00:48","EntryLogger.java","6257","27588","33845","","67690"
"2017-07-07 08:19","BookieInitializationTest.java","114954","61152","176106","","352212"
"2017-06-28 23:24","BookieInitializationTest.java","114427","54829","169256","","338512"
"2017-07-28 06:39","BookieInitializationTest.java","116066","64153","180219","","360438"
"2017-08-02 00:49","BookieInitializationTest.java","118802","81243","200045","","400090"
"2017-06-05 20:30","BookieInitializationTest.java","114065","51423","165488","","330976"
"2017-05-15 19:52","BookieInitializationTest.java","112885","46692","159577","","319154"
"2017-05-16 00:31","ResponseBuilder.java","111707","77894","189601","","379202"
"2017-05-15 19:52","TestBackwardCompatCMS42.java","2090","15905","17995","","35990"
"2017-06-01 23:58","LedgerCacheImpl.java","1160","3935","5095","","10190"
"2017-07-04 06:27","LedgerCacheImpl.java","2419","12429","14848","","29696"
"2017-05-16 00:31","ConcurrentLedgerTest.java","113453","50318","163771","","327542"
"2017-05-15 19:52","BookKeeperClusterTestCase.java","113068","70170","183238","","366476"
"2016-04-05 08:45","BookKeeperClusterTestCase.java","109017","34993","144010","","288020"
"2017-08-01 08:34","BookKeeperClusterTestCase.java","117232","100383","217615","","435230"
"2014-02-05 22:43","BookKeeperClusterTestCase.java","2368","7637","10005","7","20010"
"2017-11-08 12:27","BookKeeperClusterTestCase.java","126655","120422","247077","","494154"
"2014-05-09 14:04","BookKeeperClusterTestCase.java","2849","12272","15121","7","30242"
"2017-07-04 06:27","BookKeeperClusterTestCase.java","114520","82050","196570","","393140"
"2014-07-24 01:41","BookKeeperClusterTestCase.java","3366","14393","17759","","35518"
"2014-05-23 18:46","BookKeeperClusterTestCase.java","2855","12608","15463","7","30926"
"2017-06-30 00:12","BookKeeperClusterTestCase.java","114404","79973","194377","","388754"
"2014-04-24 10:43","BookKeeperClusterTestCase.java","2762","11166","13928","7","27856"
"2016-04-27 09:55","BookKeeperClusterTestCase.java","109102","35882","144984","","289968"
"2015-10-06 10:48","BookKeeperClusterTestCase.java","5384","29531","34915","","69830"
"2014-12-10 19:43","BookKeeperClusterTestCase.java","4587","25242","29829","","59658"
"2017-05-02 23:04","HierarchicalLedgerManager.java","46868","104997","151865","","303730"
"2012-12-24 05:50","HierarchicalLedgerManager.java","11212","71202","82414","2","164828"
"2017-05-12 16:39","HierarchicalLedgerManager.java","46871","105680","152551","","305102"
"2013-04-04 11:21","HierarchicalLedgerManager.java","13294","108021","121315","5","242630"
"2014-01-17 18:13","HierarchicalLedgerManager.java","14468","120555","135023","6","270046"
"2017-07-28 20:12","BKException.java","49151","122111","171262","","342524"
"2016-07-11 22:53","BKException.java","47349","75009","122358","","244716"
"2017-05-02 23:04","BKException.java","47775","104223","151998","","303996"
"2013-09-10 15:14","BKException.java","13760","113623","127383","5","254766"
"2014-02-21 19:01","BKException.java","15209","122477","137686","7","275372"
"2017-08-02 00:49","BKException.java","49587","136159","185746","","371492"
"2012-12-12 11:20","BKException.java","10626","65628","76254","2","152508"
"2012-06-19 12:39","BKException.java","2403","7866","10269","2","20538"
"2015-09-15 10:38","BKException.java","16185","140618","156803","","313606"
"2017-01-31 04:01","BKException.java","47503","97095","144598","","289196"
"2015-10-06 10:48","BKException.java","16189","141172","157361","","314722"
"2015-10-22 09:22","BKException.java","16199","142012","158211","","316422"
"2012-09-04 10:39","BKException.java","6836","39360","46196","2","92392"
"2012-12-03 17:59","BKException.java","10423","64227","74650","2","149300"
"2014-07-24 01:41","TestLedgerFragmentReplication.java","9824","82197","92021","","184042"
"2014-02-05 22:43","TestLedgerFragmentReplication.java","9255","75870","85125","7","170250"
"2014-12-10 19:43","BookieInitializationTest.java","5212","26600","31812","","63624"
"2014-06-06 15:29","BookieInitializationTest.java","3695","15447","19142","7","38284"
"2015-07-10 22:48","BookieInitializationTest.java","5540","29568","35108","","70216"
"2014-01-21 17:26","BookieInitializationTest.java","2004","7496","9500","6","19000"
"2013-10-12 05:42","BookieInitializationTest.java","1067","1800","2867","6","5734"
"2017-07-07 08:19","BookieInitializationTest.java","115059","85285","200344","","400688"
"2017-06-28 23:24","BookieInitializationTest.java","114788","79218","194006","","388012"
"2017-07-28 06:39","BookieInitializationTest.java","115706","87821","203527","","407054"
"2017-08-02 00:49","BookieInitializationTest.java","118254","104723","222977","","445954"
"2017-06-05 20:30","BookieInitializationTest.java","114618","76004","190622","","381244"
"2017-05-15 19:52","BookieInitializationTest.java","113632","71467","185099","","370198"
"2014-04-29 22:07","ClientUtil.java","11175","86187","97362","7","194724"
"2017-05-15 19:52","ClientUtil.java","67783","91115","158898","","317796"
"2017-05-25 14:23","ClientUtil.java","67890","93504","161394","","322788"
"2017-07-04 06:27","ServerConfiguration.java","10334","51596","61930","","123860"
"2016-04-27 09:55","ServerConfiguration.java","188","700","888","","1776"
"2017-05-15 19:52","ServerConfiguration.java","8153","38987","47140","","94280"
"2017-03-22 22:54","ServerConfiguration.java","6760","29536","36296","","72592"
"2017-03-23 00:48","ServerConfiguration.java","6765","29593","36358","","72716"
"2017-01-31 02:11","ServerConfiguration.java","6139","22546","28685","","57370"
"2016-11-09 03:02","ServerConfiguration.java","6019","15254","21273","","42546"
"2016-11-30 00:02","ServerConfiguration.java","6084","16001","22085","","44170"
"2017-06-05 20:30","ServerConfiguration.java","9467","43852","53319","","106638"
"2016-09-10 20:27","ServerConfiguration.java","4321","9767","14088","","28176"
"2017-08-02 00:49","ServerConfiguration.java","14659","74127","88786","","177572"
"2017-10-03 12:31","ServerConfiguration.java","26807","76432","103239","","206478"
"2017-08-16 03:37","ServerConfiguration.java","17061","83162","100223","","200446"
"2017-05-26 12:38","ServerConfiguration.java","8409","41559","49968","","99936"
"2017-07-07 08:19","ServerConfiguration.java","10384","53609","63993","","127986"
"2017-06-28 23:24","ServerConfiguration.java","9839","47268","57107","","114214"
"2017-11-08 12:27","ServerConfiguration.java","29540","97039","126579","","253158"
"2017-06-05 20:30","LedgerDirsManager.java","113614","71053","184667","","369334"
"2017-01-30 23:25","LedgerDirsManager.java","111553","50956","162509","","325018"
"2017-03-28 22:35","LedgerDirsManager.java","111662","61796","173458","","346916"
"2017-06-28 23:24","LedgerDirsManager.java","113807","74290","188097","","376194"
"2017-07-07 08:19","LedgerDirsManager.java","114117","80396","194513","","389026"
"2014-01-21 17:26","LedgerDirsManager.java","464","2009","2473","6","4946"
"2014-08-02 20:02","LedgerDirsManager.java","2987","17252","20239","","40478"
"2017-05-16 00:31","SortedLedgerStorage.java","1307","2535","3842","","7684"
"2017-07-07 05:11","BookKeeperConstants.java","5180","39190","44370","","88740"
"2017-06-30 00:12","BookKeeperConstants.java","4934","35303","40237","","80474"
"2015-09-15 10:38","AbstractConfiguration.java","15580","137126","152706","","305412"
"2017-03-28 22:40","AbstractConfiguration.java","48207","99947","148154","","296308"
"2012-10-05 16:24","AbstractConfiguration.java","8187","44790","52977","2","105954"
"2012-06-19 12:39","AbstractConfiguration.java","1012","3588","4600","2","9200"
"2012-12-12 11:20","AbstractConfiguration.java","9666","61781","71447","2","142894"
"2017-08-02 00:49","AbstractConfiguration.java","50331","134016","184347","","368694"
"2013-06-12 18:41","AbstractConfiguration.java","12933","107750","120683","5","241366"
"2012-06-13 16:57","AbstractConfiguration.java","229","2039","2268","","4536"
"2016-07-31 07:53","AbstractConfiguration.java","48001","73815","121816","","243632"
"2017-01-31 02:14","AbstractConfiguration.java","48103","89339","137442","","274884"
"2016-07-31 07:56","AbstractConfiguration.java","48001","74149","122150","","244300"
"2017-05-02 23:04","AbstractConfiguration.java","48411","101972","150383","","300766"
"2017-03-23 00:48","AbstractConfiguration.java","48153","95198","143351","","286702"
"2012-11-30 04:54","AbstractConfiguration.java","9426","59806","69232","2","138464"
"2017-07-07 08:19","LedgerDirsManager.java","803","6599","7402","","14804"
"2017-06-01 23:58","LedgerHandleAdv.java","1085","1996","3081","","6162"
"2017-03-23 15:55","CheckpointSourceList.java","41","119","160","","320"
"2015-04-21 09:17","WriteEntryProcessorV3.java","1381","6632","8013","","16026"
"2017-05-16 00:31","WriteEntryProcessorV3.java","114344","54385","168729","","337458"
"2016-11-12 03:35","WriteEntryProcessorV3.java","112787","30834","143621","","287242"
"2017-05-15 19:52","WriteEntryProcessorV3.java","114187","53810","167997","","335994"
"2017-08-02 00:49","DefaultPerChannelBookieClientPool.java","117771","93523","211294","","422588"
"2014-07-25 00:34","DefaultPerChannelBookieClientPool.java","1139","8004","9143","","18286"
"2017-05-15 19:52","BookKeeperClusterTestCase.java","111874","63707","175581","","351162"
"2016-04-05 08:45","BookKeeperClusterTestCase.java","107546","28253","135799","","271598"
"2017-08-01 08:34","BookKeeperClusterTestCase.java","116497","94379","210876","","421752"
"2017-11-08 12:27","BookKeeperClusterTestCase.java","126442","114940","241382","","482764"
"2014-05-09 14:04","BookKeeperClusterTestCase.java","510","4664","5174","7","10348"
"2017-07-04 06:27","BookKeeperClusterTestCase.java","113475","75736","189211","","378422"
"2014-07-24 01:41","BookKeeperClusterTestCase.java","1183","6941","8124","","16248"
"2014-05-23 18:46","BookKeeperClusterTestCase.java","524","5008","5532","7","11064"
"2017-06-30 00:12","BookKeeperClusterTestCase.java","113338","73638","186976","","373952"
"2014-04-24 10:43","BookKeeperClusterTestCase.java","422","3557","3979","7","7958"
"2016-04-27 09:55","BookKeeperClusterTestCase.java","107634","29145","136779","","273558"
"2015-10-06 10:48","BookKeeperClusterTestCase.java","3746","22624","26370","","52740"
"2014-12-10 19:43","BookKeeperClusterTestCase.java","2838","18224","21062","","42124"
"2017-08-02 00:49","BookieNettyServer.java","10828","64850","75678","","151356"
"2017-06-01 09:47","BookieNettyServer.java","4571","32924","37495","","74990"
"2017-05-15 19:52","BookieNettyServer.java","4280","29668","33948","","67896"
"2017-01-31 02:14","BookieNettyServer.java","2353","13926","16279","","32558"
"2017-03-23 00:48","BookieNettyServer.java","2562","19944","22506","","45012"
"2015-10-06 10:05","LedgerDeleteOp.java","1056","2247","3303","","6606"
"2017-05-15 19:52","BookieJournalTest.java","113296","49743","163039","","326078"
"2017-05-16 00:31","BookieJournalTest.java","113453","50318","163771","","327542"
"2012-12-12 11:20","BookieLedgerIndexTest.java","5375","29407","34782","2","69564"
"2013-10-14 16:43","BookieLedgerIndexTest.java","10379","80279","90658","6","181316"
"2017-05-15 19:52","LedgerHandle.java","112963","69972","182935","","365870"
"2017-05-02 22:07","LedgerHandle.java","112212","66867","179079","","358158"
"2017-03-23 15:55","LedgerHandle.java","112091","61120","173211","","346422"
"2016-09-10 21:01","LedgerHandle.java","110473","42215","152688","","305376"
"2016-07-11 23:01","LedgerHandle.java","109181","36819","146000","","292000"
"2014-02-05 22:43","LedgerHandle.java","2261","7437","9698","7","19396"
"2014-02-21 19:01","LedgerHandle.java","2441","8780","11221","7","22442"
"2017-05-17 08:57","LedgerHandle.java","113089","70575","183664","","367328"
"2017-05-25 14:23","LedgerHandle.java","113122","72413","185535","","371070"
"2017-06-21 19:50","LedgerHandle.java","114120","76342","190462","","380924"
"2017-06-21 21:00","LedgerHandle.java","114131","77136","191267","","382534"
"2017-06-01 23:58","LedgerHandle.java","113867","74069","187936","","375872"
"2014-01-21 05:19","LedgerHandle.java","1112","5485","6597","6","13194"
"2014-09-18 06:47","LedgerHandle.java","4035","23430","27465","","54930"
"2014-12-09 19:57","LedgerHandle.java","4167","24655","28822","","57644"
"2017-07-04 06:27","LedgerHandle.java","114440","81877","196317","","392634"
"2017-06-30 00:12","LedgerHandle.java","114324","79800","194124","","388248"
"2014-05-30 14:01","LedgerHandle.java","2818","13091","15909","7","31818"
"2014-05-30 15:07","LedgerHandle.java","2838","13150","15988","7","31976"
"2014-01-17 18:13","LedgerHandle.java","796","4273","5069","6","10138"
"2016-02-09 08:32","LedgerHandle.java","5434","31353","36787","","73574"
"2016-03-16 05:03","LedgerHandle.java","108899","32079","140978","","281956"
"2015-10-22 09:22","LedgerHandle.java","5304","30188","35492","","70984"
"2015-10-06 10:05","LedgerHandle.java","5273","29101","34374","","68748"
"2017-01-31 04:01","LedgerHandle.java","111993","60656","172649","","345298"
"2015-04-21 09:39","LedgerHandle.java","4534","27191","31725","","63450"
"2015-10-06 11:12","LedgerHandle.java","5276","29344","34620","","69240"
"2014-12-05 14:10","LedgerHandle.java","4123","24162","28285","","56570"
"2014-07-24 01:41","ConcurrentLedgerTest.java","19016","148315","167331","","334662"
"2014-12-10 19:43","ConcurrentLedgerTest.java","19200","158127","177327","","354654"
"2011-11-28 19:25","ConcurrentLedgerTest.java","1137","5169","6306","","12612"
"2011-11-18 11:18","ConcurrentLedgerTest.java","717","2005","2722","","5444"
"2012-03-08 19:24","ConcurrentLedgerTest.java","2557","14116","16673","1","33346"
"2012-02-15 16:11","ConcurrentLedgerTest.java","2238","11915","14153","1","28306"
"2013-10-12 05:42","ConcurrentLedgerTest.java","18328","136600","154928","6","309856"
"2014-02-05 22:43","ConcurrentLedgerTest.java","18772","142313","161085","7","322170"
"2017-05-16 00:31","ConcurrentLedgerTest.java","40748","116540","157288","","314576"
"2017-06-30 00:12","RoundRobinDistributionScheduleTest.java","115434","60802","176236","","352472"
"2016-11-18 00:18","LedgerCacheImpl.java","112105","48301","160406","","320812"
"2017-05-16 00:31","LedgerCacheImpl.java","113235","71296","184531","","369062"
"2017-06-01 23:58","LedgerCacheImpl.java","114026","74862","188888","","377776"
"2014-08-02 20:02","LedgerCacheImpl.java","3814","21834","25648","","51296"
"2017-07-04 06:27","LedgerCacheImpl.java","114576","82647","197223","","394446"
"2017-01-31 04:01","LedgerCacheImpl.java","112168","61465","173633","","347266"
"2017-07-04 06:27","ServerConfiguration.java","115359","60429","175788","","351576"
"2016-04-14 00:51","ServerConfiguration.java","106389","10197","116586","","233172"
"2016-03-08 06:49","ServerConfiguration.java","1726","6160","7886","","15772"
"2016-01-26 22:11","ServerConfiguration.java","1349","4769","6118","","12236"
"2016-04-05 18:47","ServerConfiguration.java","106363","10121","116484","","232968"
"2016-04-27 09:55","ServerConfiguration.java","106450","10770","117220","","234440"
"2015-04-21 09:55","ServerConfiguration.java","191","632","823","","1646"
"2015-04-21 10:02","ServerConfiguration.java","204","678","882","","1764"
"2017-05-15 19:52","ServerConfiguration.java","113379","48021","161400","","322800"
"2017-03-22 22:54","ServerConfiguration.java","112112","38696","150808","","301616"
"2017-03-23 00:48","ServerConfiguration.java","112117","38753","150870","","301740"
"2017-01-31 02:11","ServerConfiguration.java","111985","32200","144185","","288370"
"2016-04-05 08:45","ServerConfiguration.java","106352","9868","116220","","232440"
"2016-11-09 03:02","ServerConfiguration.java","111872","24915","136787","","273574"
"2016-11-30 00:02","ServerConfiguration.java","111935","25660","137595","","275190"
"2017-06-05 20:30","ServerConfiguration.java","114541","52734","167275","","334550"
"2016-09-10 20:27","ServerConfiguration.java","110231","19485","129716","","259432"
"2017-08-02 00:49","ServerConfiguration.java","119198","82474","201672","","403344"
"2017-10-03 12:31","ServerConfiguration.java","130514","83947","214461","","428922"
"2017-08-16 03:37","ServerConfiguration.java","121434","91343","212777","","425554"
"2017-05-26 12:38","ServerConfiguration.java","113595","50553","164148","","328296"
"2017-07-07 08:19","ServerConfiguration.java","115408","62441","177849","","355698"
"2017-06-28 23:24","ServerConfiguration.java","114885","56122","171007","","342014"
"2017-11-08 12:27","ServerConfiguration.java","132737","104044","236781","","473562"
"2017-07-07 05:11","Auditor.java","113157","90667","203824","","407648"
"2014-02-05 22:43","Auditor.java","3888","17457","21345","7","42690"
"2013-08-21 13:19","Auditor.java","1099","8370","9469","5","18938"
"2017-05-26 16:52","Auditor.java","111975","79713","191688","","383376"
"2016-09-10 21:01","Auditor.java","110847","50982","161829","","323658"
"2016-11-09 03:02","Auditor.java","110964","54767","165731","","331462"
"2016-03-08 07:18","Auditor.java","6492","42351","48843","","97686"
"2014-04-24 10:43","Auditor.java","4179","20883","25062","7","50124"
"2014-06-02 11:54","Auditor.java","4405","23247","27652","7","55304"
"2014-05-06 12:30","Auditor.java","4233","21362","25595","7","51190"
"2014-05-23 18:48","Auditor.java","4254","22307","26561","7","53122"
"2015-10-06 10:05","ReadOnlyLedgerHandle.java","4712","25063","29775","","59550"
"2017-01-31 04:01","ReadOnlyLedgerHandle.java","111542","56728","168270","","336540"
"2017-06-30 00:12","ReadOnlyLedgerHandle.java","113974","75973","189947","","379894"
"2014-02-05 22:43","ReadOnlyLedgerHandle.java","1505","3204","4709","7","9418"
"2017-03-23 15:55","ReadOnlyLedgerHandle.java","111653","57205","168858","","337716"
"2015-07-10 22:48","ZooKeeperWatcherBase.java","1878","6218","8096","","16192"
"2017-06-01 23:58","ZooKeeperWatcherBase.java","115384","56724","172108","","344216"
"2012-05-10 14:47","BookieException.java","12253","33843","46096","1","92192"
"2012-09-07 07:04","BookieException.java","14480","68144","82624","2","165248"
"2011-11-16 17:05","BookieException.java","2735","4433","7168","","14336"
"2013-02-08 19:08","BookieException.java","17898","129758","147656","4","295312"
"2012-03-13 07:31","BookieException.java","4997","21154","26151","1","52302"
"2017-07-07 08:19","BookieException.java","40545","130651","171196","","342392"
"2013-01-09 18:48","IndexCorruptionTest.java","12695","75483","88178","2","176356"
"2013-01-09 17:18","IndexCorruptionTest.java","12663","75254","87917","2","175834"
"2013-05-09 11:41","IndexCorruptionTest.java","13970","110011","123981","5","247962"
"2016-02-09 08:30","Journal.java","1302","4569","5871","","11742"
"2017-05-26 16:52","Journal.java","113534","50238","163772","","327544"
"2017-03-22 22:54","Journal.java","112033","38343","150376","","300752"
"2016-11-12 03:37","Journal.java","111825","24642","136467","","272934"
"2016-07-14 23:02","Journal.java","106742","11773","118515","","237030"
"2017-06-01 23:58","Journal.java","114362","51923","166285","","332570"
"2017-05-09 22:24","Journal.java","112764","45670","158434","","316868"
"2017-05-16 00:31","Journal.java","113467","48253","161720","","323440"
"2014-08-02 20:02","ServerConfiguration.java","5885","32117","38002","","76004"
"2014-05-06 12:30","ServerConfiguration.java","5191","22773","27964","7","55928"
"2014-05-15 00:41","ServerConfiguration.java","5211","23707","28918","7","57836"
"2014-09-18 06:47","ServerConfiguration.java","5958","34199","40157","","80314"
"2017-07-04 06:27","ServerConfiguration.java","113535","89818","203353","","406706"
"2014-03-07 13:14","ServerConfiguration.java","5018","20241","25259","7","50518"
"2014-04-29 22:07","ServerConfiguration.java","5188","22723","27911","7","55822"
"2016-04-14 00:51","ServerConfiguration.java","109871","44892","154763","","309526"
"2015-01-16 15:57","ServerConfiguration.java","6358","37571","43929","","87858"
"2016-03-08 06:49","ServerConfiguration.java","7355","43002","50357","","100714"
"2016-01-26 22:11","ServerConfiguration.java","7101","41734","48835","","97670"
"2014-01-21 05:05","ServerConfiguration.java","3898","16771","20669","6","41338"
"2014-03-12 21:26","ServerConfiguration.java","5094","22119","27213","7","54426"
"2016-04-05 18:47","ServerConfiguration.java","109851","44822","154673","","309346"
"2016-04-27 09:55","ServerConfiguration.java","109919","45452","155371","","310742"
"2015-04-21 09:55","ServerConfiguration.java","6410","38064","44474","","88948"
"2015-01-12 15:18","ServerConfiguration.java","6355","36630","42985","","85970"
"2015-04-21 10:02","ServerConfiguration.java","6406","38093","44499","","88998"
"2017-05-15 19:52","ServerConfiguration.java","112230","78085","190315","","380630"
"2017-03-22 22:54","ServerConfiguration.java","111544","69341","180885","","361770"
"2017-03-23 00:48","ServerConfiguration.java","111548","69397","180945","","361890"
"2017-01-31 02:11","ServerConfiguration.java","111456","62884","174340","","348680"
"2013-02-19 16:19","ServerConfiguration.java","990","943","1933","4","3866"
"2013-02-19 16:15","ServerConfiguration.java","984","918","1902","4","3804"
"2016-04-05 08:45","ServerConfiguration.java","109849","44578","154427","","308854"
"2016-11-09 03:02","ServerConfiguration.java","111423","55679","167102","","334204"
"2016-11-30 00:02","ServerConfiguration.java","111433","56371","167804","","335608"
"2017-06-05 20:30","ServerConfiguration.java","113115","82521","195636","","391272"
"2016-09-10 20:27","ServerConfiguration.java","111294","51761","163055","","326110"
"2017-08-02 00:49","ServerConfiguration.java","116603","111092","227695","","455390"
"2017-10-03 12:31","ServerConfiguration.java","123286","107932","231218","","462436"
"2017-08-16 03:37","ServerConfiguration.java","117824","118946","236770","","473540"
"2013-07-20 19:59","ServerConfiguration.java","2198","8815","11013","5","22026"
"2013-12-02 18:45","ServerConfiguration.java","3782","15405","19187","6","38374"
"2014-05-09 14:04","ServerConfiguration.java","5206","23382","28588","7","57176"
"2017-05-26 12:38","ServerConfiguration.java","112362","80533","192895","","385790"
"2013-06-15 19:05","ServerConfiguration.java","2108","8156","10264","5","20528"
"2014-01-15 15:58","ServerConfiguration.java","3862","15829","19691","6","39382"
"2013-10-22 07:44","ServerConfiguration.java","3655","12781","16436","6","32872"
"2017-07-07 08:19","ServerConfiguration.java","113524","91770","205294","","410588"
"2017-06-28 23:24","ServerConfiguration.java","113269","85719","198988","","397976"
"2017-11-08 12:27","ServerConfiguration.java","124640","127160","251800","","503600"
"2014-01-22 14:35","ServerConfiguration.java","4184","18072","22256","6","44512"
"2013-10-12 05:42","ServerConfiguration.java","3450","12203","15653","6","31306"
"2016-04-14 00:51","TestBKConfiguration.java","108047","25533","133580","","267160"
"2017-05-15 19:52","LedgerHandle.java","111874","63707","175581","","351162"
"2017-05-02 22:07","LedgerHandle.java","111088","60567","171655","","343310"
"2017-03-23 15:55","LedgerHandle.java","110933","54786","165719","","331438"
"2016-09-10 21:01","LedgerHandle.java","109171","35737","144908","","289816"
"2016-07-11 23:01","LedgerHandle.java","107874","30336","138210","","276420"
"2014-02-21 19:01","LedgerHandle.java","201","1364","1565","7","3130"
"2017-05-17 08:57","LedgerHandle.java","112017","64327","176344","","352688"
"2017-05-25 14:23","LedgerHandle.java","112050","66165","178215","","356430"
"2017-06-21 19:50","LedgerHandle.java","113101","70147","183248","","366496"
"2017-06-21 21:00","LedgerHandle.java","113111","70940","184051","","368102"
"2017-06-01 23:58","LedgerHandle.java","112825","67851","180676","","361352"
"2014-09-18 06:47","LedgerHandle.java","2360","16579","18939","","37878"
"2014-12-09 19:57","LedgerHandle.java","2516","17828","20344","","40688"
"2017-07-04 06:27","LedgerHandle.java","113475","75736","189211","","378422"
"2017-06-30 00:12","LedgerHandle.java","113338","73638","186976","","373952"
"2014-05-30 14:01","LedgerHandle.java","700","5797","6497","7","12994"
"2014-05-30 15:07","LedgerHandle.java","720","5856","6576","7","13152"
"2016-02-09 08:32","LedgerHandle.java","3922","24665","28587","","57174"
"2016-03-16 05:03","LedgerHandle.java","107526","25530","133056","","266112"
"2015-10-22 09:22","LedgerHandle.java","3774","23482","27256","","54512"
"2015-10-06 10:05","LedgerHandle.java","3740","22392","26132","","52264"
"2017-01-31 04:01","LedgerHandle.java","110826","54313","165139","","330278"
"2015-04-21 09:39","LedgerHandle.java","2956","20437","23393","","46786"
"2015-10-06 11:12","LedgerHandle.java","3746","22638","26384","","52768"
"2014-12-05 14:10","LedgerHandle.java","2462","17325","19787","","39574"
"2017-05-04 20:58","AbstractZkLedgerManager.java","111525","75463","186988","","373976"
"2013-07-29 12:30","AbstractZkLedgerManager.java","1010","7834","8844","5","17688"
"2017-06-01 23:58","AbstractZkLedgerManager.java","112692","81287","193979","","387958"
"2017-06-12 17:20","AbstractZkLedgerManager.java","112853","83225","196078","","392156"
"2017-03-28 22:40","AbstractZkLedgerManager.java","111151","73242","184393","","368786"
"2016-02-09 08:23","AbstractZkLedgerManager.java","6337","40479","46816","","93632"
"2015-09-15 10:38","AbstractZkLedgerManager.java","6192","38089","44281","","88562"
"2016-02-23 19:16","AbstractZkLedgerManager.java","6362","40842","47204","","94408"
"2014-05-12 08:10","AbstractZkLedgerManager.java","4253","22294","26547","7","53094"
"2014-01-17 18:13","AbstractZkLedgerManager.java","2699","14569","17268","6","34536"
"2013-05-31 12:02","BookieJournalRollingTest.java","18841","120390","139231","5","278462"
"2013-10-12 05:42","BookieJournalRollingTest.java","19088","127442","146530","6","293060"
"2012-03-15 10:37","BookieJournalRollingTest.java","7474","12707","20181","1","40362"
"2014-07-24 01:41","BookieJournalRollingTest.java","19959","139340","159299","","318598"
"2012-04-17 13:16","BookieJournalRollingTest.java","8883","16987","25870","1","51740"
"2012-12-13 12:33","LedgerRecoveryTest.java","17296","92316","109612","2","219224"
"2013-01-07 12:25","LedgerRecoveryTest.java","17622","97533","115155","2","230310"
"2011-11-17 11:16","LedgerRecoveryTest.java","2969","5310","8279","","16558"
"2012-02-13 15:46","LedgerRecoveryTest.java","4625","16631","21256","1","42512"
"2012-01-17 16:52","LedgerRecoveryTest.java","4405","12129","16534","1","33068"
"2011-11-04 11:00","LedgerRecoveryTest.java","2094","2044","4138","","8276"
"2013-06-12 18:41","LedgerRecoveryTest.java","18830","136311","155141","5","310282"
"2013-03-25 18:02","LedgerRecoveryTest.java","18737","131393","150130","4","300260"
"2014-02-05 22:43","LedgerRecoveryTest.java","19159","145041","164200","7","328400"
"2017-05-16 00:31","LedgerRecoveryTest.java","40457","118590","159047","","318094"
"2017-06-21 19:50","LedgerRecoveryTest.java","40534","123462","163996","","327992"
"2017-06-01 23:58","ReadEntryProcessorV3.java","3874","28643","32517","","65034"
"2017-05-16 00:31","ReadEntryProcessorV3.java","2882","24876","27758","","55516"
"2017-05-15 19:52","ReadEntryProcessorV3.java","2703","24279","26982","","53964"
"2017-06-05 22:25","ReadEntryProcessorV3.java","4292","30510","34802","","69604"
"2016-08-01 08:04","LedgerOpenOp.java","108938","32902","141840","","283680"
"2015-10-06 10:05","LedgerOpenOp.java","4836","24291","29127","","58254"
"2015-04-21 09:17","LedgerOpenOp.java","4052","22316","26368","","52736"
"2014-02-21 19:01","LedgerOpenOp.java","1382","3348","4730","7","9460"
"2017-06-05 20:30","IndexPersistenceMgrTest.java","114824","55354","170178","","340356"
"2017-10-03 12:31","IndexPersistenceMgrTest.java","130084","85854","215938","","431876"
"2017-07-07 08:19","IndexPersistenceMgrTest.java","115669","65039","180708","","361416"
"2017-01-31 04:01","BookieRequestProcessor.java","112860","44137","156997","","313994"
"2017-06-05 22:25","BookieRequestProcessor.java","115521","59786","175307","","350614"
"2017-07-04 06:27","BookieRequestProcessor.java","116075","66126","182201","","364402"
"2017-08-02 00:49","BookieRequestProcessor.java","119826","88083","207909","","415818"
"2017-03-28 22:35","BookieRequestProcessor.java","112996","48865","161861","","323722"
"2017-01-31 02:14","BookieRequestProcessor.java","112858","38666","151524","","303048"
"2017-05-15 19:52","BookieRequestProcessor.java","114187","53810","167997","","335994"
"2013-05-04 14:22","BookieAccessor.java","2688","36368","39056","5","78112"
"2017-03-22 22:54","BookieAccessor.java","80325","70283","150608","","301216"
"2017-08-02 00:49","BookkeeperInternalCallbacks.java","6070","30062","36132","","72264"
"2017-06-21 21:00","BookkeeperInternalCallbacks.java","107","1461","1568","","3136"
"2017-06-01 23:58","ReplicationWorker.java","1071","1928","2999","","5998"
"2016-12-21 01:48","LedgerCacheTest.java","111615","50937","162552","","325104"
"2019-02-20 11:43","LedgerCacheTest.java","133565","411564","545129","","1090258"
"2017-05-16 00:31","LedgerCacheTest.java","112757","67407","180164","","360328"
"2014-07-24 01:41","LedgerCacheTest.java","2720","10877","13597","","27194"
"2014-12-10 19:43","LedgerCacheTest.java","3979","21764","25743","","51486"
"2016-03-08 06:49","LedgerCacheTest.java","5185","29209","34394","","68788"
"2014-03-12 21:26","LedgerCacheTest.java","1999","7401","9400","7","18800"
"2013-01-09 18:48","IndexCorruptionTest.java","17734","85239","102973","2","205946"
"2013-01-09 17:18","IndexCorruptionTest.java","17702","85010","102712","2","205424"
"2013-05-09 11:41","IndexCorruptionTest.java","18984","119742","138726","5","277452"
"2012-03-15 10:37","IndexCorruptionTest.java","7409","12126","19535","1","39070"
"2012-05-10 14:47","BookieException.java","10538","30430","40968","1","81936"
"2012-09-07 07:04","BookieException.java","13332","65298","78630","2","157260"
"2013-02-08 19:08","BookieException.java","16880","127042","143922","4","287844"
"2012-03-13 07:31","BookieException.java","2832","17291","20123","1","40246"
"2017-07-07 08:19","BookieException.java","40432","128840","169272","","338544"
"2017-08-02 00:49","BookieNettyServer.java","9032","51481","60513","","121026"
"2017-06-01 09:47","BookieNettyServer.java","2400","19180","21580","","43160"
"2017-05-15 19:52","BookieNettyServer.java","2090","15905","17995","","35990"
"2017-03-23 00:48","BookieNettyServer.java","250","6059","6309","","12618"
"2017-06-05 20:30","LedgerDirsManager.java","113744","69638","183382","","366764"
"2017-01-30 23:25","LedgerDirsManager.java","111645","49503","161148","","322296"
"2017-03-28 22:35","LedgerDirsManager.java","111755","60344","172099","","344198"
"2017-06-28 23:24","LedgerDirsManager.java","113937","72875","186812","","373624"
"2017-07-07 08:19","LedgerDirsManager.java","114242","78976","193218","","386436"
"2014-08-02 20:02","LedgerDirsManager.java","2814","15534","18348","","36696"
"2017-03-23 00:54","TestDiskChecker.java","111671","57566","169237","","338474"
"2014-12-10 19:43","TestDiskChecker.java","3896","21337","25233","","50466"
"2017-08-02 00:49","AuthHandler.java","6431","31872","38303","","76606"
"2017-07-04 06:27","ServerConfiguration.java","114212","54848","169060","","338120"
"2016-04-14 00:51","ServerConfiguration.java","104791","4165","108956","","217912"
"2016-04-05 18:47","ServerConfiguration.java","104764","4088","108852","","217704"
"2016-04-27 09:55","ServerConfiguration.java","104977","4863","109840","","219680"
"2017-05-15 19:52","ServerConfiguration.java","112113","42321","154434","","308868"
"2017-03-22 22:54","ServerConfiguration.java","110842","32992","143834","","287668"
"2017-03-23 00:48","ServerConfiguration.java","110847","33049","143896","","287792"
"2017-01-31 02:11","ServerConfiguration.java","110683","26464","137147","","274294"
"2016-04-05 08:45","ServerConfiguration.java","104753","3835","108588","","217176"
"2016-11-09 03:02","ServerConfiguration.java","110567","19176","129743","","259486"
"2016-11-30 00:02","ServerConfiguration.java","110632","19923","130555","","261110"
"2017-06-05 20:30","ServerConfiguration.java","113351","47110","160461","","320922"
"2016-09-10 20:27","ServerConfiguration.java","108881","13701","122582","","245164"
"2017-08-02 00:49","ServerConfiguration.java","118405","77247","195652","","391304"
"2017-10-03 12:31","ServerConfiguration.java","129965","78964","208929","","417858"
"2017-08-16 03:37","ServerConfiguration.java","120802","86277","207079","","414158"
"2017-05-26 12:38","ServerConfiguration.java","112364","44888","157252","","314504"
"2017-07-07 08:19","ServerConfiguration.java","114263","56862","171125","","342250"
"2017-06-28 23:24","ServerConfiguration.java","113722","50525","164247","","328494"
"2017-11-08 12:27","ServerConfiguration.java","132573","99446","232019","","464038"
"2016-04-05 08:45","BookieClient.java","40664","83624","124288","","248576"
"2017-03-28 22:35","BookieClient.java","40847","111179","152026","","304052"
"2013-10-29 05:14","BookieClient.java","18349","136236","154585","6","309170"
"2014-02-05 22:43","BookieClient.java","18694","140947","159641","7","319282"
"2017-01-31 04:01","BookieClient.java","40857","106597","147454","","294908"
"2017-05-15 19:52","LedgerHandle.java","111919","62589","174508","","349016"
"2017-05-02 22:07","LedgerHandle.java","111127","59443","170570","","341140"
"2017-03-23 15:55","LedgerHandle.java","110928","53618","164546","","329092"
"2016-09-10 21:01","LedgerHandle.java","109160","34563","143723","","287446"
"2016-07-11 23:01","LedgerHandle.java","107855","29154","137009","","274018"
"2017-05-17 08:57","LedgerHandle.java","112065","63212","175277","","350554"
"2017-05-25 14:23","LedgerHandle.java","112098","65050","177148","","354296"
"2017-06-21 19:50","LedgerHandle.java","113159","69042","182201","","364402"
"2017-06-21 21:00","LedgerHandle.java","113169","69835","183004","","366008"
"2017-06-01 23:58","LedgerHandle.java","112883","66746","179629","","359258"
"2014-09-18 06:47","LedgerHandle.java","2190","15246","17436","","34872"
"2014-12-09 19:57","LedgerHandle.java","2474","16623","19097","","38194"
"2017-07-04 06:27","LedgerHandle.java","113576","74674","188250","","376500"
"2017-06-30 00:12","LedgerHandle.java","113438","72575","186013","","372026"
"2014-05-30 14:01","LedgerHandle.java","521","4455","4976","7","9952"
"2014-05-30 15:07","LedgerHandle.java","544","4517","5061","7","10122"
"2016-02-09 08:32","LedgerHandle.java","3903","23483","27386","","54772"
"2016-03-16 05:03","LedgerHandle.java","107506","24347","131853","","263706"
"2015-10-22 09:22","LedgerHandle.java","3755","22300","26055","","52110"
"2015-10-06 10:05","LedgerHandle.java","3721","21210","24931","","49862"
"2017-01-31 04:01","LedgerHandle.java","110821","53145","163966","","327932"
"2015-04-21 09:39","LedgerHandle.java","2914","19232","22146","","44292"
"2015-10-06 11:12","LedgerHandle.java","3727","21456","25183","","50366"
"2014-12-05 14:10","LedgerHandle.java","2420","16120","18540","","37080"
"2016-08-01 08:04","LedgerOpenOp.java","48076","71879","119955","","239910"
"2015-10-06 10:05","LedgerOpenOp.java","15236","134530","149766","","299532"
"2015-04-21 09:17","LedgerOpenOp.java","14909","133012","147921","","295842"
"2014-01-21 05:19","LedgerOpenOp.java","13620","113459","127079","6","254158"
"2014-02-21 19:01","LedgerOpenOp.java","14125","115930","130055","7","260110"
"2012-07-18 17:00","LedgerOpenOp.java","3288","12203","15491","2","30982"
"2013-05-31 12:02","BookieJournalRollingTest.java","14063","110379","124442","5","248884"
"2013-10-12 05:42","BookieJournalRollingTest.java","14365","117486","131851","6","263702"
"2014-07-24 01:41","BookieJournalRollingTest.java","15357","129505","144862","","289724"
"2012-04-17 13:16","BookieJournalRollingTest.java","1777","4648","6425","1","12850"
"2017-07-04 06:27","ServerConfiguration.java","114490","56140","170630","","341260"
"2016-04-14 00:51","ServerConfiguration.java","105185","5573","110758","","221516"
"2016-03-08 06:49","ServerConfiguration.java","397","1411","1808","","3616"
"2016-04-05 18:47","ServerConfiguration.java","105158","5496","110654","","221308"
"2016-04-27 09:55","ServerConfiguration.java","105261","6161","111422","","222844"
"2017-05-15 19:52","ServerConfiguration.java","112436","43658","156094","","312188"
"2017-03-22 22:54","ServerConfiguration.java","111076","34240","145316","","290632"
"2017-03-23 00:48","ServerConfiguration.java","111081","34297","145378","","290756"
"2017-01-31 02:11","ServerConfiguration.java","110918","27713","138631","","277262"
"2016-04-05 08:45","ServerConfiguration.java","105147","5243","110390","","220780"
"2016-11-09 03:02","ServerConfiguration.java","110804","20427","131231","","262462"
"2016-11-30 00:02","ServerConfiguration.java","110868","21173","132041","","264082"
"2017-06-05 20:30","ServerConfiguration.java","113640","48413","162053","","324106"
"2016-09-10 20:27","ServerConfiguration.java","109130","14964","124094","","248188"
"2017-08-02 00:49","ServerConfiguration.java","118625","78481","197106","","394212"
"2017-10-03 12:31","ServerConfiguration.java","130131","80144","210275","","420550"
"2017-08-16 03:37","ServerConfiguration.java","121020","87509","208529","","417058"
"2017-05-26 12:38","ServerConfiguration.java","112672","46210","158882","","317764"
"2017-07-07 08:19","ServerConfiguration.java","114539","58152","172691","","345382"
"2017-06-28 23:24","ServerConfiguration.java","114007","51824","165831","","331662"
"2017-11-08 12:27","ServerConfiguration.java","132729","100616","233345","","466690"
"2014-01-21 16:41","CodahaleMetricsProvider.java","500","2267","2767","6","5534"
"2014-09-22 12:11","CodahaleMetricsProvider.java","3569","20381","23950","","47900"
"2014-09-06 07:27","CodahaleMetricsProvider.java","3453","20086","23539","","47078"
"2016-12-17 02:43","CodahaleMetricsProvider.java","111603","50818","162421","","324842"
"2017-05-26 16:52","CodahaleMetricsProvider.java","112808","69541","182349","","364698"
"2014-07-24 01:41","TestEntryLog.java","9018","78226","87244","","174488"
"2014-12-10 19:43","TestEntryLog.java","9619","88455","98074","","196148"
"2016-02-24 00:44","TestEntryLog.java","10308","95031","105339","","210678"
"2014-03-12 21:26","TestEntryLog.java","8575","75028","83603","7","167206"
"2013-10-12 05:42","TestEntryLog.java","7324","65505","72829","6","145658"
"2017-05-16 00:31","TestEntryLog.java","73492","89193","162685","","325370"
"2017-07-07 08:19","TestEntryLog.java","74455","102129","176584","","353168"
"2017-05-25 14:23","LedgerHandle.java","70","1875","1945","","3890"
"2017-06-21 19:50","LedgerHandle.java","1652","6388","8040","","16080"
"2017-06-21 21:00","LedgerHandle.java","1672","7191","8863","","17726"
"2017-06-01 23:58","LedgerHandle.java","1131","3847","4978","","9956"
"2017-07-04 06:27","LedgerHandle.java","2390","12341","14731","","29462"
"2017-06-30 00:12","LedgerHandle.java","2066","10056","12122","","24244"
"2014-02-21 19:01","LedgerChecker.java","11104","95489","106593","7","213186"
"2014-02-05 22:43","LedgerChecker.java","11012","94234","105246","7","210492"
"2017-07-28 20:12","LedgerChecker.java","62194","112271","174465","","348930"
"2017-05-15 19:52","LedgerChecker.java","60748","95803","156551","","313102"
"2017-03-23 00:48","ClientConfiguration.java","47515","96575","144090","","288180"
"2016-04-05 08:45","ClientConfiguration.java","47268","73208","120476","","240952"
"2017-03-28 22:35","ClientConfiguration.java","47509","100821","148330","","296660"
"2017-01-31 02:14","ClientConfiguration.java","47466","90717","138183","","276366"
"2017-04-15 13:58","ClientConfiguration.java","47574","101986","149560","","299120"
"2017-03-23 00:59","ClientConfiguration.java","47515","96587","144102","","288204"
"2017-05-15 19:52","ClientConfiguration.java","47968","105034","153002","","306004"
"2016-10-13 07:50","ClientConfiguration.java","47365","82529","129894","","259788"
"2017-06-21 19:58","ClientConfiguration.java","48706","111095","159801","","319602"
"2013-10-29 05:14","ClientConfiguration.java","14532","115399","129931","6","259862"
"2017-06-05 21:48","ClientConfiguration.java","48660","109661","158321","","316642"
"2017-06-21 19:50","ClientConfiguration.java","48706","110985","159691","","319382"
"2017-08-02 00:49","ClientConfiguration.java","49668","135368","185036","","370072"
"2017-08-01 08:34","ClientConfiguration.java","49565","132680","182245","","364490"
"2013-06-12 18:41","ClientConfiguration.java","13492","110324","123816","5","247632"
"2014-05-27 13:56","ClientConfiguration.java","15176","125124","140300","7","280600"
"2017-06-30 00:12","ClientConfiguration.java","48719","114252","162971","","325942"
"2014-09-18 06:47","ClientConfiguration.java","15599","135051","150650","","301300"
"2017-07-04 06:27","ClientConfiguration.java","48790","116284","165074","","330148"
"2012-09-12 11:59","ClientConfiguration.java","6655","40195","46850","2","93700"
"2017-01-31 04:01","ClientConfiguration.java","47480","96200","143680","","287360"
"2015-10-06 10:05","ClientConfiguration.java","16092","139977","156069","","312138"
"2015-10-06 10:48","ClientConfiguration.java","16093","140204","156297","","312594"
"2013-02-08 19:08","ClientConfiguration.java","12087","103298","115385","4","230770"
"2012-12-03 10:46","ClientConfiguration.java","10105","63184","73289","2","146578"
"2016-02-09 08:32","ClientConfiguration.java","16182","142158","158340","","316680"
"2014-12-06 07:54","ClientConfiguration.java","15664","136034","151698","","303396"
"2016-08-01 08:04","ClientConfiguration.java","47367","75761","123128","","246256"
"2012-12-13 13:07","ClientConfiguration.java","10510","65411","75921","2","151842"
"2014-08-02 20:02","ServerConfiguration.java","2950","16309","19259","","38518"
"2014-05-06 12:30","ServerConfiguration.java","1744","6453","8197","7","16394"
"2014-05-15 00:41","ServerConfiguration.java","1772","7395","9167","7","18334"
"2014-09-18 06:47","ServerConfiguration.java","3515","18883","22398","","44796"
"2017-07-04 06:27","ServerConfiguration.java","114239","77649","191888","","383776"
"2014-03-07 13:14","ServerConfiguration.java","1493","3843","5336","7","10672"
"2014-04-29 22:07","ServerConfiguration.java","1741","6403","8144","7","16288"
"2016-04-14 00:51","ServerConfiguration.java","108541","30689","139230","","278460"
"2015-01-16 15:57","ServerConfiguration.java","3993","22333","26326","","52652"
"2016-03-08 06:49","ServerConfiguration.java","5199","27973","33172","","66344"
"2016-01-26 22:11","ServerConfiguration.java","4883","26643","31526","","63052"
"2014-03-12 21:26","ServerConfiguration.java","1626","5778","7404","7","14808"
"2016-04-05 18:47","ServerConfiguration.java","108515","30613","139128","","278256"
"2016-04-27 09:55","ServerConfiguration.java","108592","31252","139844","","279688"
"2015-04-21 09:55","ServerConfiguration.java","4097","22878","26975","","53950"
"2015-01-12 15:18","ServerConfiguration.java","3985","21387","25372","","50744"
"2015-04-21 10:02","ServerConfiguration.java","4107","22921","27028","","54056"
"2017-05-15 19:52","ServerConfiguration.java","112690","65672","178362","","356724"
"2017-03-22 22:54","ServerConfiguration.java","111764","56688","168452","","336904"
"2017-03-23 00:48","ServerConfiguration.java","111769","56745","168514","","337028"
"2017-01-31 02:11","ServerConfiguration.java","111659","50214","161873","","323746"
"2016-04-05 08:45","ServerConfiguration.java","108507","30363","138870","","277740"
"2016-11-09 03:02","ServerConfiguration.java","111581","42964","154545","","309090"
"2016-11-30 00:02","ServerConfiguration.java","111621","43686","155307","","310614"
"2017-06-05 20:30","ServerConfiguration.java","113739","70272","184011","","368022"
"2016-09-10 20:27","ServerConfiguration.java","110111","37705","147816","","295632"
"2017-08-02 00:49","ServerConfiguration.java","117723","99339","217062","","434124"
"2017-10-03 12:31","ServerConfiguration.java","125183","96956","222139","","444278"
"2017-08-16 03:37","ServerConfiguration.java","119279","107528","226807","","453614"
"2014-05-09 14:04","ServerConfiguration.java","1759","7062","8821","7","17642"
"2017-05-26 12:38","ServerConfiguration.java","112868","68166","181034","","362068"
"2017-07-07 08:19","ServerConfiguration.java","114238","79611","193849","","387698"
"2017-06-28 23:24","ServerConfiguration.java","113933","73510","187443","","374886"
"2017-11-08 12:27","ServerConfiguration.java","126821","116468","243289","","486578"
"2014-01-22 14:35","ServerConfiguration.java","341","1356","1697","6","3394"
"2014-01-21 05:19","LedgerDeleteOp.java","19001","144080","163081","6","326162"
"2012-06-19 12:39","LedgerDeleteOp.java","12679","37919","50598","2","101196"
"2015-04-21 09:17","LedgerDeleteOp.java","19430","162773","182203","","364406"
"2015-10-06 10:05","LedgerDeleteOp.java","19469","164003","183472","","366944"
"2011-11-17 11:16","LedgerDeleteOp.java","2969","5310","8279","","16558"
"2012-12-24 05:50","LedgerDeleteOp.java","17351","95437","112788","2","225576"
"2017-05-15 19:52","BookKeeperClusterTestCase.java","113469","73276","186745","","373490"
"2016-04-05 08:45","BookKeeperClusterTestCase.java","109534","38215","147749","","295498"
"2017-08-01 08:34","BookKeeperClusterTestCase.java","117427","103283","220710","","441420"
"2013-10-12 05:42","BookKeeperClusterTestCase.java","1526","4231","5757","6","11514"
"2014-02-05 22:43","BookKeeperClusterTestCase.java","3442","11416","14858","7","29716"
"2017-11-08 12:27","BookKeeperClusterTestCase.java","126535","123007","249542","","499084"
"2014-05-09 14:04","BookKeeperClusterTestCase.java","3837","15965","19802","7","39604"
"2017-07-04 06:27","BookKeeperClusterTestCase.java","114840","85075","199915","","399830"
"2014-07-24 01:41","BookKeeperClusterTestCase.java","4324","18056","22380","","44760"
"2014-05-23 18:46","BookKeeperClusterTestCase.java","3843","16301","20144","7","40288"
"2017-06-30 00:12","BookKeeperClusterTestCase.java","114731","83005","197736","","395472"
"2014-04-24 10:43","BookKeeperClusterTestCase.java","3767","14876","18643","7","37286"
"2016-04-27 09:55","BookKeeperClusterTestCase.java","109609","39094","148703","","297406"
"2015-10-06 10:48","BookKeeperClusterTestCase.java","6193","33045","39238","","78476"
"2014-12-10 19:43","BookKeeperClusterTestCase.java","5462","28822","34284","","68568"
"2017-05-15 19:52","DigestManager.java","45709","111418","157127","","314254"
"2012-07-18 17:00","DigestManager.java","12140","34289","46429","2","92858"
"2017-05-25 14:23","DigestManager.java","45789","113780","159569","","319138"
"2012-05-10 14:47","DigestManager.java","9250","18834","28084","1","56168"
"2012-05-25 17:13","DigestManager.java","9682","20520","30202","1","60404"
"2017-01-31 04:01","DigestManager.java","45315","102678","147993","","295986"
"2014-08-02 20:02","Journal.java","9919","88150","98069","","196138"
"2014-03-07 13:14","Journal.java","9274","76496","85770","7","171540"
"2014-04-29 22:07","Journal.java","9334","78868","88202","7","176404"
"2013-12-06 07:39","Journal.java","8395","72169","80564","6","161128"
"2012-10-18 16:40","Journal.java","956","3527","4483","2","8966"
"2015-04-21 09:23","Journal.java","10345","93831","104176","","208352"
"2016-02-09 08:30","Journal.java","10891","97644","108535","","217070"
"2015-02-23 08:11","Journal.java","10340","93590","103930","","207860"
"2017-05-26 16:52","Journal.java","71826","92016","163842","","327684"
"2017-03-22 22:54","Journal.java","71114","80910","152024","","304048"
"2016-11-12 03:37","Journal.java","70997","67300","138297","","276594"
"2016-07-14 23:02","Journal.java","69837","58354","128191","","256382"
"2013-05-04 14:22","Journal.java","6902","60420","67322","5","134644"
"2013-07-20 19:59","Journal.java","7183","65799","72982","5","145964"
"2013-07-04 14:01","Journal.java","7156","65535","72691","5","145382"
"2017-06-01 23:58","Journal.java","72461","93508","165969","","331938"
"2017-05-09 22:24","Journal.java","71496","87888","159384","","318768"
"2013-10-12 05:42","Journal.java","8135","68887","77022","6","154044"
"2013-10-02 06:23","Journal.java","7337","67166","74503","5","149006"
"2017-05-16 00:31","Journal.java","71781","90053","161834","","323668"
"2017-07-28 20:12","ITopologyAwareEnsemblePlacementPolicy.java","6467","43391","49858","","99716"
"2017-07-04 06:27","FileInfo.java","40913","126715","167628","","335256"
"2012-10-26 12:51","FileInfo.java","16027","77644","93671","2","187342"
"2014-12-04 12:28","FileInfo.java","19183","157578","176761","","353522"
"2017-01-31 04:01","FileInfo.java","40577","107605","148182","","296364"
"2017-03-23 15:55","FileInfo.java","40568","107962","148530","","297060"
"2016-11-18 00:18","FileInfo.java","40550","94477","135027","","270054"
"2012-12-18 13:04","FileInfo.java","16490","92127","108617","2","217234"
"2013-05-04 14:22","FileInfo.java","18037","129075","147112","5","294224"
"2012-02-09 18:14","FileInfo.java","2102","11520","13622","1","27244"
"2012-02-17 11:18","FileInfo.java","2235","12108","14343","1","28686"
"2012-02-24 19:20","FileInfo.java","2337","12775","15112","1","30224"
"2012-06-13 16:57","FileInfo.java","11016","33149","44165","","88330"
"2012-03-29 15:18","FileInfo.java","9975","26435","36410","1","72820"
"2017-06-01 23:58","FileInfo.java","40847","119414","160261","","320522"
"2017-07-17 23:27","FileInfo.java","40943","129852","170795","","341590"
"2017-05-16 00:31","FileInfo.java","40748","116540","157288","","314576"
"2013-10-22 16:21","FileInfo.java","18424","137463","155887","6","311774"
"2013-10-11 08:36","FileInfo.java","18300","136031","154331","6","308662"
"2017-06-21 19:50","LedgerHandle.java","1606","4537","6143","","12286"
"2017-06-21 21:00","LedgerHandle.java","1626","5340","6966","","13932"
"2017-06-01 23:58","LedgerHandle.java","1085","1996","3081","","6162"
"2017-07-04 06:27","LedgerHandle.java","2346","10492","12838","","25676"
"2017-06-30 00:12","LedgerHandle.java","2020","8205","10225","","20450"
"2017-07-04 06:27","LedgerStorage.java","4475","18442","22917","","45834"
"2017-05-16 00:31","LedgerStorage.java","2203","6160","8363","","16726"
"2017-07-04 06:27","LedgerStorage.java","114212","54848","169060","","338120"
"2017-03-28 22:37","LedgerStorage.java","110849","37518","148367","","296734"
"2017-01-31 04:01","LedgerStorage.java","110707","32569","143276","","286552"
"2016-11-18 00:18","LedgerStorage.java","110603","19364","129967","","259934"
"2017-05-16 00:31","LedgerStorage.java","112289","42915","155204","","310408"
"2015-09-15 10:38","AbstractConfiguration.java","15234","134204","149438","","298876"
"2017-03-28 22:40","AbstractConfiguration.java","48290","97454","145744","","291488"
"2012-10-05 16:24","AbstractConfiguration.java","7341","41368","48709","2","97418"
"2012-12-12 11:20","AbstractConfiguration.java","8861","58400","67261","2","134522"
"2017-08-02 00:49","AbstractConfiguration.java","50686","131795","182481","","364962"
"2013-06-12 18:41","AbstractConfiguration.java","12389","104630","117019","5","234038"
"2016-07-31 07:53","AbstractConfiguration.java","48073","71311","119384","","238768"
"2017-01-31 02:14","AbstractConfiguration.java","48180","86840","135020","","270040"
"2016-07-31 07:56","AbstractConfiguration.java","48073","71645","119718","","239436"
"2017-05-02 23:04","AbstractConfiguration.java","48536","99521","148057","","296114"
"2017-03-23 00:48","AbstractConfiguration.java","48235","92704","140939","","281878"
"2012-11-30 04:54","AbstractConfiguration.java","8604","56408","65012","2","130024"
"2017-05-15 19:52","TestBackwardCompatCMS42.java","8150","39276","47426","","94852"
"2017-01-31 02:14","TestBackwardCompatCMS42.java","6577","23888","30465","","60930"
"2017-06-30 00:12","ReadLastConfirmedOp.java","68520","100377","168897","","337794"
"2017-05-15 19:52","ReadLastConfirmedOp.java","67621","91011","158632","","317264"
"2017-06-01 23:58","ReadLastConfirmedOp.java","68362","94945","163307","","326614"
"2014-02-21 19:01","ReadLastConfirmedOp.java","10898","83618","94516","7","189032"
"2017-07-04 06:27","FileInfo.java","115620","63027","178647","","357294"
"2017-01-31 04:01","FileInfo.java","112283","40916","153199","","306398"
"2017-03-23 15:55","FileInfo.java","112426","41425","153851","","307702"
"2016-11-18 00:18","FileInfo.java","112207","27739","139946","","279892"
"2017-06-01 23:58","FileInfo.java","114705","54877","169582","","339164"
"2017-07-17 23:27","FileInfo.java","115875","66389","182264","","364528"
"2017-05-16 00:31","FileInfo.java","113829","51226","165055","","330110"
"2015-09-15 10:38","AbstractConfiguration.java","9012","78443","87455","","174910"
"2017-03-28 22:40","AbstractConfiguration.java","79621","79246","158867","","317734"
"2017-08-02 00:49","AbstractConfiguration.java","84247","115817","200064","","400128"
"2013-06-12 18:41","AbstractConfiguration.java","4756","47458","52214","5","104428"
"2016-07-31 07:53","AbstractConfiguration.java","78265","51964","130229","","260458"
"2017-01-31 02:14","AbstractConfiguration.java","79457","68578","148035","","296070"
"2016-07-31 07:56","AbstractConfiguration.java","78265","52298","130563","","261126"
"2017-05-02 23:04","AbstractConfiguration.java","79923","81369","161292","","322584"
"2017-03-23 00:48","AbstractConfiguration.java","79547","74477","154024","","308048"
"2014-01-21 05:19","PerChannelBookieClient.java","18492","141230","159722","6","319444"
"2013-10-22 07:35","PerChannelBookieClient.java","18368","136752","155120","6","310240"
"2012-05-17 16:05","PerChannelBookieClient.java","10849","30806","41655","1","83310"
"2012-05-26 19:16","PerChannelBookieClient.java","10983","31541","42524","1","85048"
"2014-01-09 07:30","PerChannelBookieClient.java","18441","139747","158188","6","316376"
"2017-06-30 00:12","PerChannelBookieClient.java","40883","124724","165607","","331214"
"2014-05-27 13:56","PerChannelBookieClient.java","18844","147100","165944","7","331888"
"2017-07-04 06:27","PerChannelBookieClient.java","40913","126715","167628","","335256"
"2012-07-23 23:39","PerChannelBookieClient.java","12759","44641","57400","2","114800"
"2012-08-13 11:38","PerChannelBookieClient.java","13148","50925","64073","2","128146"
"2017-01-31 04:01","PerChannelBookieClient.java","40577","107605","148182","","296364"
"2015-10-06 10:05","PerChannelBookieClient.java","19285","161478","180763","","361526"
"2016-04-05 18:47","PerChannelBookieClient.java","40426","84916","125342","","250684"
"2012-02-01 12:06","PerChannelBookieClient.java","1878","7557","9435","1","18870"
"2017-04-15 13:58","PerChannelBookieClient.java","40567","113287","153854","","307708"
"2017-05-15 19:52","PerChannelBookieClient.java","40724","116098","156822","","313644"
"2012-12-01 15:04","PerChannelBookieClient.java","16168","87037","103205","2","206410"
"2016-04-05 08:45","PerChannelBookieClient.java","40424","84672","125096","","250192"
"2017-07-28 20:12","PerChannelBookieClient.java","41165","131561","172726","","345452"
"2017-01-31 02:14","PerChannelBookieClient.java","40563","102122","142685","","285370"
"2017-03-28 22:35","PerChannelBookieClient.java","40560","112180","152740","","305480"
"2017-03-23 00:48","PerChannelBookieClient.java","40567","107935","148502","","297004"
"2013-01-10 19:13","PerChannelBookieClient.java","16940","95120","112060","2","224120"
"2014-07-25 00:34","PerChannelBookieClient.java","19169","154290","173459","","346918"
"2012-02-24 20:07","PerChannelBookieClient.java","2381","12825","15206","1","30412"
"2011-11-18 11:18","PerChannelBookieClient.java","717","2005","2722","","5444"
"2017-08-02 00:49","PerChannelBookieClient.java","41569","145577","187146","","374292"
"2012-04-02 12:38","PerChannelBookieClient.java","10040","27476","37516","1","75032"
"2017-06-21 19:58","PerChannelBookieClient.java","40876","121573","162449","","324898"
"2017-06-01 23:58","PerChannelBookieClient.java","40847","119414","160261","","320522"
"2013-10-29 05:14","PerChannelBookieClient.java","18433","137608","156041","6","312082"
"2013-06-28 17:27","PerChannelBookieClient.java","18229","134105","152334","5","304668"
"2014-02-21 19:01","PerChannelBookieClient.java","18808","143512","162320","7","324640"
"2014-02-05 22:43","PerChannelBookieClient.java","18772","142313","161085","7","322170"
"2017-04-20 19:55","PerChannelBookieClient.java","40568","113309","153877","","307754"
"2013-09-11 00:34","PerChannelBookieClient.java","18282","135620","153902","5","307804"
"2013-08-20 12:51","PerChannelBookieClient.java","18262","135313","153575","5","307150"
"2014-08-02 20:02","ServerConfiguration.java","1466","10673","12139","","24278"
"2014-05-06 12:30","ServerConfiguration.java","120","677","797","7","1594"
"2014-05-15 00:41","ServerConfiguration.java","149","1620","1769","7","3538"
"2014-09-18 06:47","ServerConfiguration.java","2047","13263","15310","","30620"
"2017-07-04 06:27","ServerConfiguration.java","114173","73431","187604","","375208"
"2014-04-29 22:07","ServerConfiguration.java","117","627","744","7","1488"
"2016-04-14 00:51","ServerConfiguration.java","108142","26138","134280","","268560"
"2015-01-16 15:57","ServerConfiguration.java","2666","16854","19520","","39040"
"2016-03-08 06:49","ServerConfiguration.java","3999","22621","26620","","53240"
"2016-01-26 22:11","ServerConfiguration.java","3657","21265","24922","","49844"
"2016-04-05 18:47","ServerConfiguration.java","108116","26062","134178","","268356"
"2016-04-27 09:55","ServerConfiguration.java","108195","26703","134898","","269796"
"2015-04-21 09:55","ServerConfiguration.java","2801","17430","20231","","40462"
"2015-01-12 15:18","ServerConfiguration.java","2658","15908","18566","","37132"
"2015-04-21 10:02","ServerConfiguration.java","2814","17476","20290","","40580"
"2017-05-15 19:52","ServerConfiguration.java","112505","61335","173840","","347680"
"2017-03-22 22:54","ServerConfiguration.java","111498","52270","163768","","327536"
"2017-03-23 00:48","ServerConfiguration.java","111503","52327","163830","","327660"
"2017-01-31 02:11","ServerConfiguration.java","111404","45807","157211","","314422"
"2016-04-05 08:45","ServerConfiguration.java","108106","25810","133916","","267832"
"2016-11-09 03:02","ServerConfiguration.java","111310","38541","149851","","299702"
"2016-11-30 00:02","ServerConfiguration.java","111358","39271","150629","","301258"
"2017-06-05 20:30","ServerConfiguration.java","113592","65973","179565","","359130"
"2016-09-10 20:27","ServerConfiguration.java","109725","33167","142892","","285784"
"2017-08-02 00:49","ServerConfiguration.java","117819","95283","213102","","426204"
"2017-10-03 12:31","ServerConfiguration.java","125398","93019","218417","","436834"
"2017-08-16 03:37","ServerConfiguration.java","119413","103510","222923","","445846"
"2014-05-09 14:04","ServerConfiguration.java","136","1287","1423","7","2846"
"2017-05-26 12:38","ServerConfiguration.java","112699","63845","176544","","353088"
"2017-07-07 08:19","ServerConfiguration.java","114205","75426","189631","","379262"
"2017-06-28 23:24","ServerConfiguration.java","113787","69212","182999","","365998"
"2017-11-08 12:27","ServerConfiguration.java","127302","112797","240099","","480198"
"2013-10-02 06:40","MSLedgerManagerFactory.java","4037","45725","49762","5","99524"
"2017-06-01 23:58","MSLedgerManagerFactory.java","81562","84384","165946","","331892"
"2013-04-04 11:21","MSLedgerManagerFactory.java","3159","37896","41055","5","82110"
"2015-09-15 10:38","MSLedgerManagerFactory.java","8247","74371","82618","","165236"
"2017-03-28 22:40","MSLedgerManagerFactory.java","80137","76455","156592","","313184"
"2014-01-17 18:13","MSLedgerManagerFactory.java","5306","51403","56709","6","113418"
"2014-05-12 08:10","MSLedgerManagerFactory.java","6474","58742","65216","7","130432"
"2017-07-04 06:27","LedgerCacheImpl.java","1257","8492","9749","","19498"
"2017-01-31 04:01","BookkeeperInternalCallbacks.java","51562","90102","141664","","283328"
"2017-06-05 22:25","BookkeeperInternalCallbacks.java","52818","104346","157164","","314328"
"2014-01-17 18:13","BookkeeperInternalCallbacks.java","12175","105529","117704","6","235408"
"2017-08-02 00:49","BookkeeperInternalCallbacks.java","54261","129781","184042","","368084"
"2017-06-21 21:00","BookkeeperInternalCallbacks.java","52852","105734","158586","","317172"
"2017-06-05 22:13","BookkeeperInternalCallbacks.java","52800","104034","156834","","313668"
"2014-02-05 22:43","BookkeeperInternalCallbacks.java","12664","107717","120381","7","240762"
"2017-05-15 19:52","BookkeeperInternalCallbacks.java","52118","99004","151122","","302244"
"2017-03-28 22:35","BookkeeperInternalCallbacks.java","51603","94735","146338","","292676"
"2017-08-02 00:49","BookieNettyServer.java","14572","74332","88904","","177808"
"2017-06-01 09:47","BookieNettyServer.java","8436","42527","50963","","101926"
"2017-05-15 19:52","BookieNettyServer.java","8150","39276","47426","","94852"
"2016-09-10 20:27","BookieNettyServer.java","4345","10083","14428","","28856"
"2017-01-31 02:14","BookieNettyServer.java","6577","23888","30465","","60930"
"2017-03-23 00:48","BookieNettyServer.java","6772","29892","36664","","73328"
"2015-07-10 22:48","ZooKeeperClient.java","1878","6218","8096","","16192"
"2017-03-23 15:59","ZooKeeperClient.java","113156","43648","156804","","313608"
"2012-05-25 17:13","ReadLastConfirmedOp.java","12570","35414","47984","1","95968"
"2017-06-30 00:12","ReadLastConfirmedOp.java","40530","126712","167242","","334484"
"2012-08-27 14:43","ReadLastConfirmedOp.java","14313","61660","75973","2","151946"
"2012-09-14 15:42","ReadLastConfirmedOp.java","14716","69041","83757","2","167514"
"2011-11-16 17:05","ReadLastConfirmedOp.java","2735","4433","7168","","14336"
"2011-11-17 11:16","ReadLastConfirmedOp.java","2969","5310","8279","","16558"
"2011-10-26 16:06","ReadLastConfirmedOp.java","76","326","402","","804"
"2017-05-15 19:52","ReadLastConfirmedOp.java","40437","118152","158589","","317178"
"2012-02-13 15:46","ReadLastConfirmedOp.java","4625","16631","21256","1","42512"
"2012-04-02 12:38","ReadLastConfirmedOp.java","11814","31591","43405","1","86810"
"2017-06-01 23:58","ReadLastConfirmedOp.java","40516","121424","161940","","323880"
"2014-02-21 19:01","ReadLastConfirmedOp.java","19192","146237","165429","7","330858"
"2014-12-10 19:43","UpgradeTest.java","12298","99867","112165","","224330"
"2017-05-15 19:52","UpgradeTest.java","67868","91884","159752","","319504"
"2012-11-23 11:49","UpgradeTest.java","4733","21950","26683","2","53366"
"2013-10-11 08:36","UpgradeTest.java","10092","76465","86557","6","173114"
"2013-10-12 05:42","UpgradeTest.java","10215","77129","87344","6","174688"
"2017-06-01 23:58","ReplicationWorker.java","82008","85228","167236","","334472"
"2017-04-11 20:14","ReplicationWorker.java","80691","77423","158114","","316228"
"2014-02-05 22:43","ReplicationWorker.java","6786","54980","61766","7","123532"
"2013-10-02 06:23","ReplicationWorker.java","4644","46646","51290","5","102580"
"2016-03-16 04:51","ReplicationWorker.java","78897","44892","123789","","247578"
"2016-09-10 21:01","ReplicationWorker.java","80343","55103","135446","","270892"
"2017-05-26 16:52","ReplicationWorker.java","81321","83684","165005","","330010"
"2015-04-21 09:17","ReplicationWorker.java","8205","73860","82065","","164130"
"2013-01-03 11:06","ReplicationWorker.java","1615","2811","4426","2","8852"
"2013-12-06 07:39","ReplicationWorker.java","5817","51764","57581","6","115162"
"2014-04-24 10:43","ReplicationWorker.java","7017","58346","65363","7","130726"
"2014-09-06 07:58","ReplicationWorker.java","7782","70192","77974","","155948"
"2017-05-16 00:31","BookieProtocol.java","263","681","944","","1888"
"2017-06-01 21:20","BookieProtocol.java","1150","3895","5045","","10090"
"2017-06-05 22:25","BookieProtocol.java","1852","6494","8346","","16692"
"2017-08-16 03:41","StaticDNSResolver.java","12047","69440","81487","","162974"
"2017-07-04 06:27","LedgerHandle.java","765","5980","6745","","13490"
"2017-06-30 00:12","LedgerHandle.java","428","3682","4110","","8220"
"2017-10-17 09:32","AuditorElector.java","92072","118744","210816","","421632"
"2013-08-21 13:19","AuditorElector.java","4546","46442","50988","5","101976"
"2016-07-14 23:02","AuditorElector.java","79153","49843","128996","","257992"
"2016-09-10 21:01","AuditorElector.java","80343","55103","135446","","270892"
"2013-03-05 18:45","AuditorElector.java","3478","37683","41161","4","82322"
"2017-03-28 22:40","AuditorElector.java","80657","77373","158030","","316060"
"2014-06-02 11:54","AuditorElector.java","7219","60686","67905","7","135810"
"2014-04-24 10:43","AuditorElector.java","7017","58346","65363","7","130726"
"2014-09-06 07:58","AuditorElector.java","7782","70192","77974","","155948"
"2013-01-04 11:32","AuditorElector.java","1657","3668","5325","2","10650"
"2012-11-23 11:49","TestBenchmark.java","16617","72275","88892","2","177784"
"2014-02-05 22:43","TestBenchmark.java","20163","130787","150950","7","301900"
"2012-05-09 13:20","TestBenchmark.java","9134","15399","24533","1","49066"
"2012-06-12 17:37","TestBenchmark.java","9780","17877","27657","1","55314"
"2016-02-09 08:12","TestBenchmark.java","21100","152294","173394","","346788"
"2015-09-15 10:38","LedgerManager.java","4673","24700","29373","","58746"
"2017-07-04 06:27","LedgerStorage.java","4684","23458","28142","","56284"
"2017-03-28 22:37","LedgerStorage.java","375","5182","5557","","11114"
"2017-05-16 00:31","LedgerStorage.java","2479","11243","13722","","27444"
"2017-06-21 19:58","BookieClientTest.java","1939","7262","9201","","18402"
"2015-07-10 22:48","ZooWorker.java","1878","6218","8096","","16192"
"2017-07-04 06:27","LedgerHandle.java","737","5169","5906","","11812"
"2017-06-30 00:12","LedgerHandle.java","397","2868","3265","","6530"
"2012-05-25 17:13","ReadLastConfirmedOp.java","10317","39064","49381","1","98762"
"2017-06-30 00:12","ReadLastConfirmedOp.java","36232","128317","164549","","329098"
"2012-08-27 14:43","ReadLastConfirmedOp.java","11814","65064","76878","2","153756"
"2012-09-14 15:42","ReadLastConfirmedOp.java","12128","72356","84484","2","168968"
"2011-09-05 19:38","ReadLastConfirmedOp.java","4901","10804","15705","","31410"
"2011-11-16 17:05","ReadLastConfirmedOp.java","7085","14686","21771","","43542"
"2011-11-17 11:16","ReadLastConfirmedOp.java","7296","15540","22836","","45672"
"2011-10-26 16:06","ReadLastConfirmedOp.java","4971","11124","16095","","32190"
"2017-05-15 19:52","ReadLastConfirmedOp.java","36169","119787","155956","","311912"
"2012-02-13 15:46","ReadLastConfirmedOp.java","8735","26644","35379","1","70758"
"2012-04-02 12:38","ReadLastConfirmedOp.java","9668","35348","45016","1","90032"
"2017-06-01 23:58","ReadLastConfirmedOp.java","36213","123024","159237","","318474"
"2014-02-21 19:01","ReadLastConfirmedOp.java","16289","149237","165526","7","331052"
"2017-06-21 19:50","LedgerHandle.java","526","2546","3072","","6144"
"2017-06-21 21:00","LedgerHandle.java","546","3349","3895","","7790"
"2017-07-04 06:27","LedgerHandle.java","1257","8492","9749","","19498"
"2017-06-30 00:12","LedgerHandle.java","925","6199","7124","","14248"
"2012-07-23 23:39","BKStats.java","13318","37733","51051","2","102102"
"2012-05-25 17:13","ReadLastConfirmedOp.java","10849","31995","42844","1","85688"
"2017-06-30 00:12","ReadLastConfirmedOp.java","40399","124883","165282","","330564"
"2012-08-27 14:43","ReadLastConfirmedOp.java","13153","58802","71955","2","143910"
"2012-09-14 15:42","ReadLastConfirmedOp.java","13591","66218","79809","2","159618"
"2011-11-17 11:16","ReadLastConfirmedOp.java","254","897","1151","","2302"
"2017-05-15 19:52","ReadLastConfirmedOp.java","40249","116266","156515","","313030"
"2012-02-13 15:46","ReadLastConfirmedOp.java","2421","12729","15150","1","30300"
"2012-04-02 12:38","ReadLastConfirmedOp.java","9922","28001","37923","1","75846"
"2017-06-01 23:58","ReadLastConfirmedOp.java","40364","119574","159938","","319876"
"2014-02-21 19:01","ReadLastConfirmedOp.java","18534","143881","162415","7","324830"
"2017-07-07 08:19","LedgerDirsManagerTest.java","4946","31822","36768","","73536"
"2017-06-05 20:30","LedgerDirsManagerTest.java","3920","21956","25876","","51752"
"2017-07-07 08:19","BookieException.java","113524","91770","205294","","410588"
"2013-03-25 06:27","TestLedgerManager.java","6126","47523","53649","4","107298"
"2012-12-10 10:58","TestLedgerManager.java","2171","4874","7045","2","14090"
"2017-03-28 22:40","TestLedgerManager.java","79034","82522","161556","","323112"
"2015-07-10 22:48","TestLedgerManager.java","10386","83378","93764","","187528"
"2014-07-24 01:41","TestLedgerManager.java","9529","70253","79782","","159564"
"2012-12-08 11:18","Bookie.java","7355","49672","57027","2","114054"
"2012-09-14 15:42","Bookie.java","3829","26845","30674","2","61348"
"2012-10-25 15:35","Bookie.java","6697","38957","45654","2","91308"
"2012-10-26 16:25","Bookie.java","6903","40112","47015","2","94030"
"2017-01-31 04:01","Bookie.java","51690","89750","141440","","282880"
"2017-03-28 22:37","Bookie.java","51749","94616","146365","","292730"
"2016-01-26 22:11","Bookie.java","13984","129168","143152","","286304"
"2015-03-18 07:38","Bookie.java","13621","125553","139174","","278348"
"2015-04-21 09:17","Bookie.java","13622","125656","139278","","278556"
"2012-10-18 16:40","Bookie.java","6575","37698","44273","2","88546"
"2012-12-03 17:59","Bookie.java","7213","49485","56698","2","113396"
"2012-07-23 23:39","Bookie.java","1858","4772","6630","2","13260"
"2013-06-21 19:26","Bookie.java","10989","97715","108704","5","217408"
"2012-09-07 07:04","Bookie.java","3375","25730","29105","2","58210"
"2014-09-23 17:53","Bookie.java","13366","122241","135607","","271214"
"2017-07-04 06:27","Bookie.java","53083","109917","163000","","326000"
"2017-06-05 22:25","Bookie.java","52947","103995","156942","","313884"
"2014-02-06 09:25","Bookie.java","12706","107287","119993","7","239986"
"2014-04-29 22:07","Bookie.java","12843","110929","123772","7","247544"
"2013-12-06 07:39","Bookie.java","12137","104463","116600","6","233200"
"2014-08-02 20:02","Bookie.java","13299","120082","133381","","266762"
"2013-10-02 07:01","Bookie.java","11139","99710","110849","5","221698"
"2017-06-28 23:24","Bookie.java","52988","105989","158977","","317954"
"2017-07-07 08:19","Bookie.java","53080","111877","164957","","329914"
"2013-09-11 00:34","Bookie.java","11111","99481","110592","5","221184"
"2014-01-21 17:26","Bookie.java","12287","106350","118637","6","237274"
"2013-10-12 05:42","Bookie.java","11899","101203","113102","6","226204"
"2013-10-22 16:21","Bookie.java","12090","102161","114251","6","228502"
"2017-05-16 00:31","Bookie.java","52312","99136","151448","","302896"
"2013-07-24 16:55","Bookie.java","11039","98823","109862","5","219724"
"2014-02-05 22:43","Bookie.java","12704","107277","119981","7","239962"
"2014-08-18 23:03","Bookie.java","13307","121558","134865","","269730"
"2014-05-09 14:04","Bookie.java","12854","111581","124435","7","248870"
"2013-06-15 19:05","Bookie.java","10986","97585","108571","5","217142"
"2017-06-01 23:58","Bookie.java","52931","102530","155461","","310922"
"2017-08-02 00:49","Bookie.java","54424","129464","183888","","367776"
"2013-12-02 18:45","Bookie.java","12127","104301","116428","6","232856"
"2013-05-04 14:22","Bookie.java","10802","92872","103674","5","207348"
"2012-12-18 13:04","Bookie.java","7703","54372","62075","2","124150"
"2016-11-18 00:18","Bookie.java","51645","76604","128249","","256498"
"2017-03-28 22:35","Bookie.java","51731","94383","146114","","292228"
"2016-07-14 23:02","Bookie.java","51218","68287","119505","","239010"
"2017-06-05 20:30","Bookie.java","52932","102889","155821","","311642"
"2016-11-30 00:02","Bookie.java","51656","77145","128801","","257602"
"2012-12-24 05:50","Bookie.java","8296","55073","63369","2","126738"
"2017-03-22 22:54","Bookie.java","51733","90081","141814","","283628"
"2012-12-24 06:23","Bookie.java","8355","55354","63709","2","127418"
"2017-07-04 06:27","ServerConfiguration.java","10341","51653","61994","","123988"
"2016-04-14 00:51","ServerConfiguration.java","43","93","136","","272"
"2016-04-27 09:55","ServerConfiguration.java","231","793","1024","","2048"
"2017-05-15 19:52","ServerConfiguration.java","8171","39055","47226","","94452"
"2017-03-22 22:54","ServerConfiguration.java","6786","29612","36398","","72796"
"2017-03-23 00:48","ServerConfiguration.java","6791","29669","36460","","72920"
"2017-01-31 02:11","ServerConfiguration.java","6181","22638","28819","","57638"
"2016-11-09 03:02","ServerConfiguration.java","6061","15346","21407","","42814"
"2016-11-30 00:02","ServerConfiguration.java","6126","16093","22219","","44438"
"2017-06-05 20:30","ServerConfiguration.java","9476","43911","53387","","106774"
"2016-09-10 20:27","ServerConfiguration.java","4363","9859","14222","","28444"
"2017-08-02 00:49","ServerConfiguration.java","14665","74183","88848","","177696"
"2017-10-03 12:31","ServerConfiguration.java","26810","76485","103295","","206590"
"2017-08-16 03:37","ServerConfiguration.java","17067","83218","100285","","200570"
"2017-05-26 12:38","ServerConfiguration.java","8427","41627","50054","","100108"
"2017-07-07 08:19","ServerConfiguration.java","10391","53666","64057","","128114"
"2017-06-28 23:24","ServerConfiguration.java","9848","47327","57175","","114350"
"2017-11-08 12:27","ServerConfiguration.java","29540","97089","126629","","253258"
"2017-05-15 19:52","BookKeeperClusterTestCase.java","112502","60181","172683","","345366"
"2016-04-05 08:45","BookKeeperClusterTestCase.java","108070","24623","132693","","265386"
"2017-08-01 08:34","BookKeeperClusterTestCase.java","117278","91006","208284","","416568"
"2017-11-08 12:27","BookKeeperClusterTestCase.java","127418","111762","239180","","478360"
"2017-07-04 06:27","BookKeeperClusterTestCase.java","114172","72279","186451","","372902"
"2014-07-24 01:41","BookKeeperClusterTestCase.java","723","2327","3050","","6100"
"2014-05-23 18:46","BookKeeperClusterTestCase.java","24","354","378","7","756"
"2017-06-30 00:12","BookKeeperClusterTestCase.java","114034","70180","184214","","368428"
"2016-04-27 09:55","BookKeeperClusterTestCase.java","108159","25516","133675","","267350"
"2015-10-06 10:48","BookKeeperClusterTestCase.java","3556","18280","21836","","43672"
"2014-12-10 19:43","BookKeeperClusterTestCase.java","2611","13843","16454","","32908"
"2017-07-04 06:27","ServerConfiguration.java","10260","51010","61270","","122540"
"2017-05-15 19:52","ServerConfiguration.java","8075","38397","46472","","92944"
"2017-03-22 22:54","ServerConfiguration.java","6578","28842","35420","","70840"
"2017-03-23 00:48","ServerConfiguration.java","6583","28899","35482","","70964"
"2017-01-31 02:11","ServerConfiguration.java","5957","21852","27809","","55618"
"2016-11-09 03:02","ServerConfiguration.java","5837","14560","20397","","40794"
"2016-11-30 00:02","ServerConfiguration.java","5902","15307","21209","","42418"
"2017-06-05 20:30","ServerConfiguration.java","9389","43262","52651","","105302"
"2016-09-10 20:27","ServerConfiguration.java","4139","9073","13212","","26424"
"2017-08-02 00:49","ServerConfiguration.java","14585","73541","88126","","176252"
"2017-10-03 12:31","ServerConfiguration.java","26740","75853","102593","","205186"
"2017-08-16 03:37","ServerConfiguration.java","16991","82580","99571","","199142"
"2017-05-26 12:38","ServerConfiguration.java","8331","40969","49300","","98600"
"2017-07-07 08:19","ServerConfiguration.java","10310","53023","63333","","126666"
"2017-06-28 23:24","ServerConfiguration.java","9761","46678","56439","","112878"
"2017-11-08 12:27","ServerConfiguration.java","29494","96481","125975","","251950"
"2012-09-12 11:59","TestReadTimeout.java","13113","59282","72395","2","144790"
"2012-03-15 10:37","TestReadTimeout.java","7788","17260","25048","1","50096"
"2013-10-29 05:14","TestReadTimeout.java","18801","132297","151098","6","302196"
"2014-02-05 22:43","TestReadTimeout.java","19182","137044","156226","7","312452"
"2017-07-07 08:19","LedgerDirsManagerTest.java","1234","10074","11308","","22616"
"2013-03-25 06:27","TestLedgerManager.java","4093","42787","46880","4","93760"
"2017-03-28 22:40","TestLedgerManager.java","79160","79945","159105","","318210"
"2015-07-10 22:48","TestLedgerManager.java","8455","78744","87199","","174398"
"2014-07-24 01:41","TestLedgerManager.java","7593","65614","73207","","146414"
"2012-09-14 15:42","LedgerLayout.java","623","1284","1907","2","3814"
"2017-06-01 23:58","LedgerLayout.java","68549","95793","164342","","328684"
"2016-07-14 23:02","LedgerLayout.java","66134","60848","126982","","253964"
"2017-05-26 16:52","Journal.java","112591","46028","158619","","317238"
"2017-03-22 22:54","Journal.java","110981","34024","145005","","290010"
"2016-11-12 03:37","Journal.java","110744","20294","131038","","262076"
"2016-07-14 23:02","Journal.java","105615","7379","112994","","225988"
"2017-06-01 23:58","Journal.java","113431","47725","161156","","322312"
"2017-05-09 22:24","Journal.java","111771","41410","153181","","306362"
"2017-05-16 00:31","Journal.java","112510","44029","156539","","313078"
"2017-06-30 00:12","PendingReadLacOp.java","925","6199","7124","","14248"
"2016-02-09 08:39","BookKeeperTest.java","3135","18177","21312","","42624"
"2015-10-16 07:00","BookKeeperTest.java","2971","16117","19088","","38176"
"2016-04-08 19:43","BookKeeperTest.java","107655","22874","130529","","261058"
"2017-01-31 04:01","BookKeeperTest.java","110993","48722","159715","","319430"
"2017-05-15 19:52","BookKeeperTest.java","112131","58206","170337","","340674"
"2017-05-02 22:07","BookKeeperTest.java","111314","55035","166349","","332698"
"2013-10-22 16:21","LedgerEntryPage.java","18334","136085","154419","6","308838"
"2017-07-04 06:27","LedgerEntryPage.java","41212","125726","166938","","333876"
"2012-05-25 17:13","LedgerEntryPage.java","10523","29738","40261","1","80522"
"2012-05-10 14:47","LedgerEntryPage.java","10188","28149","38337","1","76674"
"2012-12-24 05:50","StringUtils.java","17351","95437","112788","2","225576"
"2017-05-02 23:04","StringUtils.java","40280","116505","156785","","313570"
"2013-08-21 13:19","BookKeeperAdmin.java","6684","53224","59908","5","119816"
"2017-10-17 09:32","BookKeeperAdmin.java","90283","121599","211882","","423764"
"2017-06-01 23:58","BookKeeperAdmin.java","80830","88694","169524","","339048"
"2017-04-11 20:19","BookKeeperAdmin.java","79551","80930","160481","","320962"
"2014-02-21 19:01","BookKeeperAdmin.java","8882","62883","71765","7","143530"
"2014-02-05 22:43","BookKeeperAdmin.java","8777","61615","70392","7","140784"
"2017-07-07 05:11","BookKeeperAdmin.java","81118","97897","179015","","358030"
"2013-02-26 04:12","BookKeeperAdmin.java","5702","44546","50248","4","100496"
"2016-11-09 03:05","BookKeeperAdmin.java","79322","62411","141733","","283466"
"2016-11-30 00:07","BookKeeperAdmin.java","79332","63085","142417","","284834"
"2016-09-10 21:01","BookKeeperAdmin.java","79206","58610","137816","","275632"
"2016-07-14 23:02","BookKeeperAdmin.java","78161","53495","131656","","263312"
"2016-10-13 09:27","BookKeeperAdmin.java","79321","62076","141397","","282794"
"2013-02-08 19:08","BookKeeperAdmin.java","4817","43633","48450","4","96900"
"2016-03-16 05:03","BookKeeperAdmin.java","77922","48764","126686","","253372"
"2016-03-08 07:18","BookKeeperAdmin.java","10757","85885","96642","","193284"
"2014-12-06 08:03","BookKeeperAdmin.java","9742","77801","87543","","175086"
"2014-04-24 10:43","BookKeeperAdmin.java","8910","64883","73793","7","147586"
"2014-09-06 07:51","BookKeeperAdmin.java","9572","76494","86066","","172132"
"2013-05-10 12:45","BookKeeperAdmin.java","6326","46991","53317","5","106634"
"2016-04-27 21:11","ZkLedgerUnderreplicationManager.java","109657","37452","147109","","294218"
"2016-07-14 23:02","ZkLedgerUnderreplicationManager.java","109910","38690","148600","","297200"
"2017-07-07 05:11","ZkLedgerUnderreplicationManager.java","114953","85178","200131","","400262"
"2017-06-28 23:28","ZkLedgerUnderreplicationManager.java","114716","79920","194636","","389272"
"2017-06-01 23:58","ZkLedgerUnderreplicationManager.java","114459","75769","190228","","380456"
"2014-08-18 23:03","ZkLedgerUnderreplicationManager.java","4787","24749","29536","","59072"
"2014-06-03 12:35","ZkLedgerUnderreplicationManager.java","3771","15796","19567","7","39134"
"2014-06-02 11:54","ZkLedgerUnderreplicationManager.java","3751","15308","19059","7","38118"
"2017-03-28 22:40","ZkLedgerUnderreplicationManager.java","112797","67603","180400","","360800"
"2016-04-27 09:55","ZkLedgerUnderreplicationManager.java","109657","37452","147109","","294218"
"2017-03-23 00:48","ClientConfiguration.java","41073","106918","147991","","295982"
"2016-04-05 08:45","ClientConfiguration.java","40885","83610","124495","","248990"
"2017-03-28 22:35","ClientConfiguration.java","41069","111166","152235","","304470"
"2017-01-31 02:14","ClientConfiguration.java","41064","101100","142164","","284328"
"2017-04-15 13:58","ClientConfiguration.java","41076","112273","153349","","306698"
"2017-03-23 00:59","ClientConfiguration.java","41073","106930","148003","","296006"
"2017-05-15 19:52","ClientConfiguration.java","41242","115093","156335","","312670"
"2016-10-13 07:50","ClientConfiguration.java","40949","92898","133847","","267694"
"2017-06-21 19:58","ClientConfiguration.java","41397","120571","161968","","323936"
"2013-10-29 05:14","ClientConfiguration.java","18343","135995","154338","6","308676"
"2017-06-05 21:48","ClientConfiguration.java","41368","119154","160522","","321044"
"2017-06-21 19:50","ClientConfiguration.java","41396","120460","161856","","323712"
"2012-04-20 19:18","ClientConfiguration.java","9877","26662","36539","1","73078"
"2017-08-02 00:49","ClientConfiguration.java","42074","144559","186633","","373266"
"2017-08-01 08:34","ClientConfiguration.java","41978","141878","183856","","367712"
"2013-06-12 18:41","ClientConfiguration.java","18113","131730","149843","5","299686"
"2014-05-27 13:56","ClientConfiguration.java","18765","145498","164263","7","328526"
"2017-06-30 00:12","ClientConfiguration.java","41403","123721","165124","","330248"
"2014-09-18 06:47","ClientConfiguration.java","19102","155339","174441","","348882"
"2017-07-04 06:27","ClientConfiguration.java","41434","125713","167147","","334294"
"2012-09-12 11:59","ClientConfiguration.java","13166","63491","76657","2","153314"
"2017-01-31 04:01","ClientConfiguration.java","41078","106583","147661","","295322"
"2015-10-06 10:05","ClientConfiguration.java","19212","159882","179094","","358188"
"2015-10-06 10:48","ClientConfiguration.java","19214","160110","179324","","358648"
"2013-02-08 19:08","ClientConfiguration.java","16971","124967","141938","4","283876"
"2012-12-03 10:46","ClientConfiguration.java","16032","85896","101928","2","203856"
"2012-02-01 12:06","ClientConfiguration.java","1215","5371","6586","1","13172"
"2016-02-09 08:32","ClientConfiguration.java","19225","161986","181211","","362422"
"2014-12-06 07:54","ClientConfiguration.java","19109","156264","175373","","350746"
"2016-08-01 08:04","ClientConfiguration.java","40943","86122","127065","","254130"
"2012-12-13 13:07","ClientConfiguration.java","16321","88007","104328","2","208656"
"2016-07-11 23:01","BookieWriteLedgerTest.java","109633","44958","154591","","309182"
"2014-02-05 22:43","BookieWriteLedgerTest.java","3706","16569","20275","7","40550"
"2014-07-24 01:41","BookieWriteLedgerTest.java","4547","23168","27715","","55430"
"2015-10-22 09:22","BookieWriteLedgerTest.java","6053","38624","44677","","89354"
"2014-12-10 19:43","BookieInitializationTest.java","13596","123555","137151","","274302"
"2012-10-25 15:35","BookieInitializationTest.java","6697","38957","45654","2","91308"
"2014-06-06 15:29","BookieInitializationTest.java","12917","113240","126157","7","252314"
"2015-07-10 22:48","BookieInitializationTest.java","13768","126367","140135","","280270"
"2013-10-02 07:01","BookieInitializationTest.java","11139","99710","110849","5","221698"
"2013-06-21 18:51","BookieInitializationTest.java","10986","97632","108618","5","217236"
"2013-07-24 16:55","BookieInitializationTest.java","11039","98823","109862","5","219724"
"2014-01-21 17:26","BookieInitializationTest.java","12287","106350","118637","6","237274"
"2013-10-12 05:42","BookieInitializationTest.java","11899","101203","113102","6","226204"
"2017-07-07 08:19","BookieInitializationTest.java","53080","111877","164957","","329914"
"2017-06-28 23:24","BookieInitializationTest.java","52988","105989","158977","","317954"
"2017-07-28 06:39","BookieInitializationTest.java","53624","114310","167934","","335868"
"2017-08-02 00:49","BookieInitializationTest.java","54424","129464","183888","","367776"
"2017-06-05 20:30","BookieInitializationTest.java","52932","102889","155821","","311642"
"2017-05-15 19:52","BookieInitializationTest.java","52246","98652","150898","","301796"
"2017-05-16 13:20","BookieProtoEncoding.java","273","698","971","","1942"
"2017-05-16 00:31","BookieProtoEncoding.java","263","681","944","","1888"
"2017-06-01 21:20","BookieProtoEncoding.java","1150","3895","5045","","10090"
"2017-05-17 08:57","BookieProtoEncoding.java","291","768","1059","","2118"
"2017-06-05 22:25","BookieProtoEncoding.java","1852","6494","8346","","16692"
"2013-10-14 17:38","LedgerRecoveryOp.java","13838","111666","125504","6","251008"
"2017-06-21 19:58","LedgerRecoveryOp.java","49410","109604","159014","","318028"
"2017-06-21 21:00","LedgerRecoveryOp.java","49411","110278","159689","","319378"
"2017-06-21 19:50","LedgerRecoveryOp.java","49410","109494","158904","","317808"
"2013-03-25 18:02","LedgerRecoveryOp.java","12575","102387","114962","4","229924"
"2017-06-30 00:12","RoundRobinDistributionSchedule.java","115434","60802","176236","","352472"
"2014-07-24 01:41","ConcurrentLedgerTest.java","19365","151005","170370","","340740"
"2014-12-10 19:43","ConcurrentLedgerTest.java","19422","160690","180112","","360224"
"2011-11-17 11:16","ConcurrentLedgerTest.java","2969","5310","8279","","16558"
"2011-11-28 19:25","ConcurrentLedgerTest.java","3825","10198","14023","","28046"
"2011-11-18 11:18","ConcurrentLedgerTest.java","3592","7221","10813","","21626"
"2012-03-08 19:24","ConcurrentLedgerTest.java","4913","18813","23726","1","47452"
"2012-02-15 16:11","ConcurrentLedgerTest.java","4626","16644","21270","1","42540"
"2013-10-12 05:42","ConcurrentLedgerTest.java","18908","139521","158429","6","316858"
"2014-02-05 22:43","ConcurrentLedgerTest.java","19159","145041","164200","7","328400"
"2017-05-16 00:31","ConcurrentLedgerTest.java","40457","118590","159047","","318094"
"2012-12-24 05:50","SnapshotMap.java","11231","70119","81350","2","162700"
"2013-05-31 12:02","BookieJournalRollingTest.java","18075","128254","146329","5","292658"
"2013-10-12 05:42","BookieJournalRollingTest.java","18238","135222","153460","6","306920"
"2012-02-17 12:50","BookieJournalRollingTest.java","1622","10252","11874","1","23748"
"2012-03-15 10:37","BookieJournalRollingTest.java","8763","22626","31389","1","62778"
"2014-07-24 01:41","BookieJournalRollingTest.java","18947","146958","165905","","331810"
"2012-04-17 13:16","BookieJournalRollingTest.java","9891","26625","36516","1","73032"
"2012-06-19 12:39","BookieRecoveryTest.java","11948","36710","48658","2","97316"
"2012-12-12 11:20","BookieRecoveryTest.java","16732","91033","107765","2","215530"
"2012-09-12 11:59","BookieRecoveryTest.java","14056","67767","81823","2","163646"
"2017-06-30 00:12","BookieRecoveryTest.java","40391","126095","166486","","332972"
"2014-07-24 01:41","BookieRecoveryTest.java","19054","150216","169270","","338540"
"2011-11-28 19:25","BookieRecoveryTest.java","2895","8790","11685","","23370"
"2011-11-16 17:05","BookieRecoveryTest.java","1661","2881","4542","","9084"
"2012-12-04 22:15","BookieRecoveryTest.java","16667","89916","106583","2","213166"
"2017-04-11 20:15","BookieRecoveryTest.java","40104","114047","154151","","308302"
"2017-05-15 19:52","BookieRecoveryTest.java","40265","117502","157767","","315534"
"2012-07-18 17:00","BookieRecoveryTest.java","13312","46989","60301","2","120602"
"2012-12-10 16:02","BookieRecoveryTest.java","16719","89970","106689","2","213378"
"2012-03-31 10:58","BookieRecoveryTest.java","11072","30233","41305","1","82610"
"2011-11-15 19:42","BookieRecoveryTest.java","1566","2051","3617","","7234"
"2011-11-18 11:18","BookieRecoveryTest.java","2545","5696","8241","","16482"
"2012-02-13 15:46","BookieRecoveryTest.java","3724","15252","18976","1","37952"
"2013-08-13 14:32","BookieRecoveryTest.java","18472","137302","155774","5","311548"
"2014-02-05 22:43","BookieRecoveryTest.java","18838","144242","163080","7","326160"
"2012-10-05 16:24","LedgerFragment.java","3399","10365","13764","2","27528"
"2012-09-12 20:34","LedgerFragment.java","400","2482","2882","2","5764"
"2012-11-30 04:54","LedgerFragment.java","5012","25755","30767","2","61534"
"2014-02-05 22:43","LedgerFragment.java","11251","84832","96083","7","192166"
"2017-07-04 06:27","FileInfo.java","39962","128033","167995","","335990"
"2012-10-26 12:51","FileInfo.java","15698","79584","95282","2","190564"
"2011-11-17 11:16","FileInfo.java","954","3223","4177","","8354"
"2014-12-04 12:28","FileInfo.java","18502","159166","177668","","355336"
"2017-01-31 04:01","FileInfo.java","39661","108958","148619","","297238"
"2017-03-23 15:55","FileInfo.java","39656","109319","148975","","297950"
"2016-11-18 00:18","FileInfo.java","39645","95841","135486","","270972"
"2012-12-18 13:04","FileInfo.java","16126","94032","110158","2","220316"
"2013-05-04 14:22","FileInfo.java","17581","130888","148469","5","296938"
"2012-02-09 18:14","FileInfo.java","2794","14481","17275","1","34550"
"2012-02-17 11:18","FileInfo.java","2910","15052","17962","1","35924"
"2012-02-24 19:20","FileInfo.java","2997","15704","18701","1","37402"
"2012-06-13 16:57","FileInfo.java","11046","35448","46494","","92988"
"2012-03-29 15:18","FileInfo.java","10264","28993","39257","1","78514"
"2017-06-01 23:58","FileInfo.java","39916","120752","160668","","321336"
"2017-07-17 23:27","FileInfo.java","39968","131146","171114","","342228"
"2017-05-16 00:31","FileInfo.java","39828","117889","157717","","315434"
"2013-10-22 16:21","FileInfo.java","17896","139204","157100","6","314200"
"2013-10-11 08:36","FileInfo.java","17802","137802","155604","6","311208"
"2017-06-01 23:58","ZooKeeperWatcherBase.java","113946","50946","164892","","329784"
"2017-08-16 03:37","BookieServer.java","119527","114284","233811","","467622"
"2017-08-02 00:49","BookieServer.java","118002","106126","224128","","448256"
"2013-07-24 16:55","BookieServer.java","169","1037","1206","5","2412"
"2014-02-05 22:43","BookieServer.java","3424","11081","14505","7","29010"
"2017-06-28 23:24","BookieServer.java","114616","80701","195317","","390634"
"2017-06-01 23:58","BookieServer.java","114389","77072","191461","","382922"
"2017-10-17 09:32","BookieServer.java","125653","111788","237441","","474882"
"2014-08-02 20:02","BookieServer.java","4626","24493","29119","","58238"
"2013-12-06 07:39","BookieServer.java","1930","7340","9270","6","18540"
"2014-01-21 05:05","BookieServer.java","2267","8775","11042","6","22084"
"2017-07-07 05:11","Auditor.java","6514","43889","50403","","100806"
"2017-05-26 16:52","Auditor.java","4545","32148","36693","","73386"
"2016-11-09 03:02","Auditor.java","1684","5352","7036","","14072"
"2017-08-16 03:37","BookieServer.java","119735","113624","233359","","466718"
"2017-08-02 00:49","BookieServer.java","118212","105468","223680","","447360"
"2014-02-05 22:43","BookieServer.java","3275","10064","13339","7","26678"
"2017-06-28 23:24","BookieServer.java","114756","79973","194729","","389458"
"2017-06-01 23:58","BookieServer.java","114529","76344","190873","","381746"
"2017-10-17 09:32","BookieServer.java","125916","111183","237099","","474198"
"2014-08-02 20:02","BookieServer.java","4526","23525","28051","","56102"
"2013-12-06 07:39","BookieServer.java","1776","6318","8094","6","16188"
"2014-01-21 05:05","BookieServer.java","2113","7753","9866","6","19732"
"2017-07-07 05:11","Auditor.java","5002","38709","43711","","87422"
"2017-05-26 16:52","Auditor.java","3008","26943","29951","","59902"
"2017-08-16 03:37","BookieServer.java","118635","105735","224370","","448740"
"2017-08-02 00:49","BookieServer.java","117040","97507","214547","","429094"
"2017-06-28 23:24","BookieServer.java","113132","71560","184692","","369384"
"2017-06-01 23:58","BookieServer.java","112825","67851","180676","","361352"
"2017-10-17 09:32","BookieServer.java","125165","103643","228808","","457616"
"2014-08-02 20:02","BookieServer.java","1789","13999","15788","","31576"
"2014-06-02 11:54","AuditorLedgerCheckerTest.java","7361","61335","68696","7","137392"
"2014-07-24 01:41","AuditorLedgerCheckerTest.java","7669","62128","69797","","139594"
"2016-03-08 07:18","AuditorLedgerCheckerTest.java","9173","80164","89337","","178674"
"2012-12-18 12:00","AuditorLedgerCheckerTest.java","256","763","1019","2","2038"
"2016-12-17 02:44","AuditorLedgerCheckerTest.java","80434","65789","146223","","292446"
"2017-07-07 05:11","AuditorLedgerCheckerTest.java","82301","94943","177244","","354488"
"2014-02-05 22:43","AuditorLedgerCheckerTest.java","6998","55699","62697","7","125394"
"2013-08-21 13:19","AuditorLedgerCheckerTest.java","4768","47171","51939","5","103878"
"2017-10-17 09:32","AuditorLedgerCheckerTest.java","91878","119057","210935","","421870"
"2017-05-12 15:20","AuditorLedgerCheckerTest.java","80932","80661","161593","","323186"
"2013-06-15 19:05","AuditorLedgerCheckerTest.java","4600","45327","49927","5","99854"
"2013-05-31 12:02","AuditorLedgerCheckerTest.java","4497","41124","45621","5","91242"
"2016-11-18 00:18","InterleavedLedgerStorage.java","111492","43933","155425","","310850"
"2014-01-21 17:26","InterleavedLedgerStorage.java","464","2009","2473","6","4946"
"2017-05-16 00:31","InterleavedLedgerStorage.java","112699","67005","179704","","359408"
"2014-08-02 20:02","InterleavedLedgerStorage.java","2987","17252","20239","","40478"
"2017-07-04 06:27","InterleavedLedgerStorage.java","114118","78434","192552","","385104"
"2015-04-21 09:55","InterleavedLedgerStorage.java","4012","23699","27711","","55422"
"2017-01-31 04:01","InterleavedLedgerStorage.java","111563","57105","168668","","337336"
"2016-03-08 06:49","InterleavedLedgerStorage.java","5112","28792","33904","","67808"
"2017-03-28 22:37","InterleavedLedgerStorage.java","111701","62050","173751","","347502"
"2015-04-21 09:17","InterleavedLedgerStorage.java","3982","23498","27480","","54960"
"2016-07-14 23:02","BenchThroughputLatency.java","108873","35735","144608","","289216"
"2014-07-15 09:09","BenchThroughputLatency.java","2449","12597","15046","","30092"
"2017-03-23 00:48","ClientConfiguration.java","40851","106931","147782","","295564"
"2016-04-05 08:45","ClientConfiguration.java","40664","83624","124288","","248576"
"2017-03-28 22:35","ClientConfiguration.java","40847","111179","152026","","304052"
"2017-01-31 02:14","ClientConfiguration.java","40843","101114","141957","","283914"
"2017-04-15 13:58","ClientConfiguration.java","40854","112286","153140","","306280"
"2017-03-23 00:59","ClientConfiguration.java","40851","106943","147794","","295588"
"2017-05-15 19:52","ClientConfiguration.java","41020","115106","156126","","312252"
"2016-10-13 07:50","ClientConfiguration.java","40728","92912","133640","","267280"
"2017-06-21 19:58","ClientConfiguration.java","41175","120584","161759","","323518"
"2013-10-29 05:14","ClientConfiguration.java","18349","136236","154585","6","309170"
"2017-06-05 21:48","ClientConfiguration.java","41146","119167","160313","","320626"
"2017-06-21 19:50","ClientConfiguration.java","41174","120473","161647","","323294"
"2012-04-20 19:18","ClientConfiguration.java","9893","26913","36806","1","73612"
"2017-08-02 00:49","ClientConfiguration.java","41852","144572","186424","","372848"
"2017-08-01 08:34","ClientConfiguration.java","41756","141891","183647","","367294"
"2013-06-12 18:41","ClientConfiguration.java","18119","131971","150090","5","300180"
"2014-05-27 13:56","ClientConfiguration.java","18770","145738","164508","7","329016"
"2017-06-30 00:12","ClientConfiguration.java","41181","123734","164915","","329830"
"2014-09-18 06:47","ClientConfiguration.java","19106","155578","174684","","349368"
"2017-07-04 06:27","ClientConfiguration.java","41212","125726","166938","","333876"
"2012-09-12 11:59","ClientConfiguration.java","13182","63742","76924","2","153848"
"2017-01-31 04:01","ClientConfiguration.java","40857","106597","147454","","294908"
"2015-10-06 10:05","ClientConfiguration.java","19214","160119","179333","","358666"
"2015-10-06 10:48","ClientConfiguration.java","19216","160347","179563","","359126"
"2013-02-08 19:08","ClientConfiguration.java","16980","125211","142191","4","284382"
"2012-12-03 10:46","ClientConfiguration.java","16044","86143","102187","2","204374"
"2012-02-01 12:06","ClientConfiguration.java","1240","5631","6871","1","13742"
"2016-02-09 08:32","ClientConfiguration.java","19227","162223","181450","","362900"
"2014-12-06 07:54","ClientConfiguration.java","19113","156503","175616","","351232"
"2016-08-01 08:04","ClientConfiguration.java","40722","86136","126858","","253716"
"2012-12-13 13:07","ClientConfiguration.java","16333","88254","104587","2","209174"
"2014-05-09 14:04","CookieTest.java","9129","68249","77378","7","154756"
"2013-10-12 05:42","CookieTest.java","7828","57525","65353","6","130706"
"2016-11-30 00:02","CookieTest.java","78850","64732","143582","","287164"
"2014-12-10 19:43","CookieTest.java","10150","80502","90652","","181304"
"2014-09-23 17:53","CookieTest.java","9852","79120","88972","","177944"
"2014-09-18 06:57","CookieTest.java","9834","79046","88880","","177760"
"2017-05-09 23:06","GarbageCollectorThread.java","1616","14637","16253","","32506"
"2017-11-08 12:27","GarbageCollectorThread.java","32341","83491","115832","","231664"
"2017-03-28 22:39","GarbageCollectorThread.java","940","11905","12845","","25690"
"2015-09-15 10:38","BookKeeper.java","15581","136532","152113","","304226"
"2015-10-22 09:22","BookKeeper.java","15593","137924","153517","","307034"
"2017-01-31 04:01","BookKeeper.java","48396","94506","142902","","285804"
"2012-07-23 23:39","BookKeeper.java","4184","15148","19332","2","38664"
"2012-12-13 13:07","BookKeeper.java","9777","62068","71845","2","143690"
"2015-07-10 22:48","BookKeeper.java","15412","136061","151473","","302946"
"2017-06-30 00:12","BookKeeper.java","49642","112565","162207","","324414"
"2014-02-06 09:21","BookKeeper.java","14458","117085","131543","7","263086"
"2012-06-19 12:39","BookKeeper.java","857","2838","3695","2","7390"
"2012-09-12 11:59","BookKeeper.java","5735","36665","42400","2","84800"
"2014-01-21 05:19","BookKeeper.java","14064","115884","129948","6","259896"
"2013-10-02 06:40","BookKeeper.java","13035","109550","122585","5","245170"
"2014-02-21 19:01","BookKeeper.java","14545","118331","132876","7","265752"
"2016-10-13 07:50","BookKeeper.java","48286","80840","129126","","258252"
"2017-06-21 21:00","BookKeeper.java","49627","110079","159706","","319412"
"2013-06-12 18:41","BookKeeper.java","12884","107106","119990","5","239980"
"2013-05-06 19:32","BookKeeper.java","12713","102933","115646","5","231292"
"2013-01-10 19:13","BookKeeper.java","11210","68472","79682","2","159364"
"2017-03-28 22:35","BookKeeper.java","48426","99128","147554","","295108"
"2016-07-11 23:01","BookKeeper.java","48236","73321","121557","","243114"
"2016-10-13 09:27","BookKeeper.java","48362","80902","129264","","258528"
"2017-07-28 20:12","BookKeeper.java","50176","119654","169830","","339660"
"2017-05-15 19:52","BookKeeper.java","48892","103348","152240","","304480"
"2013-09-10 15:14","BookKeeper.java","12998","109379","122377","5","244754"
"2016-07-14 23:02","BenchThroughputLatency.java","109280","37011","146291","","292582"
"2013-10-29 05:14","BenchThroughputLatency.java","662","1531","2193","6","4386"
"2014-07-15 09:09","BenchThroughputLatency.java","2973","13990","16963","","33926"
"2014-06-02 11:54","AuditorLedgerCheckerTest.java","8656","75293","83949","7","167898"
"2014-07-24 01:41","AuditorLedgerCheckerTest.java","8944","76066","85010","","170020"
"2012-12-14 20:26","AuditorLedgerCheckerTest.java","1983","14646","16629","2","33258"
"2016-03-08 07:18","AuditorLedgerCheckerTest.java","10311","93965","104276","","208552"
"2012-12-18 12:00","AuditorLedgerCheckerTest.java","2238","15408","17646","2","35292"
"2016-12-17 02:44","AuditorLedgerCheckerTest.java","74449","72467","146916","","293832"
"2017-07-07 05:11","AuditorLedgerCheckerTest.java","76202","101507","177709","","355418"
"2014-02-05 22:43","AuditorLedgerCheckerTest.java","8364","69728","78092","7","156184"
"2013-08-21 13:19","AuditorLedgerCheckerTest.java","6283","61349","67632","5","135264"
"2017-10-17 09:32","AuditorLedgerCheckerTest.java","83762","123604","207366","","414732"
"2017-05-12 15:20","AuditorLedgerCheckerTest.java","74942","87334","162276","","324552"
"2013-06-15 19:05","AuditorLedgerCheckerTest.java","6138","59528","65666","5","131332"
"2013-05-31 12:02","AuditorLedgerCheckerTest.java","6053","55343","61396","5","122792"
"2017-08-02 00:49","ClientConfiguration.java","984","3569","4553","","9106"
"2017-06-01 23:58","EntryLogger.java","81692","84292","165984","","331968"
"2014-01-21 17:26","EntryLogger.java","5392","52456","57848","6","115696"
"2013-10-02 06:23","EntryLogger.java","3928","45310","49238","5","98476"
"2014-01-22 14:35","EntryLogger.java","5520","52960","58480","6","116960"
"2017-11-08 12:27","EntryLogger.java","92760","128832","221592","","443184"
"2013-10-22 07:44","EntryLogger.java","4999","47677","52676","6","105352"
"2013-05-04 14:22","EntryLogger.java","3356","38427","41783","5","83566"
"2017-01-31 02:11","EntryLogger.java","80104","65084","145188","","290376"
"2017-03-23 00:48","EntryLogger.java","80195","71596","151791","","303582"
"2016-07-14 23:02","EntryLogger.java","78765","48835","127600","","255200"
"2016-02-24 00:44","EntryLogger.java","8452","77299","85751","","171502"
"2015-04-21 10:02","EntryLogger.java","7562","72801","80363","","160726"
"2013-01-04 11:32","EntryLogger.java","771","2162","2933","2","5866"
"2015-04-21 09:44","EntryLogger.java","7564","72619","80183","","160366"
"2017-05-26 12:38","LocalBookKeeper.java","113106","49229","162335","","324670"
"2017-06-01 11:31","LocalBookKeeper.java","113180","50217","163397","","326794"
"2017-06-01 23:58","LocalBookKeeper.java","113946","50946","164892","","329784"
"2016-12-21 01:48","LedgerCacheTest.java","47133","91137","138270","","276540"
"2013-02-12 06:00","LedgerCacheTest.java","12229","105248","117477","4","234954"
"2013-01-07 03:48","LedgerCacheTest.java","11645","72572","84217","2","168434"
"2012-12-24 05:50","LedgerCacheTest.java","11090","70375","81465","2","162930"
"2012-12-24 06:23","LedgerCacheTest.java","11141","70648","81789","2","163578"
"2019-02-20 11:43","LedgerCacheTest.java","53950","436631","490581","","981162"
"2013-08-12 19:01","LedgerCacheTest.java","13442","113857","127299","5","254598"
"2013-10-12 05:42","LedgerCacheTest.java","14164","115976","130140","6","260280"
"2017-05-16 00:31","LedgerCacheTest.java","47675","107007","154682","","309364"
"2013-12-02 18:45","LedgerCacheTest.java","14357","119039","133396","6","266792"
"2012-03-31 09:31","LedgerCacheTest.java","78","548","626","1","1252"
"2014-07-24 01:41","LedgerCacheTest.java","15185","128024","143209","","286418"
"2012-06-06 18:13","LedgerCacheTest.java","1785","6321","8106","1","16212"
"2014-12-10 19:43","LedgerCacheTest.java","15580","138047","153627","","307254"
"2016-03-08 06:49","LedgerCacheTest.java","16023","144729","160752","","321504"
"2014-03-12 21:26","LedgerCacheTest.java","14880","124964","139844","7","279688"
"2012-12-08 11:18","LedgerCacheTest.java","10591","65416","76007","2","152014"
"2012-10-26 12:51","LedgerCacheTest.java","10009","55166","65175","2","130350"
"2017-03-23 00:48","ClientConfiguration.java","112373","64601","176974","","353948"
"2016-04-05 08:45","ClientConfiguration.java","109237","38345","147582","","295164"
"2017-03-28 22:35","ClientConfiguration.java","112368","68848","181216","","362432"
"2017-01-31 02:14","ClientConfiguration.java","112279","58698","170977","","341954"
"2017-04-15 13:58","ClientConfiguration.java","112481","70061","182542","","365084"
"2017-03-23 00:59","ClientConfiguration.java","112374","64614","176988","","353976"
"2017-05-15 19:52","ClientConfiguration.java","113166","73400","186566","","373132"
"2016-10-13 07:50","ClientConfiguration.java","112110","50442","162552","","325104"
"2017-06-21 19:58","ClientConfiguration.java","114243","79800","194043","","388086"
"2013-10-29 05:14","ClientConfiguration.java","2010","6045","8055","6","16110"
"2017-06-05 21:48","ClientConfiguration.java","114102","78271","192373","","384746"
"2017-06-21 19:50","ClientConfiguration.java","114241","79688","193929","","387858"
"2017-08-02 00:49","ClientConfiguration.java","117642","106510","224152","","448304"
"2017-08-01 08:34","ClientConfiguration.java","117118","103401","220519","","441038"
"2014-05-27 13:56","ClientConfiguration.java","3959","17075","21034","7","42068"
"2017-06-30 00:12","ClientConfiguration.java","114422","83123","197545","","395090"
"2014-09-18 06:47","ClientConfiguration.java","4773","27393","32166","","64332"
"2017-07-04 06:27","ClientConfiguration.java","114531","85193","199724","","399448"
"2017-01-31 04:01","ClientConfiguration.java","112286","64174","176460","","352920"
"2015-10-06 10:05","ClientConfiguration.java","5893","32946","38839","","77678"
"2015-10-06 10:48","ClientConfiguration.java","5896","33175","39071","","78142"
"2016-02-09 08:32","ClientConfiguration.java","6039","35183","41222","","82444"
"2014-12-06 07:54","ClientConfiguration.java","4898","28436","33334","","66668"
"2016-08-01 08:04","ClientConfiguration.java","109573","41135","150708","","301416"
"2012-12-08 11:18","ZkLedgerLayoutTest.java","8777","57163","65940","2","131880"
"2014-07-24 01:41","ZkLedgerLayoutTest.java","14466","120866","135332","","270664"
"2013-03-25 06:27","ZkLedgerLayoutTest.java","11968","99041","111009","4","222018"
"2014-01-21 05:19","PerChannelBookieClient.java","19000","144076","163076","6","326152"
"2013-10-22 07:35","PerChannelBookieClient.java","18916","139638","158554","6","317108"
"2012-05-17 16:05","PerChannelBookieClient.java","12426","34721","47147","1","94294"
"2012-05-26 19:16","PerChannelBookieClient.java","12557","35453","48010","1","96020"
"2014-01-09 07:30","PerChannelBookieClient.java","18986","142630","161616","6","323232"
"2017-06-30 00:12","PerChannelBookieClient.java","40529","126708","167237","","334474"
"2014-05-27 13:56","PerChannelBookieClient.java","19217","149811","169028","7","338056"
"2017-07-04 06:27","PerChannelBookieClient.java","40545","128685","169230","","338460"
"2012-07-23 23:39","PerChannelBookieClient.java","13977","48197","62174","2","124348"
"2012-08-13 11:38","PerChannelBookieClient.java","14328","54443","68771","2","137542"
"2011-11-17 11:16","PerChannelBookieClient.java","2950","5288","8238","","16476"
"2011-10-27 15:41","PerChannelBookieClient.java","128","576","704","","1408"
"2017-01-31 04:01","PerChannelBookieClient.java","40290","109656","149946","","299892"
"2015-10-06 10:05","PerChannelBookieClient.java","19467","163998","183465","","366930"
"2016-04-05 18:47","PerChannelBookieClient.java","40190","87018","127208","","254416"
"2012-02-01 12:06","PerChannelBookieClient.java","4415","12432","16847","1","33694"
"2011-11-16 17:05","PerChannelBookieClient.java","2716","4411","7127","","14254"
"2017-04-15 13:58","PerChannelBookieClient.java","40278","115336","155614","","311228"
"2017-05-15 19:52","PerChannelBookieClient.java","40436","118148","158584","","317168"
"2012-12-01 15:04","PerChannelBookieClient.java","17074","90281","107355","2","214710"
"2016-04-05 08:45","PerChannelBookieClient.java","40188","86774","126962","","253924"
"2017-07-28 20:12","PerChannelBookieClient.java","40781","133515","174296","","348592"
"2017-01-31 02:14","PerChannelBookieClient.java","40278","104175","144453","","288906"
"2017-03-28 22:35","PerChannelBookieClient.java","40275","114233","154508","","309016"
"2017-03-23 00:48","PerChannelBookieClient.java","40284","109990","150274","","300548"
"2013-01-10 19:13","PerChannelBookieClient.java","17741","98259","116000","2","232000"
"2014-07-25 00:34","PerChannelBookieClient.java","19397","156856","176253","","352506"
"2012-02-24 20:07","PerChannelBookieClient.java","4737","17519","22256","1","44512"
"2011-11-18 11:18","PerChannelBookieClient.java","3574","7200","10774","","21548"
"2017-08-02 00:49","PerChannelBookieClient.java","41169","147515","188684","","377368"
"2012-04-02 12:38","PerChannelBookieClient.java","11798","31572","43370","1","86740"
"2017-06-21 19:58","PerChannelBookieClient.java","40534","123569","164103","","328206"
"2017-06-01 23:58","PerChannelBookieClient.java","40515","121420","161935","","323870"
"2013-10-29 05:14","PerChannelBookieClient.java","18979","140492","159471","6","318942"
"2013-06-28 17:27","PerChannelBookieClient.java","18831","137045","155876","5","311752"
"2014-02-21 19:01","PerChannelBookieClient.java","19190","146232","165422","7","330844"
"2014-02-05 22:43","PerChannelBookieClient.java","19158","145037","164195","7","328390"
"2017-04-20 19:55","PerChannelBookieClient.java","40279","115358","155637","","311274"
"2013-09-11 00:34","PerChannelBookieClient.java","18866","138542","157408","5","314816"
"2013-08-20 12:51","PerChannelBookieClient.java","18859","138248","157107","5","314214"
"2014-12-10 19:43","ReadOnlyBookieTest.java","1949","11577","13526","","27052"
"2016-03-08 06:49","ReadOnlyBookieTest.java","3369","19236","22605","","45210"
"2016-04-14 00:51","ReadOnlyBookieTest.java","107666","22907","130573","","261146"
"2016-04-07 21:39","ReadOnlyBookieTest.java","107653","22853","130506","","261012"
"2017-05-02 23:04","HierarchicalLedgerManager.java","111667","75069","186736","","373472"
"2017-05-12 16:39","HierarchicalLedgerManager.java","111682","75764","187446","","374892"
"2014-01-17 18:13","HierarchicalLedgerManager.java","2537","13897","16434","6","32868"
"2015-03-12 08:21","AuditorPeriodicCheckTest.java","7016","70430","77446","","154892"
"2014-04-24 14:44","AuditorPeriodicCheckTest.java","5815","55135","60950","7","121900"
"2013-05-31 12:02","AuditorPeriodicCheckTest.java","2855","36964","39819","5","79638"
"2013-10-11 08:36","AuditorPeriodicCheckTest.java","4131","44504","48635","6","97270"
"2014-02-05 22:43","AuditorPeriodicCheckTest.java","5551","51734","57285","7","114570"
"2017-05-16 00:31","AuditorPeriodicCheckTest.java","81092","79526","160618","","321236"
"2014-07-25 00:34","AuditorPeriodicCheckTest.java","6516","64279","70795","","141590"
"2016-09-10 21:01","AuditorPeriodicCheckTest.java","80088","52837","132925","","265850"
"2013-01-10 19:13","AuditorPeriodicCheckTest.java","635","1457","2092","2","4184"
"2016-12-21 01:48","LedgerCacheTest.java","47342","90876","138218","","276436"
"2013-02-12 06:00","LedgerCacheTest.java","12361","104910","117271","4","234542"
"2013-01-07 03:48","LedgerCacheTest.java","11777","72234","84011","2","168022"
"2012-12-24 05:50","LedgerCacheTest.java","11219","70034","81253","2","162506"
"2012-12-24 06:23","LedgerCacheTest.java","11271","70308","81579","2","163158"
"2019-02-20 11:43","LedgerCacheTest.java","54182","436393","490575","","981150"
"2013-08-12 19:01","LedgerCacheTest.java","13606","113551","127157","5","254314"
"2013-10-12 05:42","LedgerCacheTest.java","14363","115705","130068","6","260136"
"2017-05-16 00:31","LedgerCacheTest.java","47882","106744","154626","","309252"
"2013-12-02 18:45","LedgerCacheTest.java","14556","118768","133324","6","266648"
"2014-07-24 01:41","LedgerCacheTest.java","15383","127752","143135","","286270"
"2012-06-06 18:13","LedgerCacheTest.java","1709","5775","7484","1","14968"
"2014-12-10 19:43","LedgerCacheTest.java","15778","137775","153553","","307106"
"2016-03-08 06:49","LedgerCacheTest.java","16231","144467","160698","","321396"
"2014-03-12 21:26","LedgerCacheTest.java","15079","124693","139772","7","279544"
"2012-12-08 11:18","LedgerCacheTest.java","10546","64901","75447","2","150894"
"2012-10-26 12:51","LedgerCacheTest.java","9964","54651","64615","2","129230"
"2017-05-15 19:52","ReadLacProcessorV3.java","2252","10598","12850","","25700"
"2017-05-16 00:31","ReadLacProcessorV3.java","2479","11243","13722","","27444"
"2014-01-21 05:19","PerChannelBookieClient.java","19077","143705","162782","6","325564"
"2013-10-22 07:35","PerChannelBookieClient.java","18990","139264","158254","6","316508"
"2012-05-17 16:05","PerChannelBookieClient.java","12359","34206","46565","1","93130"
"2012-05-26 19:16","PerChannelBookieClient.java","12494","34942","47436","1","94872"
"2014-01-09 07:30","PerChannelBookieClient.java","19059","142255","161314","6","322628"
"2017-06-30 00:12","PerChannelBookieClient.java","40775","126506","167281","","334562"
"2014-05-27 13:56","PerChannelBookieClient.java","19326","149472","168798","7","337596"
"2017-07-04 06:27","PerChannelBookieClient.java","40800","128492","169292","","338584"
"2012-07-23 23:39","PerChannelBookieClient.java","13967","47739","61706","2","123412"
"2012-08-13 11:38","PerChannelBookieClient.java","14330","53997","68327","2","136654"
"2011-11-17 11:16","PerChannelBookieClient.java","2842","4732","7574","","15148"
"2017-01-31 04:01","PerChannelBookieClient.java","40508","109426","149934","","299868"
"2015-10-06 10:05","PerChannelBookieClient.java","19680","163763","183443","","366886"
"2016-04-05 18:47","PerChannelBookieClient.java","40404","86784","127188","","254376"
"2012-02-01 12:06","PerChannelBookieClient.java","4334","11903","16237","1","32474"
"2011-11-16 17:05","PerChannelBookieClient.java","2605","3852","6457","","12914"
"2017-04-15 13:58","PerChannelBookieClient.java","40496","115106","155602","","311204"
"2017-05-15 19:52","PerChannelBookieClient.java","40654","117918","158572","","317144"
"2012-12-01 15:04","PerChannelBookieClient.java","17095","89854","106949","2","213898"
"2016-04-05 08:45","PerChannelBookieClient.java","40402","86540","126942","","253884"
"2017-07-28 20:12","PerChannelBookieClient.java","41035","133321","174356","","348712"
"2017-01-31 02:14","PerChannelBookieClient.java","40495","103944","144439","","288878"
"2017-03-28 22:35","PerChannelBookieClient.java","40493","114003","154496","","308992"
"2017-03-23 00:48","PerChannelBookieClient.java","40502","109760","150262","","300524"
"2013-01-10 19:13","PerChannelBookieClient.java","17767","97837","115604","2","231208"
"2014-07-25 00:34","PerChannelBookieClient.java","19607","156618","176225","","352450"
"2012-02-24 20:07","PerChannelBookieClient.java","4667","17001","21668","1","43336"
"2011-11-18 11:18","PerChannelBookieClient.java","3477","6655","10132","","20264"
"2017-08-02 00:49","PerChannelBookieClient.java","41431","147329","188760","","377520"
"2012-04-02 12:38","PerChannelBookieClient.java","11728","31054","42782","1","85564"
"2017-06-21 19:58","PerChannelBookieClient.java","40780","123367","164147","","328294"
"2017-06-01 23:58","PerChannelBookieClient.java","40760","121217","161977","","323954"
"2013-10-29 05:14","PerChannelBookieClient.java","19052","140117","159169","6","318338"
"2013-06-28 17:27","PerChannelBookieClient.java","18895","136661","155556","5","311112"
"2014-02-21 19:01","PerChannelBookieClient.java","19292","145886","165178","7","330356"
"2014-02-05 22:43","PerChannelBookieClient.java","19260","144691","163951","7","327902"
"2017-04-20 19:55","PerChannelBookieClient.java","40497","115128","155625","","311250"
"2013-09-11 00:34","PerChannelBookieClient.java","18934","138162","157096","5","314192"
"2013-08-20 12:51","PerChannelBookieClient.java","18923","137864","156787","5","313574"
"2017-05-15 19:52","BookieSocketAddress.java","8171","39055","47226","","94452"
"2016-10-13 07:50","BookieSocketAddress.java","5880","14862","20742","","41484"
"2016-12-17 02:44","AuditorLedgerCheckerTest.java","110566","24930","135496","","270992"
"2017-07-07 05:11","AuditorLedgerCheckerTest.java","114218","55869","170087","","340174"
"2017-10-17 09:32","AuditorLedgerCheckerTest.java","130873","87061","217934","","435868"
"2017-05-12 15:20","AuditorLedgerCheckerTest.java","111472","40210","151682","","303364"
"2017-03-22 22:54","Cookie.java","110918","54693","165611","","331222"
"2016-11-30 00:02","Cookie.java","110782","41698","152480","","304960"
"2014-05-09 14:04","Cookie.java","510","4664","5174","7","10348"
"2014-09-23 17:53","Cookie.java","2426","16728","19154","","38308"
"2014-09-18 06:57","Cookie.java","2408","16654","19062","","38124"
"2014-12-06 08:03","Cookie.java","2510","17731","20241","","40482"
"2017-06-30 00:12","PerChannelBookieClient.java","4415","21228","25643","","51286"
"2017-07-04 06:27","PerChannelBookieClient.java","4684","23458","28142","","56284"
"2017-04-15 13:58","PerChannelBookieClient.java","713","6405","7118","","14236"
"2017-05-15 19:52","PerChannelBookieClient.java","2252","10598","12850","","25700"
"2017-07-28 20:12","PerChannelBookieClient.java","6172","29540","35712","","71424"
"2017-03-28 22:35","PerChannelBookieClient.java","334","4926","5260","","10520"
"2017-03-23 00:48","PerChannelBookieClient.java","171","511","682","","1364"
"2017-08-02 00:49","PerChannelBookieClient.java","9319","46299","55618","","111236"
"2017-06-21 19:58","PerChannelBookieClient.java","4026","17695","21721","","43442"
"2017-06-01 23:58","PerChannelBookieClient.java","3520","15059","18579","","37158"
"2017-04-20 19:55","PerChannelBookieClient.java","726","6439","7165","","14330"
"2016-11-18 00:18","InterleavedLedgerStorage.java","111581","42477","154058","","308116"
"2017-05-16 00:31","InterleavedLedgerStorage.java","112808","65569","178377","","356754"
"2014-08-02 20:02","InterleavedLedgerStorage.java","2814","15534","18348","","36696"
"2017-07-04 06:27","InterleavedLedgerStorage.java","114243","77014","191257","","382514"
"2015-04-21 09:55","InterleavedLedgerStorage.java","3996","22138","26134","","52268"
"2017-01-31 04:01","InterleavedLedgerStorage.java","111655","55652","167307","","334614"
"2016-03-08 06:49","InterleavedLedgerStorage.java","5141","27276","32417","","64834"
"2017-03-28 22:37","InterleavedLedgerStorage.java","111795","60599","172394","","344788"
"2015-04-21 09:17","InterleavedLedgerStorage.java","3959","21930","25889","","51778"
"2017-06-30 00:12","DistributionSchedule.java","68690","100683","169373","","338746"
"2014-07-24 01:41","ConcurrentLedgerTest.java","19806","145073","164879","","329758"
"2014-12-10 19:43","ConcurrentLedgerTest.java","19992","154887","174879","","349758"
"2012-03-08 19:24","ConcurrentLedgerTest.java","1646","9173","10819","1","21638"
"2012-02-15 16:11","ConcurrentLedgerTest.java","1228","6873","8101","1","16202"
"2013-10-12 05:42","ConcurrentLedgerTest.java","19036","133276","152312","6","304624"
"2014-02-05 22:43","ConcurrentLedgerTest.java","19520","139029","158549","7","317098"
"2017-05-16 00:31","ConcurrentLedgerTest.java","42569","114329","156898","","313796"
"2017-06-21 19:58","PendingReadOp.java","1939","7262","9201","","18402"
"2017-06-05 21:48","PendingReadOp.java","1589","5524","7113","","14226"
"2017-06-05 22:13","PendingReadOp.java","1598","5946","7544","","15088"
"2017-06-01 11:42","PendingReadOp.java","482","3708","4190","","8380"
"2017-06-01 22:39","PendingReadOp.java","1212","4020","5232","","10464"
"2017-07-04 06:27","PendingReadOp.java","2652","13080","15732","","31464"
"2013-10-12 05:42","TestLedgerUnderreplicationManager.java","1664","8469","10133","6","20266"
"2015-07-10 22:48","TestLedgerUnderreplicationManager.java","5389","35489","40878","","81756"
"2016-11-18 00:18","InterleavedLedgerStorage.java","112544","49122","161666","","323332"
"2013-12-02 18:45","InterleavedLedgerStorage.java","1529","5322","6851","6","13702"
"2014-01-15 15:58","InterleavedLedgerStorage.java","1618","5755","7373","6","14746"
"2014-01-21 17:26","InterleavedLedgerStorage.java","2041","7723","9764","6","19528"
"2017-05-16 00:31","InterleavedLedgerStorage.java","113660","72103","185763","","371526"
"2014-08-02 20:02","InterleavedLedgerStorage.java","4362","22764","27126","","54252"
"2017-07-04 06:27","InterleavedLedgerStorage.java","114959","83412","198371","","396742"
"2015-04-21 09:55","InterleavedLedgerStorage.java","5284","29108","34392","","68784"
"2017-01-31 04:01","InterleavedLedgerStorage.java","112606","62285","174891","","349782"
"2016-03-08 06:49","InterleavedLedgerStorage.java","6286","34103","40389","","80778"
"2017-03-28 22:37","InterleavedLedgerStorage.java","112707","67193","179900","","359800"
"2015-04-21 09:17","InterleavedLedgerStorage.java","5264","28917","34181","","68362"
"2016-07-11 23:01","LedgerCreateOp.java","42652","83145","125797","","251594"
"2014-02-05 22:43","LedgerCreateOp.java","19113","137144","156257","7","312514"
"2014-01-21 05:19","LedgerCreateOp.java","18827","136055","154882","6","309764"
"2012-06-19 12:39","LedgerCreateOp.java","10420","27809","38229","2","76458"
"2015-09-15 10:38","LedgerCreateOp.java","19790","156149","175939","","351878"
"2015-04-21 09:17","LedgerCreateOp.java","19602","155094","174696","","349392"
"2015-10-22 09:22","LedgerCreateOp.java","19803","157542","177345","","354690"
"2017-06-12 17:20","LedgerManagerTestCase.java","4315","30732","35047","","70094"
"2017-05-16 00:31","LedgerManagerTestCase.java","2889","24754","27643","","55286"
"2017-01-31 04:01","LedgerManagerTestCase.java","779","13880","14659","","29318"
"2017-03-28 22:37","LedgerManagerTestCase.java","1057","18965","20022","","40044"
"2017-07-04 06:27","LedgerManagerTestCase.java","4948","36823","41771","","83542"
"2017-05-09 23:06","GarbageCollectorThread.java","7311","36146","43457","","86914"
"2017-11-08 12:27","GarbageCollectorThread.java","29479","96443","125922","","251844"
"2017-03-28 22:39","GarbageCollectorThread.java","6662","33441","40103","","80206"
"2017-01-30 23:25","GarbageCollectorThread.java","5878","21692","27570","","55140"
"2017-08-02 00:49","BookieNettyServer.java","116036","110652","226688","","453376"
"2013-10-02 06:23","BookieNettyServer.java","1523","9480","11003","5","22006"
"2013-06-15 19:05","BookieNettyServer.java","1180","7355","8535","5","17070"
"2017-06-01 09:47","BookieNettyServer.java","111790","80737","192527","","385054"
"2013-10-11 16:18","BookieNettyServer.java","2401","10754","13155","6","26310"
"2017-05-15 19:52","BookieNettyServer.java","111646","77628","189274","","378548"
"2016-09-10 20:27","BookieNettyServer.java","110661","51255","161916","","323832"
"2017-01-31 02:14","BookieNettyServer.java","110822","62989","173811","","347622"
"2016-04-05 08:45","BookieNettyServer.java","109189","44045","153234","","306468"
"2017-03-23 00:48","BookieNettyServer.java","110915","68891","179806","","359612"
"2016-04-05 18:47","BookieNettyServer.java","109191","44289","153480","","306960"
"2014-01-21 05:05","BookieNettyServer.java","3224","16224","19448","6","38896"
"2017-08-16 03:37","BookieServer.java","8421","37093","45514","","91028"
"2017-08-02 00:49","BookieServer.java","5929","27968","33897","","67794"
"2017-10-17 09:32","BookieServer.java","33029","53079","86108","","172216"
"2017-07-04 06:27","FileInfo.java","4684","23458","28142","","56284"
"2017-03-23 15:55","FileInfo.java","201","567","768","","1536"
"2017-06-01 23:58","FileInfo.java","3520","15059","18579","","37158"
"2017-07-17 23:27","FileInfo.java","4958","26839","31797","","63594"
"2017-05-16 00:31","FileInfo.java","2479","11243","13722","","27444"
"2017-06-01 23:58","EntryLogger.java","80497","87680","168177","","336354"
"2014-01-21 17:26","EntryLogger.java","6320","57967","64287","6","128574"
"2013-10-02 06:23","EntryLogger.java","4933","50898","55831","5","111662"
"2014-01-22 14:35","EntryLogger.java","6448","58471","64919","6","129838"
"2017-11-08 12:27","EntryLogger.java","90849","131504","222353","","444706"
"2013-10-22 07:44","EntryLogger.java","5938","53199","59137","6","118274"
"2013-05-04 14:22","EntryLogger.java","4423","44077","48500","5","97000"
"2017-01-31 02:11","EntryLogger.java","79005","68568","147573","","295146"
"2017-03-23 00:48","EntryLogger.java","79095","75079","154174","","308348"
"2016-07-14 23:02","EntryLogger.java","77811","52464","130275","","260550"
"2012-12-24 06:23","EntryLogger.java","1292","5875","7167","2","14334"
"2016-02-24 00:44","EntryLogger.java","9023","82453","91476","","182952"
"2015-04-21 10:02","EntryLogger.java","8274","78096","86370","","172740"
"2013-01-04 11:32","EntryLogger.java","2028","8002","10030","2","20060"
"2015-04-21 09:44","EntryLogger.java","8276","77914","86190","","172380"
"2017-07-04 06:27","InterleavedLedgerStorage.java","2419","12429","14848","","29696"
"2012-12-13 12:33","LedgerRecoveryTest.java","16447","89126","105573","2","211146"
"2013-01-07 12:25","LedgerRecoveryTest.java","16809","94379","111188","2","222376"
"2012-02-13 15:46","LedgerRecoveryTest.java","2237","11902","14139","1","28278"
"2012-01-17 16:52","LedgerRecoveryTest.java","1850","7233","9083","1","18166"
"2013-06-12 18:41","LedgerRecoveryTest.java","18220","133360","151580","5","303160"
"2013-03-25 18:02","LedgerRecoveryTest.java","18019","128334","146353","4","292706"
"2014-02-05 22:43","LedgerRecoveryTest.java","18772","142313","161085","7","322170"
"2017-05-16 00:31","LedgerRecoveryTest.java","40748","116540","157288","","314576"
"2017-06-21 19:50","LedgerRecoveryTest.java","40875","121462","162337","","324674"
"2014-07-24 01:41","ConcurrentLedgerTest.java","16126","154131","170257","","340514"
"2014-12-10 19:43","ConcurrentLedgerTest.java","16175","163808","179983","","359966"
"2011-11-17 11:16","ConcurrentLedgerTest.java","7104","15810","22914","","45828"
"2011-09-05 19:38","ConcurrentLedgerTest.java","4728","11093","15821","","31642"
"2011-11-28 19:25","ConcurrentLedgerTest.java","7878","20616","28494","","56988"
"2011-11-18 11:18","ConcurrentLedgerTest.java","7652","17646","25298","","50596"
"2012-03-08 19:24","ConcurrentLedgerTest.java","8724","28989","37713","1","75426"
"2012-02-15 16:11","ConcurrentLedgerTest.java","8487","26870","35357","1","70714"
"2013-10-12 05:42","ConcurrentLedgerTest.java","15717","142695","158412","6","316824"
"2014-02-05 22:43","ConcurrentLedgerTest.java","15926","148173","164099","7","328198"
"2017-05-16 00:31","ConcurrentLedgerTest.java","35872","120370","156242","","312484"
"2013-08-21 13:19","BookKeeperAdmin.java","9573","95002","104575","5","209150"
"2017-10-17 09:32","BookKeeperAdmin.java","61238","131443","192681","","385362"
"2017-06-01 23:58","BookKeeperAdmin.java","55242","101995","157237","","314474"
"2017-04-11 20:19","BookKeeperAdmin.java","54104","94372","148476","","296952"
"2014-02-21 19:01","BookKeeperAdmin.java","11311","104201","115512","7","231024"
"2014-02-05 22:43","BookKeeperAdmin.java","11220","102947","114167","7","228334"
"2017-07-07 05:11","BookKeeperAdmin.java","55394","111062","166456","","332912"
"2013-02-26 04:12","BookKeeperAdmin.java","8836","86569","95405","4","190810"
"2016-11-09 03:05","BookKeeperAdmin.java","53963","75941","129904","","259808"
"2016-11-30 00:07","BookKeeperAdmin.java","53967","76609","130576","","261152"
"2016-09-10 21:01","BookKeeperAdmin.java","53882","72175","126057","","252114"
"2016-07-14 23:02","BookKeeperAdmin.java","53482","67705","121187","","242374"
"2016-10-13 09:27","BookKeeperAdmin.java","53963","75607","129570","","259140"
"2012-11-30 04:54","BookKeeperAdmin.java","5665","44554","50219","2","100438"
"2013-02-08 19:08","BookKeeperAdmin.java","7987","85692","93679","4","187358"
"2016-03-16 05:03","BookKeeperAdmin.java","53321","63052","116373","","232746"
"2016-03-08 07:18","BookKeeperAdmin.java","12717","126734","139451","","278902"
"2014-12-06 08:03","BookKeeperAdmin.java","11910","118858","130768","","261536"
"2012-09-03 18:54","BookKeeperAdmin.java","1617","19660","21277","2","42554"
"2014-04-24 10:43","BookKeeperAdmin.java","11324","106186","117510","7","235020"
"2012-10-05 16:24","BookKeeperAdmin.java","4318","29430","33748","2","67496"
"2012-09-07 07:04","BookKeeperAdmin.java","1738","21247","22985","2","45970"
"2014-09-06 07:51","BookKeeperAdmin.java","11825","117636","129461","","258922"
"2012-08-19 11:39","BookKeeperAdmin.java","1355","13539","14894","2","29788"
"2013-05-10 12:45","BookKeeperAdmin.java","9332","88886","98218","5","196436"
"2012-08-24 22:44","BookKeeperAdmin.java","1358","14434","15792","2","31584"
"2017-07-28 20:12","BookieConnectionPeer.java","5908","34745","40653","","81306"
"2017-06-30 00:12","PerChannelBookieClient.java","114336","55984","170320","","340640"
"2017-07-04 06:27","PerChannelBookieClient.java","114520","58129","172649","","345298"
"2017-01-31 04:01","PerChannelBookieClient.java","111029","35864","146893","","293786"
"2016-04-05 18:47","PerChannelBookieClient.java","105307","7604","112911","","225822"
"2017-04-15 13:58","PerChannelBookieClient.java","111514","42041","153555","","307110"
"2017-05-15 19:52","PerChannelBookieClient.java","112499","45680","158179","","316358"
"2016-04-05 08:45","PerChannelBookieClient.java","105296","7351","112647","","225294"
"2017-07-28 20:12","PerChannelBookieClient.java","115727","63930","179657","","359314"
"2017-01-31 02:14","PerChannelBookieClient.java","111001","30367","141368","","282736"
"2017-03-28 22:35","PerChannelBookieClient.java","111228","40655","151883","","303766"
"2017-03-23 00:48","PerChannelBookieClient.java","111167","36342","147509","","295018"
"2017-08-02 00:49","PerChannelBookieClient.java","118417","80232","198649","","397298"
"2017-06-21 19:58","PerChannelBookieClient.java","114006","52510","166516","","333032"
"2017-06-01 23:58","PerChannelBookieClient.java","113567","49941","163508","","327016"
"2017-04-20 19:55","PerChannelBookieClient.java","111525","42073","153598","","307196"
"2017-05-15 19:52","ReadEntryProcessor.java","112499","45680","158179","","316358"
"2017-06-01 23:58","ReadEntryProcessor.java","113567","49941","163508","","327016"
"2017-05-16 00:31","ReadEntryProcessor.java","112662","46261","158923","","317846"
"2017-06-21 19:58","PendingReadOp.java","79802","94480","174282","","348564"
"2017-06-05 21:48","PendingReadOp.java","79753","93043","172796","","345592"
"2017-06-05 22:13","PendingReadOp.java","79754","93457","173211","","346422"
"2017-06-01 11:42","PendingReadOp.java","79075","91656","170731","","341462"
"2017-06-01 22:39","PendingReadOp.java","79665","91828","171493","","342986"
"2013-09-11 00:34","PendingReadOp.java","6605","57924","64529","5","129058"
"2014-02-05 22:43","PendingReadOp.java","8600","66122","74722","7","149444"
"2013-03-25 18:02","PendingReadOp.java","5861","50157","56018","4","112036"
"2017-05-15 19:52","PendingReadOp.java","78905","88260","167165","","334330"
"2015-04-21 09:17","PendingReadOp.java","9827","84810","94637","","189274"
"2012-12-03 10:46","PendingReadOp.java","436","5804","6240","2","12480"
"2016-02-09 08:39","PendingReadOp.java","10439","88761","99200","","198400"
"2016-02-09 08:32","PendingReadOp.java","10439","88704","99143","","198286"
"2012-12-13 13:07","PendingReadOp.java","2124","9314","11438","2","22876"
"2017-07-04 06:27","PendingReadOp.java","79996","99779","179775","","359550"
"2014-01-21 05:19","PendingReadOp.java","7891","64610","72501","6","145002"
"2017-07-07 05:11","ZkLedgerUnderreplicationManager.java","680","5701","6381","","12762"
"2015-04-21 09:23","Journal.java","135","371","506","","1012"
"2016-02-09 08:30","Journal.java","1433","4936","6369","","12738"
"2017-05-26 16:52","Journal.java","113613","50553","164166","","328332"
"2017-03-22 22:54","Journal.java","112124","38670","150794","","301588"
"2016-11-12 03:37","Journal.java","111920","24973","136893","","273786"
"2016-07-14 23:02","Journal.java","106837","12104","118941","","237882"
"2017-06-01 23:58","Journal.java","114434","52231","166665","","333330"
"2017-05-09 22:24","Journal.java","112850","45992","158842","","317684"
"2017-05-16 00:31","Journal.java","113548","48570","162118","","324236"
"2017-06-01 23:58","LongZkLedgerIdGenerator.java","2460","7143","9603","","19206"
"2012-12-18 13:04","LedgerDescriptorImpl.java","10762","68600","79362","2","158724"
"2016-11-18 00:18","LedgerDescriptorImpl.java","47444","83572","131016","","262032"
"2017-05-16 00:31","LedgerDescriptorImpl.java","48024","106017","154041","","308082"
"2017-07-04 06:27","LedgerDescriptorImpl.java","48796","116799","165595","","331190"
"2017-06-05 22:25","LedgerDescriptorImpl.java","48680","110897","159577","","319154"
"2017-01-31 04:01","LedgerDescriptorImpl.java","47489","96718","144207","","288414"
"2017-03-22 22:54","Cookie.java","111482","51103","162585","","325170"
"2016-11-30 00:02","Cookie.java","111328","38090","149418","","298836"
"2014-09-23 17:53","Cookie.java","2169","12317","14486","","28972"
"2014-09-18 06:57","Cookie.java","2151","12243","14394","","28788"
"2014-12-06 08:03","Cookie.java","2253","13320","15573","","31146"
"2015-04-21 09:17","PendingAddOp.java","4052","22316","26368","","52736"
"2015-10-06 10:48","PendingAddOp.java","4842","24523","29365","","58730"
"2015-10-22 09:22","PendingAddOp.java","4870","25381","30251","","60502"
"2017-06-30 00:12","PendingAddOp.java","114143","75246","189389","","378778"
"2014-02-21 19:01","PendingAddOp.java","1382","3348","4730","7","9460"
"2014-02-05 22:43","PendingAddOp.java","1184","1987","3171","7","6342"
"2017-08-02 00:49","PendingAddOp.java","117758","99028","216786","","433572"
"2017-05-15 19:52","PendingAddOp.java","112723","65359","178082","","356164"
"2014-01-21 05:19","PerChannelBookieClient.java","19001","144080","163081","6","326162"
"2013-10-22 07:35","PerChannelBookieClient.java","18918","139643","158561","6","317122"
"2012-05-17 16:05","PerChannelBookieClient.java","12440","34738","47178","1","94356"
"2012-05-26 19:16","PerChannelBookieClient.java","12571","35470","48041","1","96082"
"2014-01-09 07:30","PerChannelBookieClient.java","18987","142634","161621","6","323242"
"2017-06-30 00:12","PerChannelBookieClient.java","40530","126712","167242","","334484"
"2014-05-27 13:56","PerChannelBookieClient.java","19218","149815","169033","7","338066"
"2017-07-04 06:27","PerChannelBookieClient.java","40546","128689","169235","","338470"
"2012-07-23 23:39","PerChannelBookieClient.java","13991","48214","62205","2","124410"
"2012-08-13 11:38","PerChannelBookieClient.java","14333","54451","68784","2","137568"
"2011-11-17 11:16","PerChannelBookieClient.java","2969","5310","8279","","16558"
"2011-09-16 16:55","PerChannelBookieClient.java","19","22","41","","82"
"2011-10-27 15:41","PerChannelBookieClient.java","147","598","745","","1490"
"2017-01-31 04:01","PerChannelBookieClient.java","40292","109661","149953","","299906"
"2015-10-06 10:05","PerChannelBookieClient.java","19469","164003","183472","","366944"
"2016-04-05 18:47","PerChannelBookieClient.java","40192","87023","127215","","254430"
"2012-02-01 12:06","PerChannelBookieClient.java","4431","12451","16882","1","33764"
"2011-11-16 17:05","PerChannelBookieClient.java","2735","4433","7168","","14336"
"2017-04-15 13:58","PerChannelBookieClient.java","40280","115341","155621","","311242"
"2017-05-15 19:52","PerChannelBookieClient.java","40437","118152","158589","","317178"
"2012-12-01 15:04","PerChannelBookieClient.java","17079","90289","107368","2","214736"
"2016-04-05 08:45","PerChannelBookieClient.java","40190","86779","126969","","253938"
"2017-07-28 20:12","PerChannelBookieClient.java","40782","133519","174301","","348602"
"2017-01-31 02:14","PerChannelBookieClient.java","40280","104180","144460","","288920"
"2017-03-28 22:35","PerChannelBookieClient.java","40277","114238","154515","","309030"
"2017-03-23 00:48","PerChannelBookieClient.java","40286","109995","150281","","300562"
"2013-01-10 19:13","PerChannelBookieClient.java","17744","98265","116009","2","232018"
"2014-07-25 00:34","PerChannelBookieClient.java","19399","156861","176260","","352520"
"2012-02-24 20:07","PerChannelBookieClient.java","4753","17538","22291","1","44582"
"2011-11-18 11:18","PerChannelBookieClient.java","3592","7221","10813","","21626"
"2017-08-02 00:49","PerChannelBookieClient.java","41168","147517","188685","","377370"
"2012-04-02 12:38","PerChannelBookieClient.java","11814","31591","43405","1","86810"
"2017-06-21 19:58","PerChannelBookieClient.java","40535","123573","164108","","328216"
"2017-06-01 23:58","PerChannelBookieClient.java","40516","121424","161940","","323880"
"2013-10-29 05:14","PerChannelBookieClient.java","18980","140496","159476","6","318952"
"2013-06-28 17:27","PerChannelBookieClient.java","18833","137050","155883","5","311766"
"2014-02-21 19:01","PerChannelBookieClient.java","19192","146237","165429","7","330858"
"2014-02-05 22:43","PerChannelBookieClient.java","19159","145041","164200","7","328400"
"2017-04-20 19:55","PerChannelBookieClient.java","40281","115363","155644","","311288"
"2013-09-11 00:34","PerChannelBookieClient.java","18868","138547","157415","5","314830"
"2013-08-20 12:51","PerChannelBookieClient.java","18861","138253","157114","5","314228"
"2017-06-30 00:12","PerChannelBookieClient.java","10147","49498","59645","","119290"
"2017-07-04 06:27","PerChannelBookieClient.java","10341","51653","61994","","123988"
"2017-01-31 04:01","PerChannelBookieClient.java","6651","29189","35840","","71680"
"2017-04-15 13:58","PerChannelBookieClient.java","7058","35288","42346","","84692"
"2017-05-15 19:52","PerChannelBookieClient.java","8171","39055","47226","","94452"
"2017-07-28 20:12","PerChannelBookieClient.java","11608","57514","69122","","138244"
"2017-01-31 02:14","PerChannelBookieClient.java","6596","23665","30261","","60522"
"2017-03-28 22:35","PerChannelBookieClient.java","6848","33978","40826","","81652"
"2017-03-23 00:48","PerChannelBookieClient.java","6791","29669","36460","","72920"
"2017-08-02 00:49","PerChannelBookieClient.java","14665","74183","88848","","177696"
"2017-06-21 19:58","PerChannelBookieClient.java","9803","46010","55813","","111626"
"2017-06-01 23:58","PerChannelBookieClient.java","9308","43385","52693","","105386"
"2017-04-20 19:55","PerChannelBookieClient.java","7069","35320","42389","","84778"
"2014-01-21 05:19","PerChannelBookieClient.java","18877","135936","154813","6","309626"
"2013-10-22 07:35","PerChannelBookieClient.java","18726","131431","150157","6","300314"
"2012-05-17 16:05","PerChannelBookieClient.java","9534","23812","33346","1","66692"
"2012-05-26 19:16","PerChannelBookieClient.java","9737","24616","34353","1","68706"
"2014-01-09 07:30","PerChannelBookieClient.java","18807","134434","153241","6","306482"
"2017-06-30 00:12","PerChannelBookieClient.java","43499","121661","165160","","330320"
"2014-05-27 13:56","PerChannelBookieClient.java","19262","141839","161101","7","322202"
"2017-07-04 06:27","PerChannelBookieClient.java","43535","123658","167193","","334386"
"2012-07-23 23:39","PerChannelBookieClient.java","12205","38408","50613","2","101226"
"2012-08-13 11:38","PerChannelBookieClient.java","12623","44721","57344","2","114688"
"2017-01-31 04:01","PerChannelBookieClient.java","42841","104190","147031","","294062"
"2015-10-06 10:05","PerChannelBookieClient.java","19861","156375","176236","","352472"
"2016-04-05 18:47","PerChannelBookieClient.java","42664","81475","124139","","248278"
"2017-04-15 13:58","PerChannelBookieClient.java","42855","109896","152751","","305502"
"2017-05-15 19:52","PerChannelBookieClient.java","43215","112910","156125","","312250"
"2012-12-01 15:04","PerChannelBookieClient.java","16151","81341","97492","2","194984"
"2016-04-05 08:45","PerChannelBookieClient.java","42662","81231","123893","","247786"
"2017-07-28 20:12","PerChannelBookieClient.java","43831","128548","172379","","344758"
"2017-01-31 02:14","PerChannelBookieClient.java","42825","98705","141530","","283060"
"2017-03-28 22:35","PerChannelBookieClient.java","42843","108784","151627","","303254"
"2017-03-23 00:48","PerChannelBookieClient.java","42847","104536","147383","","294766"
"2013-01-10 19:13","PerChannelBookieClient.java","17205","89706","106911","2","213822"
"2014-07-25 00:34","PerChannelBookieClient.java","19620","149062","168682","","337364"
"2012-02-24 20:07","PerChannelBookieClient.java","562","5327","5889","1","11778"
"2017-08-02 00:49","PerChannelBookieClient.java","44231","142560","186791","","373582"
"2012-04-02 12:38","PerChannelBookieClient.java","8668","20425","29093","1","58186"
"2017-06-21 19:58","PerChannelBookieClient.java","43494","118512","162006","","324012"
"2017-06-01 23:58","PerChannelBookieClient.java","43453","116341","159794","","319588"
"2013-10-29 05:14","PerChannelBookieClient.java","18801","132297","151098","6","302196"
"2013-06-28 17:27","PerChannelBookieClient.java","18541","128738","147279","5","294558"
"2014-02-21 19:01","PerChannelBookieClient.java","19221","138246","157467","7","314934"
"2014-02-05 22:43","PerChannelBookieClient.java","19182","137044","156226","7","312452"
"2017-04-20 19:55","PerChannelBookieClient.java","42856","109918","152774","","305548"
"2013-09-11 00:34","PerChannelBookieClient.java","18612","130271","148883","5","297766"
"2013-08-20 12:51","PerChannelBookieClient.java","18581","129953","148534","5","297068"
"2017-07-04 06:27","ServerConfiguration.java","115326","59955","175281","","350562"
"2016-04-14 00:51","ServerConfiguration.java","106257","9624","115881","","231762"
"2016-03-08 06:49","ServerConfiguration.java","1555","5548","7103","","14206"
"2016-01-26 22:11","ServerConfiguration.java","1160","4139","5299","","10598"
"2016-04-05 18:47","ServerConfiguration.java","106231","9548","115779","","231558"
"2016-04-27 09:55","ServerConfiguration.java","106318","10197","116515","","233030"
"2017-05-15 19:52","ServerConfiguration.java","113312","47513","160825","","321650"
"2017-03-22 22:54","ServerConfiguration.java","112026","38169","150195","","300390"
"2017-03-23 00:48","ServerConfiguration.java","112031","38226","150257","","300514"
"2017-01-31 02:11","ServerConfiguration.java","111895","31669","143564","","287128"
"2016-04-05 08:45","ServerConfiguration.java","106220","9295","115515","","231030"
"2016-11-09 03:02","ServerConfiguration.java","111781","24383","136164","","272328"
"2016-11-30 00:02","ServerConfiguration.java","111845","25129","136974","","273948"
"2017-06-05 20:30","ServerConfiguration.java","114488","52240","166728","","333456"
"2016-09-10 20:27","ServerConfiguration.java","110140","18953","129093","","258186"
"2017-08-02 00:49","ServerConfiguration.java","119222","82057","201279","","402558"
"2017-10-03 12:31","ServerConfiguration.java","130569","83561","214130","","428260"
"2017-08-16 03:37","ServerConfiguration.java","121485","90953","212438","","424876"
"2017-05-26 12:38","ServerConfiguration.java","113533","50050","163583","","327166"
"2017-07-07 08:19","ServerConfiguration.java","115376","61968","177344","","354688"
"2017-06-28 23:24","ServerConfiguration.java","114849","55645","170494","","340988"
"2017-11-08 12:27","ServerConfiguration.java","132826","103692","236518","","473036"
"2016-04-27 21:11","ZkLedgerUnderreplicationManager.java","109609","39094","148703","","297406"
"2016-07-14 23:02","ZkLedgerUnderreplicationManager.java","109862","40332","150194","","300388"
"2017-07-07 05:11","ZkLedgerUnderreplicationManager.java","114830","86745","201575","","403150"
"2013-08-22 16:40","ZkLedgerUnderreplicationManager.java","398","2088","2486","5","4972"
"2017-06-28 23:28","ZkLedgerUnderreplicationManager.java","114598","81492","196090","","392180"
"2017-06-01 23:58","ZkLedgerUnderreplicationManager.java","114345","77345","191690","","383380"
"2014-08-18 23:03","ZkLedgerUnderreplicationManager.java","5006","26658","31664","","63328"
"2014-06-03 12:35","ZkLedgerUnderreplicationManager.java","4014","17729","21743","7","43486"
"2014-06-02 11:54","ZkLedgerUnderreplicationManager.java","3994","17241","21235","7","42470"
"2017-03-28 22:40","ZkLedgerUnderreplicationManager.java","112747","69243","181990","","363980"
"2016-04-27 09:55","ZkLedgerUnderreplicationManager.java","109609","39094","148703","","297406"
"2017-07-07 05:11","ZkLedgerUnderreplicationManager.java","1305","10220","11525","","23050"
"2017-06-28 23:28","ZkLedgerUnderreplicationManager.java","644","4538","5182","","10364"
"2016-07-14 23:02","MetastoreTable.java","108503","26527","135030","","270060"
"2017-07-04 06:27","FileInfo.java","40546","128689","169235","","338470"
"2012-10-26 12:51","FileInfo.java","16945","80903","97848","2","195696"
"2011-11-17 11:16","FileInfo.java","2969","5310","8279","","16558"
"2014-12-04 12:28","FileInfo.java","19405","160141","179546","","359092"
"2011-11-04 11:46","FileInfo.java","2143","2215","4358","","8716"
"2017-01-31 04:01","FileInfo.java","40292","109661","149953","","299906"
"2017-03-23 15:55","FileInfo.java","40287","110022","150309","","300618"
"2016-11-18 00:18","FileInfo.java","40276","96544","136820","","273640"
"2012-12-18 13:04","FileInfo.java","17339","95317","112656","2","225312"
"2013-05-04 14:22","FileInfo.java","18739","132118","150857","5","301714"
"2012-02-09 18:14","FileInfo.java","4513","16272","20785","1","41570"
"2012-02-17 11:18","FileInfo.java","4626","16840","21466","1","42932"
"2012-02-24 19:20","FileInfo.java","4713","17492","22205","1","44410"
"2012-06-13 16:57","FileInfo.java","12599","37073","49672","","99344"
"2012-03-29 15:18","FileInfo.java","11830","30631","42461","1","84922"
"2017-06-01 23:58","FileInfo.java","40516","121424","161940","","323880"
"2017-07-17 23:27","FileInfo.java","40553","131803","172356","","344712"
"2017-05-16 00:31","FileInfo.java","40457","118590","159047","","318094"
"2013-10-22 16:21","FileInfo.java","18973","140353","159326","6","318652"
"2013-10-11 08:36","FileInfo.java","18886","138958","157844","6","315688"
"2012-10-05 16:24","LedgerFragment.java","3002","7886","10888","2","21776"
"2012-11-30 04:54","LedgerFragment.java","4665","23326","27991","2","55982"
"2014-02-05 22:43","LedgerFragment.java","11016","82515","93531","7","187062"
"2017-07-04 06:27","ServerConfiguration.java","115328","61336","176664","","353328"
"2016-04-14 00:51","ServerConfiguration.java","106379","11125","117504","","235008"
"2015-01-16 15:57","ServerConfiguration.java","16","954","970","","1940"
"2016-03-08 06:49","ServerConfiguration.java","1716","7088","8804","","17608"
"2016-01-26 22:11","ServerConfiguration.java","1354","5712","7066","","14132"
"2016-04-05 18:47","ServerConfiguration.java","106353","11049","117402","","234804"
"2016-04-27 09:55","ServerConfiguration.java","106440","11698","118138","","236276"
"2015-04-21 09:55","ServerConfiguration.java","197","1576","1773","","3546"
"2015-04-21 10:02","ServerConfiguration.java","210","1622","1832","","3664"
"2017-05-15 19:52","ServerConfiguration.java","113359","48939","162298","","324596"
"2017-03-22 22:54","ServerConfiguration.java","112092","39614","151706","","303412"
"2017-03-23 00:48","ServerConfiguration.java","112097","39671","151768","","303536"
"2017-01-31 02:11","ServerConfiguration.java","111965","33118","145083","","290166"
"2016-04-05 08:45","ServerConfiguration.java","106342","10796","117138","","234276"
"2016-11-09 03:02","ServerConfiguration.java","111852","25833","137685","","275370"
"2016-11-30 00:02","ServerConfiguration.java","111915","26578","138493","","276986"
"2017-06-05 20:30","ServerConfiguration.java","114521","53652","168173","","336346"
"2016-09-10 20:27","ServerConfiguration.java","110216","20408","130624","","261248"
"2017-08-02 00:49","ServerConfiguration.java","119164","83378","202542","","405084"
"2017-10-03 12:31","ServerConfiguration.java","130468","84839","215307","","430614"
"2017-08-16 03:37","ServerConfiguration.java","121393","92240","213633","","427266"
"2017-05-26 12:38","ServerConfiguration.java","113575","51471","165046","","330092"
"2017-07-07 08:19","ServerConfiguration.java","115377","63348","178725","","357450"
"2017-06-28 23:24","ServerConfiguration.java","114865","57040","171905","","343810"
"2017-11-08 12:27","ServerConfiguration.java","132668","104913","237581","","475162"
"2017-07-04 06:27","ServerConfiguration.java","115315","59911","175226","","350452"
"2016-04-14 00:51","ServerConfiguration.java","106244","9578","115822","","231644"
"2016-03-08 06:49","ServerConfiguration.java","1542","5502","7044","","14088"
"2016-01-26 22:11","ServerConfiguration.java","1147","4093","5240","","10480"
"2016-04-05 18:47","ServerConfiguration.java","106218","9502","115720","","231440"
"2016-04-27 09:55","ServerConfiguration.java","106305","10151","116456","","232912"
"2017-05-15 19:52","ServerConfiguration.java","113301","47469","160770","","321540"
"2017-03-22 22:54","ServerConfiguration.java","112015","38125","150140","","300280"
"2017-03-23 00:48","ServerConfiguration.java","112020","38182","150202","","300404"
"2017-01-31 02:11","ServerConfiguration.java","111884","31625","143509","","287018"
"2016-04-05 08:45","ServerConfiguration.java","106207","9249","115456","","230912"
"2016-11-09 03:02","ServerConfiguration.java","111770","24339","136109","","272218"
"2016-11-30 00:02","ServerConfiguration.java","111834","25085","136919","","273838"
"2017-06-05 20:30","ServerConfiguration.java","114477","52196","166673","","333346"
"2016-09-10 20:27","ServerConfiguration.java","110129","18909","129038","","258076"
"2017-08-02 00:49","ServerConfiguration.java","119211","82013","201224","","402448"
"2017-10-03 12:31","ServerConfiguration.java","130558","83517","214075","","428150"
"2017-08-16 03:37","ServerConfiguration.java","121474","90909","212383","","424766"
"2017-05-26 12:38","ServerConfiguration.java","113522","50006","163528","","327056"
"2017-07-07 08:19","ServerConfiguration.java","115365","61924","177289","","354578"
"2017-06-28 23:24","ServerConfiguration.java","114838","55601","170439","","340878"
"2017-11-08 12:27","ServerConfiguration.java","132817","103650","236467","","472934"
"2012-12-08 11:18","Bookie.java","9906","61942","71848","2","143696"
"2012-09-14 15:42","Bookie.java","6557","39292","45849","2","91698"
"2012-10-25 15:35","Bookie.java","9293","51272","60565","2","121130"
"2012-10-26 16:25","Bookie.java","9485","52413","61898","2","123796"
"2017-01-31 04:01","Bookie.java","47763","95542","143305","","286610"
"2017-03-28 22:37","Bookie.java","47811","100397","148208","","296416"
"2016-01-26 22:11","Bookie.java","15886","140789","156675","","313350"
"2015-03-18 07:38","Bookie.java","15615","137266","152881","","305762"
"2015-04-21 09:17","Bookie.java","15615","137368","152983","","305966"
"2012-10-18 16:40","Bookie.java","9185","50027","59212","2","118424"
"2012-12-03 17:59","Bookie.java","9767","61758","71525","2","143050"
"2012-07-04 16:17","Bookie.java","2931","12168","15099","2","30198"
"2012-07-23 23:39","Bookie.java","4751","17384","22135","2","44270"
"2013-06-21 19:26","Bookie.java","13243","109688","122931","5","245862"
"2012-09-07 07:04","Bookie.java","6130","38204","44334","2","88668"
"2014-09-23 17:53","Bookie.java","15407","134001","149408","","298816"
"2017-07-04 06:27","Bookie.java","49074","115627","164701","","329402"
"2017-06-05 22:25","Bookie.java","48958","109725","158683","","317366"
"2014-02-06 09:25","Bookie.java","14784","119084","133868","7","267736"
"2014-04-29 22:07","Bookie.java","14897","122702","137599","7","275198"
"2013-12-06 07:39","Bookie.java","14289","116334","130623","6","261246"
"2012-07-05 14:45","Bookie.java","2948","12667","15615","2","31230"
"2014-08-02 20:02","Bookie.java","15344","131846","147190","","294380"
"2013-10-02 07:01","Bookie.java","13382","111672","125054","5","250108"
"2012-06-19 12:39","Bookie.java","1445","5095","6540","2","13080"
"2017-06-28 23:24","Bookie.java","48999","111719","160718","","321436"
"2017-07-07 08:19","Bookie.java","49070","117586","166656","","333312"
"2013-09-11 00:34","Bookie.java","13355","111444","124799","5","249598"
"2014-01-21 17:26","Bookie.java","14396","118178","132574","6","265148"
"2013-10-12 05:42","Bookie.java","14086","113109","127195","6","254390"
"2013-10-22 16:21","Bookie.java","14264","114054","128318","6","256636"
"2017-05-16 00:31","Bookie.java","48325","104868","153193","","306386"
"2013-07-24 16:55","Bookie.java","13292","110795","124087","5","248174"
"2014-02-05 22:43","Bookie.java","14782","119074","133856","7","267712"
"2014-08-18 23:03","Bookie.java","15357","133327","148684","","297368"
"2014-05-09 14:04","Bookie.java","14905","123351","138256","7","276512"
"2013-06-15 19:05","Bookie.java","13240","109558","122798","5","245596"
"2017-06-01 23:58","Bookie.java","48943","108261","157204","","314408"
"2017-08-02 00:49","Bookie.java","49976","134735","184711","","369422"
"2013-12-02 18:45","Bookie.java","14284","116177","130461","6","260922"
"2013-05-04 14:22","Bookie.java","13066","104855","117921","5","235842"
"2012-12-18 13:04","Bookie.java","10227","66615","76842","2","153684"
"2016-11-18 00:18","Bookie.java","47717","82395","130112","","260224"
"2017-03-28 22:35","Bookie.java","47793","100164","147957","","295914"
"2016-07-14 23:02","Bookie.java","47645","74433","122078","","244156"
"2017-06-05 20:30","Bookie.java","48943","108619","157562","","315124"
"2016-11-30 00:02","Bookie.java","47728","82936","130664","","261328"
"2012-12-24 05:50","Bookie.java","10620","67116","77736","2","155472"
"2017-03-22 22:54","Bookie.java","47795","95862","143657","","287314"
"2012-12-24 06:23","Bookie.java","10673","67391","78064","2","156128"
"2017-08-16 03:37","BookieServer.java","119476","114550","234026","","468052"
"2017-08-02 00:49","BookieServer.java","117951","106392","224343","","448686"
"2013-07-03 17:39","BookieServer.java","57","374","431","5","862"
"2013-07-24 16:55","BookieServer.java","224","1409","1633","5","3266"
"2014-02-05 22:43","BookieServer.java","3442","11416","14858","7","29716"
"2017-06-28 23:24","BookieServer.java","114567","80969","195536","","391072"
"2017-06-01 23:58","BookieServer.java","114345","77345","191690","","383380"
"2017-10-17 09:32","BookieServer.java","125588","112040","237628","","475256"
"2014-08-02 20:02","BookieServer.java","4633","24817","29450","","58900"
"2013-12-06 07:39","BookieServer.java","1970","7697","9667","6","19334"
"2014-01-21 05:05","BookieServer.java","2302","9127","11429","6","22858"
"2015-04-21 09:17","PendingAddOp.java","12261","101415","113676","","227352"
"2015-10-06 10:48","PendingAddOp.java","12665","103236","115901","","231802"
"2015-10-22 09:22","PendingAddOp.java","12688","104089","116777","","233554"
"2017-06-30 00:12","PendingAddOp.java","68690","100683","169373","","338746"
"2014-01-21 05:19","PendingAddOp.java","10484","81374","91858","6","183716"
"2014-02-21 19:01","PendingAddOp.java","11210","84066","95276","7","190552"
"2014-02-05 22:43","PendingAddOp.java","11112","82805","93917","7","187834"
"2013-09-11 00:34","PendingAddOp.java","9316","74806","84122","5","168244"
"2013-10-14 18:32","PendingAddOp.java","10193","76710","86903","6","173806"
"2013-04-26 18:38","PendingAddOp.java","8778","67608","76386","5","152772"
"2017-08-02 00:49","PendingAddOp.java","70188","122348","192536","","385072"
"2012-12-27 23:16","PendingAddOp.java","6238","30406","36644","2","73288"
"2017-05-15 19:52","PendingAddOp.java","67845","91371","159216","","318432"
"2017-08-16 03:37","BookieServer.java","8894","40968","49862","","99724"
"2017-08-02 00:49","BookieServer.java","6431","31872","38303","","76606"
"2017-06-28 23:24","BookieServer.java","613","4015","4628","","9256"
"2017-10-17 09:32","BookieServer.java","33429","56881","90310","","180620"
"2012-06-19 12:39","BookieRecoveryTest.java","10996","29863","40859","2","81718"
"2012-12-12 11:20","BookieRecoveryTest.java","16796","85202","101998","2","203996"
"2012-09-12 11:59","BookieRecoveryTest.java","13619","61435","75054","2","150108"
"2017-06-30 00:12","BookieRecoveryTest.java","42713","122522","165235","","330470"
"2014-07-24 01:41","BookieRecoveryTest.java","19806","145073","164879","","329758"
"2012-12-04 22:15","BookieRecoveryTest.java","16701","84055","100756","2","201512"
"2017-04-11 20:15","BookieRecoveryTest.java","42181","110229","152410","","304820"
"2017-05-15 19:52","BookieRecoveryTest.java","42545","113887","156432","","312864"
"2012-07-18 17:00","BookieRecoveryTest.java","12704","40486","53190","2","106380"
"2012-12-10 16:02","BookieRecoveryTest.java","16783","84139","100922","2","201844"
"2012-03-31 10:58","BookieRecoveryTest.java","9341","22607","31948","1","63896"
"2012-02-13 15:46","BookieRecoveryTest.java","1210","6843","8053","1","16106"
"2013-08-13 14:32","BookieRecoveryTest.java","18941","131876","150817","5","301634"
"2014-02-05 22:43","BookieRecoveryTest.java","19520","139029","158549","7","317098"
"2014-01-21 05:19","LedgerDeleteOp.java","18492","141230","159722","6","319444"
"2012-06-19 12:39","LedgerDeleteOp.java","11183","34082","45265","2","90530"
"2015-04-21 09:17","LedgerDeleteOp.java","19208","160210","179418","","358836"
"2015-10-06 10:05","LedgerDeleteOp.java","19285","161478","180763","","361526"
"2012-12-24 05:50","LedgerDeleteOp.java","16503","92248","108751","2","217502"
"2014-01-21 05:19","PerChannelBookieClient.java","18235","141616","159851","6","319702"
"2013-10-22 07:35","PerChannelBookieClient.java","18113","137140","155253","6","310506"
"2012-05-17 16:05","PerChannelBookieClient.java","10723","31323","42046","1","84092"
"2012-05-26 19:16","PerChannelBookieClient.java","10854","32055","42909","1","85818"
"2014-01-09 07:30","PerChannelBookieClient.java","18184","140133","158317","6","316634"
"2017-06-30 00:12","PerChannelBookieClient.java","40399","124883","165282","","330564"
"2014-05-27 13:56","PerChannelBookieClient.java","18568","147467","166035","7","332070"
"2017-07-04 06:27","PerChannelBookieClient.java","40429","126874","167303","","334606"
"2012-07-23 23:39","PerChannelBookieClient.java","12612","45137","57749","2","115498"
"2012-08-13 11:38","PerChannelBookieClient.java","12980","51400","64380","2","128760"
"2011-11-17 11:16","PerChannelBookieClient.java","254","897","1151","","2302"
"2017-01-31 04:01","PerChannelBookieClient.java","40097","107768","147865","","295730"
"2015-10-06 10:05","PerChannelBookieClient.java","18962","161798","180760","","361520"
"2016-04-05 18:47","PerChannelBookieClient.java","39946","85079","125025","","250050"
"2012-02-01 12:06","PerChannelBookieClient.java","2068","8390","10458","1","20916"
"2017-04-15 13:58","PerChannelBookieClient.java","40089","113452","153541","","307082"
"2017-05-15 19:52","PerChannelBookieClient.java","40249","116266","156515","","313030"
"2012-12-01 15:04","PerChannelBookieClient.java","15963","87475","103438","2","206876"
"2016-04-05 08:45","PerChannelBookieClient.java","39944","84835","124779","","249558"
"2017-07-28 20:12","PerChannelBookieClient.java","40668","131707","172375","","344750"
"2017-01-31 02:14","PerChannelBookieClient.java","40083","102285","142368","","284736"
"2017-03-28 22:35","PerChannelBookieClient.java","40082","112345","152427","","304854"
"2017-03-23 00:48","PerChannelBookieClient.java","40089","108100","148189","","296378"
"2013-01-10 19:13","PerChannelBookieClient.java","16726","95549","112275","2","224550"
"2014-07-25 00:34","PerChannelBookieClient.java","18889","154653","173542","","347084"
"2012-02-24 20:07","PerChannelBookieClient.java","2564","13651","16215","1","32430"
"2011-11-18 11:18","PerChannelBookieClient.java","939","2870","3809","","7618"
"2017-08-02 00:49","PerChannelBookieClient.java","41066","145717","186783","","373566"
"2012-04-02 12:38","PerChannelBookieClient.java","9922","28001","37923","1","75846"
"2017-06-21 19:58","PerChannelBookieClient.java","40393","121733","162126","","324252"
"2017-06-01 23:58","PerChannelBookieClient.java","40364","119574","159938","","319876"
"2013-10-29 05:14","PerChannelBookieClient.java","18176","137994","156170","6","312340"
"2013-06-28 17:27","PerChannelBookieClient.java","18005","134524","152529","5","305058"
"2014-02-21 19:01","PerChannelBookieClient.java","18534","143881","162415","7","324830"
"2014-02-05 22:43","PerChannelBookieClient.java","18498","142682","161180","7","322360"
"2017-04-20 19:55","PerChannelBookieClient.java","40090","113474","153564","","307128"
"2013-09-11 00:34","PerChannelBookieClient.java","18052","136033","154085","5","308170"
"2013-08-20 12:51","PerChannelBookieClient.java","18033","135727","153760","5","307520"
"2016-04-29 05:05","ScanAndCompareGarbageCollector.java","109478","44048","153526","","307052"
"2016-04-27 09:55","ScanAndCompareGarbageCollector.java","109476","44046","153522","","307044"
"2016-03-08 06:49","ScanAndCompareGarbageCollector.java","6373","41057","47430","","94860"
"2017-03-28 22:40","ScanAndCompareGarbageCollector.java","111253","72834","184087","","368174"
"2017-05-25 14:23","LedgerFragmentReplicator.java","4527","32076","36603","","73206"
"2013-01-04 11:32","ServerConfiguration.java","18164","88055","106219","2","212438"
"2014-08-02 20:02","ServerConfiguration.java","20780","149064","169844","","339688"
"2014-05-06 12:30","ServerConfiguration.java","20391","140025","160416","7","320832"
"2014-05-15 00:41","ServerConfiguration.java","20391","140939","161330","7","322660"
"2014-09-18 06:47","ServerConfiguration.java","20791","151084","171875","","343750"
"2017-07-04 06:27","ServerConfiguration.java","45053","123388","168441","","336882"
"2014-03-07 13:14","ServerConfiguration.java","20383","137658","158041","7","316082"
"2014-04-29 22:07","ServerConfiguration.java","20391","139978","160369","7","320738"
"2012-10-18 16:40","ServerConfiguration.java","17011","69635","86646","2","173292"
"2012-09-12 20:34","ServerConfiguration.java","14226","58801","73027","2","146054"
"2016-04-14 00:51","ServerConfiguration.java","43842","80915","124757","","249514"
"2015-01-16 15:57","ServerConfiguration.java","20825","154090","174915","","349830"
"2013-02-08 19:08","ServerConfiguration.java","18485","120537","139022","4","278044"
"2016-03-08 06:49","ServerConfiguration.java","21029","158728","179757","","359514"
"2016-01-26 22:11","ServerConfiguration.java","21036","157721","178757","","357514"
"2014-01-21 05:05","ServerConfiguration.java","19994","134919","154913","6","309826"
"2014-03-12 21:26","ServerConfiguration.java","20391","139468","159859","7","319718"
"2016-04-05 18:47","ServerConfiguration.java","43827","80850","124677","","249354"
"2016-04-27 09:55","ServerConfiguration.java","43843","81428","125271","","250542"
"2015-04-21 09:55","ServerConfiguration.java","20835","154541","175376","","350752"
"2015-01-12 15:18","ServerConfiguration.java","20825","153152","173977","","347954"
"2015-04-21 10:02","ServerConfiguration.java","20836","154575","175411","","350822"
"2013-01-14 16:59","ServerConfiguration.java","18363","89702","108065","2","216130"
"2012-11-30 04:54","ServerConfiguration.java","17261","80497","97758","2","195516"
"2017-05-15 19:52","ServerConfiguration.java","44378","112285","156663","","313326"
"2017-03-22 22:54","ServerConfiguration.java","44008","103857","147865","","295730"
"2012-12-11 18:59","ServerConfiguration.java","17463","81655","99118","2","198236"
"2017-03-23 00:48","ServerConfiguration.java","44010","103911","147921","","295842"
"2017-01-31 02:11","ServerConfiguration.java","43988","97468","141456","","282912"
"2013-02-19 16:19","ServerConfiguration.java","19273","121278","140551","4","281102"
"2013-02-19 16:15","ServerConfiguration.java","19273","121259","140532","4","281064"
"2016-04-05 08:45","ServerConfiguration.java","43825","80606","124431","","248862"
"2016-11-09 03:02","ServerConfiguration.java","43967","90275","134242","","268484"
"2016-11-30 00:02","ServerConfiguration.java","43967","90957","134924","","269848"
"2017-06-05 20:30","ServerConfiguration.java","44971","116429","161400","","322800"
"2016-09-10 20:27","ServerConfiguration.java","43891","86410","130301","","260602"
"2012-03-29 15:18","ServerConfiguration.java","9629","18622","28251","1","56502"
"2012-02-15 10:58","ServerConfiguration.java","1421","3616","5037","1","10074"
"2012-02-24 19:08","ServerConfiguration.java","1531","4498","6029","1","12058"
"2017-08-02 00:49","ServerConfiguration.java","45748","142289","188037","","376074"
"2017-10-03 12:31","ServerConfiguration.java","46922","133620","180542","","361084"
"2017-08-16 03:37","ServerConfiguration.java","46531","149705","196236","","392472"
"2013-07-20 19:59","ServerConfiguration.java","19707","128376","148083","5","296166"
"2013-12-02 18:45","ServerConfiguration.java","19962","133637","153599","6","307198"
"2012-03-08 12:13","ServerConfiguration.java","1841","5889","7730","1","15460"
"2014-05-09 14:04","ServerConfiguration.java","20391","140619","161010","7","322020"
"2017-05-26 12:38","ServerConfiguration.java","44449","114672","159121","","318242"
"2013-06-15 19:05","ServerConfiguration.java","19686","127786","147472","5","294944"
"2014-01-15 15:58","ServerConfiguration.java","19967","133986","153953","6","307906"
"2013-10-22 07:44","ServerConfiguration.java","19878","131056","150934","6","301868"
"2017-07-07 08:19","ServerConfiguration.java","45046","125344","170390","","340780"
"2017-06-28 23:24","ServerConfiguration.java","45020","119522","164542","","329084"
"2017-11-08 12:27","ServerConfiguration.java","47583","152155","199738","","399476"
"2014-01-22 14:35","ServerConfiguration.java","20115","136055","156170","6","312340"
"2013-10-12 05:42","ServerConfiguration.java","19831","130636","150467","6","300934"
"2017-01-31 04:01","BookkeeperInternalCallbacks.java","111542","56728","168270","","336540"
"2017-06-05 22:25","BookkeeperInternalCallbacks.java","113701","71875","185576","","371152"
"2017-08-02 00:49","BookkeeperInternalCallbacks.java","117594","99760","217354","","434708"
"2017-06-21 21:00","BookkeeperInternalCallbacks.java","113776","73304","187080","","374160"
"2017-06-05 22:13","BookkeeperInternalCallbacks.java","113617","71497","185114","","370228"
"2014-02-05 22:43","BookkeeperInternalCallbacks.java","1505","3204","4709","7","9418"
"2017-05-15 19:52","BookkeeperInternalCallbacks.java","112556","66088","178644","","357288"
"2017-03-28 22:35","BookkeeperInternalCallbacks.java","111642","61420","173062","","346124"
"2013-08-22 16:40","ZkUtils.java","3951","45463","49414","5","98828"
"2017-06-12 17:20","ZkUtils.java","81715","86314","168029","","336058"
"2017-03-28 22:40","ZkUtils.java","80137","76455","156592","","313184"
"2017-01-31 04:01","Bookie.java","112860","44137","156997","","313994"
"2017-03-28 22:37","Bookie.java","113036","49120","162156","","324312"
"2016-01-26 22:11","Bookie.java","2348","10749","13097","","26194"
"2015-03-18 07:38","Bookie.java","1303","6452","7755","","15510"
"2015-04-21 09:17","Bookie.java","1381","6632","8013","","16026"
"2014-09-23 17:53","Bookie.java","779","2871","3650","","7300"
"2017-07-04 06:27","Bookie.java","116075","66126","182201","","364402"
"2017-06-05 22:25","Bookie.java","115521","59786","175307","","350614"
"2017-06-28 23:24","Bookie.java","115626","61844","177470","","354940"
"2017-07-07 08:19","Bookie.java","116119","68133","184252","","368504"
"2017-05-16 00:31","Bookie.java","114344","54385","168729","","337458"
"2014-08-18 23:03","Bookie.java","374","1842","2216","","4432"
"2017-06-01 23:58","Bookie.java","115213","58029","173242","","346484"
"2017-08-02 00:49","Bookie.java","119826","88083","207909","","415818"
"2016-11-18 00:18","Bookie.java","112786","30962","143748","","287496"
"2017-03-28 22:35","Bookie.java","112996","48865","161861","","323722"
"2016-07-14 23:02","Bookie.java","107718","18004","125722","","251444"
"2017-06-05 20:30","Bookie.java","115331","58505","173836","","347672"
"2016-11-30 00:02","Bookie.java","112812","31518","144330","","288660"
"2017-03-22 22:54","Bookie.java","112970","44535","157505","","315010"
"2017-07-04 06:27","FileInfo.java","35909","130417","166326","","332652"
"2012-10-26 12:51","FileInfo.java","13990","84313","98303","2","196606"
"2011-11-17 11:16","FileInfo.java","7104","15810","22914","","45828"
"2014-12-04 12:28","FileInfo.java","16164","163265","179429","","358858"
"2011-11-04 11:46","FileInfo.java","6367","12804","19171","","38342"
"2017-01-31 04:01","FileInfo.java","35724","111458","147182","","294364"
"2011-09-05 19:38","FileInfo.java","4728","11093","15821","","31642"
"2017-03-23 15:55","FileInfo.java","35720","111820","147540","","295080"
"2016-11-18 00:18","FileInfo.java","35714","98347","134061","","268122"
"2012-12-18 13:04","FileInfo.java","14292","98635","112927","2","225854"
"2013-05-04 14:22","FileInfo.java","15594","135338","150932","5","301864"
"2012-02-09 18:14","FileInfo.java","8410","26534","34944","1","69888"
"2012-02-17 11:18","FileInfo.java","8487","27066","35553","1","71106"
"2012-02-24 19:20","FileInfo.java","8570","27714","36284","1","72568"
"2012-06-13 16:57","FileInfo.java","10086","40925","51011","","102022"
"2012-03-29 15:18","FileInfo.java","9444","34610","44054","1","88108"
"2017-06-01 23:58","FileInfo.java","35891","123164","159055","","318110"
"2017-07-17 23:27","FileInfo.java","35909","133524","169433","","338866"
"2017-05-16 00:31","FileInfo.java","35872","120370","156242","","312484"
"2013-10-22 16:21","FileInfo.java","15780","143525","159305","6","318610"
"2013-10-11 08:36","FileInfo.java","15695","142132","157827","6","315654"
"2017-06-30 00:12","DistributionSchedule.java","61527","105049","166576","","333152"
"2012-09-12 11:59","DistributionSchedule.java","1356","12885","14241","2","28482"
"2012-06-19 12:39","BookieRecoveryTest.java","12679","37919","50598","2","101196"
"2012-12-12 11:20","BookieRecoveryTest.java","17210","91989","109199","2","218398"
"2012-09-12 11:59","BookieRecoveryTest.java","14547","68736","83283","2","166566"
"2017-06-30 00:12","BookieRecoveryTest.java","40530","126712","167242","","334484"
"2014-07-24 01:41","BookieRecoveryTest.java","19365","151005","170370","","340740"
"2011-10-27 18:26","BookieRecoveryTest.java","1168","1646","2814","","5628"
"2011-11-28 19:25","BookieRecoveryTest.java","3825","10198","14023","","28046"
"2011-11-16 17:05","BookieRecoveryTest.java","2735","4433","7168","","14336"
"2012-12-04 22:15","BookieRecoveryTest.java","17149","90876","108025","2","216050"
"2017-04-11 20:15","BookieRecoveryTest.java","40277","114698","154975","","309950"
"2017-05-15 19:52","BookieRecoveryTest.java","40437","118152","158589","","317178"
"2012-07-18 17:00","BookieRecoveryTest.java","13966","48121","62087","2","124174"
"2012-12-10 16:02","BookieRecoveryTest.java","17197","90926","108123","2","216246"
"2012-03-31 10:58","BookieRecoveryTest.java","11840","31479","43319","1","86638"
"2011-11-15 19:42","BookieRecoveryTest.java","2654","3617","6271","","12542"
"2011-11-18 11:18","BookieRecoveryTest.java","3592","7221","10813","","21626"
"2012-02-13 15:46","BookieRecoveryTest.java","4625","16631","21256","1","42512"
"2013-08-13 14:32","BookieRecoveryTest.java","18856","138164","157020","5","314040"
"2014-02-05 22:43","BookieRecoveryTest.java","19159","145041","164200","7","328400"
"2012-12-08 11:18","Bookie.java","10118","63381","73499","2","146998"
"2012-09-14 15:42","Bookie.java","6821","40783","47604","2","95208"
"2012-10-25 15:35","Bookie.java","9507","52713","62220","2","124440"
"2012-10-26 16:25","Bookie.java","9699","53854","63553","2","127106"
"2017-01-31 04:01","Bookie.java","47275","96281","143556","","287112"
"2017-03-28 22:37","Bookie.java","47323","101136","148459","","296918"
"2016-01-26 22:11","Bookie.java","15950","142080","158030","","316060"
"2015-03-18 07:38","Bookie.java","15686","138564","154250","","308500"
"2015-04-21 09:17","Bookie.java","15686","138666","154352","","308704"
"2012-10-18 16:40","Bookie.java","9399","51468","60867","2","121734"
"2012-12-03 17:59","Bookie.java","9979","63197","73176","2","146352"
"2012-07-04 16:17","Bookie.java","3384","13848","17232","2","34464"
"2012-07-23 23:39","Bookie.java","5044","18904","23948","2","47896"
"2013-06-21 19:26","Bookie.java","13353","111025","124378","5","248756"
"2012-09-07 07:04","Bookie.java","6428","39729","46157","2","92314"
"2014-09-23 17:53","Bookie.java","15485","135306","150791","","301582"
"2017-07-04 06:27","Bookie.java","48586","116366","164952","","329904"
"2017-06-05 22:25","Bookie.java","48470","110464","158934","","317868"
"2014-02-06 09:25","Bookie.java","14869","120396","135265","7","270530"
"2014-04-29 22:07","Bookie.java","14981","124013","138994","7","277988"
"2013-12-06 07:39","Bookie.java","14388","117660","132048","6","264096"
"2012-07-05 14:45","Bookie.java","3401","14347","17748","2","35496"
"2012-05-10 14:47","Bookie.java","511","1738","2249","1","4498"
"2014-08-02 20:02","Bookie.java","15422","133151","148573","","297146"
"2013-10-02 07:01","Bookie.java","13488","113005","126493","5","252986"
"2012-06-19 12:39","Bookie.java","1907","6784","8691","2","17382"
"2017-06-28 23:24","Bookie.java","48511","112458","160969","","321938"
"2017-07-07 08:19","Bookie.java","48582","118325","166907","","333814"
"2013-09-11 00:34","Bookie.java","13463","112779","126242","5","252484"
"2014-01-21 17:26","Bookie.java","14495","119504","133999","6","267998"
"2013-10-12 05:42","Bookie.java","14185","114435","128620","6","257240"
"2013-10-22 16:21","Bookie.java","14363","115380","129743","6","259486"
"2017-05-16 00:31","Bookie.java","47832","105602","153434","","306868"
"2013-07-24 16:55","Bookie.java","13402","112132","125534","5","251068"
"2014-02-05 22:43","Bookie.java","14867","120386","135253","7","270506"
"2014-08-18 23:03","Bookie.java","15435","134632","150067","","300134"
"2014-05-09 14:04","Bookie.java","14989","124662","139651","7","279302"
"2013-06-15 19:05","Bookie.java","13350","110895","124245","5","248490"
"2017-06-01 23:58","Bookie.java","48455","109000","157455","","314910"
"2017-08-02 00:49","Bookie.java","49464","135450","184914","","369828"
"2013-12-02 18:45","Bookie.java","14383","117503","131886","6","263772"
"2013-05-04 14:22","Bookie.java","13177","106193","119370","5","238740"
"2012-12-18 13:04","Bookie.java","10429","68044","78473","2","156946"
"2016-11-18 00:18","Bookie.java","47230","83135","130365","","260730"
"2017-03-28 22:35","Bookie.java","47305","100903","148208","","296416"
"2016-07-14 23:02","Bookie.java","47158","75173","122331","","244662"
"2017-06-05 20:30","Bookie.java","48455","109358","157813","","315626"
"2016-11-30 00:02","Bookie.java","47241","83676","130917","","261834"
"2012-12-24 05:50","Bookie.java","10814","68537","79351","2","158702"
"2017-03-22 22:54","Bookie.java","47307","96601","143908","","287816"
"2012-12-24 06:23","Bookie.java","10866","68811","79677","2","159354"
"2015-09-15 10:38","BookKeeper.java","15234","134204","149438","","298876"
"2015-10-22 09:22","BookKeeper.java","15245","135595","150840","","301680"
"2017-01-31 04:01","BookKeeper.java","48191","92320","140511","","281022"
"2012-07-23 23:39","BookKeeper.java","3348","12331","15679","2","31358"
"2012-12-13 13:07","BookKeeper.java","9041","59351","68392","2","136784"
"2015-07-10 22:48","BookKeeper.java","15034","133702","148736","","297472"
"2017-06-30 00:12","BookKeeper.java","49493","110435","159928","","319856"
"2014-02-06 09:21","BookKeeper.java","14036","114682","128718","7","257436"
"2012-09-12 11:59","BookKeeper.java","4963","33912","38875","2","77750"
"2014-01-21 05:19","BookKeeper.java","13620","113459","127079","6","254158"
"2013-10-02 06:40","BookKeeper.java","12547","107081","119628","5","239256"
"2014-02-21 19:01","BookKeeper.java","14125","115930","130055","7","260110"
"2016-10-13 07:50","BookKeeper.java","48075","78648","126723","","253446"
"2017-06-21 21:00","BookKeeper.java","49476","107947","157423","","314846"
"2013-06-12 18:41","BookKeeper.java","12389","104630","117019","5","234038"
"2013-05-06 19:32","BookKeeper.java","12215","100454","112669","5","225338"
"2013-01-10 19:13","BookKeeper.java","10695","65976","76671","2","153342"
"2017-03-28 22:35","BookKeeper.java","48229","96950","145179","","290358"
"2016-07-11 23:01","BookKeeper.java","48025","71129","119154","","238308"
"2016-10-13 09:27","BookKeeper.java","48153","78712","126865","","253730"
"2017-07-28 20:12","BookKeeper.java","50081","117578","167659","","335318"
"2017-05-15 19:52","BookKeeper.java","48739","101214","149953","","299906"
"2013-09-10 15:14","BookKeeper.java","12510","106910","119420","5","238840"
"2012-12-18 13:04","LedgerDescriptorImpl.java","11114","71006","82120","2","164240"
"2016-11-18 00:18","LedgerDescriptorImpl.java","46573","84755","131328","","262656"
"2017-05-16 00:31","LedgerDescriptorImpl.java","47134","107181","154315","","308630"
"2012-04-17 12:18","LedgerDescriptorImpl.java","646","2700","3346","1","6692"
"2017-07-04 06:27","LedgerDescriptorImpl.java","47872","117929","165801","","331602"
"2017-06-05 22:25","LedgerDescriptorImpl.java","47770","112041","159811","","319622"
"2017-01-31 04:01","LedgerDescriptorImpl.java","46615","97898","144513","","289026"
"2012-12-08 11:18","Bookie.java","10536","64211","74747","2","149494"
"2012-09-14 15:42","Bookie.java","7263","41637","48900","2","97800"
"2012-10-25 15:35","Bookie.java","9925","53543","63468","2","126936"
"2012-10-26 16:25","Bookie.java","10117","54684","64801","2","129602"
"2017-01-31 04:01","Bookie.java","47520","96938","144458","","288916"
"2017-03-28 22:37","Bookie.java","47556","101781","149337","","298674"
"2016-01-26 22:11","Bookie.java","16203","142745","158948","","317896"
"2015-03-18 07:38","Bookie.java","15940","139230","155170","","310340"
"2015-04-21 09:17","Bookie.java","15939","139331","155270","","310540"
"2012-10-18 16:40","Bookie.java","9817","52298","62115","2","124230"
"2012-12-03 17:59","Bookie.java","10397","64027","74424","2","148848"
"2012-07-04 16:17","Bookie.java","3839","14715","18554","2","37108"
"2012-07-23 23:39","Bookie.java","5497","19769","25266","2","50532"
"2013-06-21 19:26","Bookie.java","13642","111726","125368","5","250736"
"2012-09-07 07:04","Bookie.java","6881","40594","47475","2","94950"
"2014-09-23 17:53","Bookie.java","15739","135972","151711","","303422"
"2017-07-04 06:27","Bookie.java","48794","116986","165780","","331560"
"2017-06-05 22:25","Bookie.java","48681","111087","159768","","319536"
"2014-02-06 09:25","Bookie.java","15134","121073","136207","7","272414"
"2014-04-29 22:07","Bookie.java","15242","124686","139928","7","279856"
"2013-12-06 07:39","Bookie.java","14655","118339","132994","6","265988"
"2012-07-05 14:45","Bookie.java","3856","15214","19070","2","38140"
"2012-05-10 14:47","Bookie.java","983","2622","3605","1","7210"
"2014-08-02 20:02","Bookie.java","15676","133817","149493","","298986"
"2012-04-17 13:16","Bookie.java","508","920","1428","1","2856"
"2013-10-02 07:01","Bookie.java","13774","113703","127477","5","254954"
"2012-06-19 12:39","Bookie.java","2370","7659","10029","2","20058"
"2017-06-28 23:24","Bookie.java","48721","113080","161801","","323602"
"2017-07-07 08:19","Bookie.java","48790","118945","167735","","335470"
"2013-09-11 00:34","Bookie.java","13749","113477","127226","5","254452"
"2014-01-21 17:26","Bookie.java","14761","120182","134943","6","269886"
"2013-10-12 05:42","Bookie.java","14458","115120","129578","6","259156"
"2013-10-22 16:21","Bookie.java","14631","116060","130691","6","261382"
"2017-05-16 00:31","Bookie.java","48051","106233","154284","","308568"
"2013-07-24 16:55","Bookie.java","13688","112830","126518","5","253036"
"2014-02-05 22:43","Bookie.java","15132","121063","136195","7","272390"
"2014-08-18 23:03","Bookie.java","15689","135298","150987","","301974"
"2014-05-09 14:04","Bookie.java","15250","125335","140585","7","281170"
"2013-06-15 19:05","Bookie.java","13638","111595","125233","5","250466"
"2017-06-01 23:58","Bookie.java","48662","109619","158281","","316562"
"2012-04-17 12:18","Bookie.java","127","316","443","1","886"
"2017-08-02 00:49","Bookie.java","49620","136018","185638","","371276"
"2013-12-02 18:45","Bookie.java","14651","118183","132834","6","265668"
"2013-05-04 14:22","Bookie.java","13466","106894","120360","5","240720"
"2012-12-18 13:04","Bookie.java","10845","68872","79717","2","159434"
"2016-11-18 00:18","Bookie.java","47475","83792","131267","","262534"
"2017-03-28 22:35","Bookie.java","47538","101548","149086","","298172"
"2016-07-14 23:02","Bookie.java","47401","75828","123229","","246458"
"2017-06-05 20:30","Bookie.java","48662","109977","158639","","317278"
"2016-11-30 00:02","Bookie.java","47486","84333","131819","","263638"
"2012-12-24 05:50","Bookie.java","11230","69365","80595","2","161190"
"2017-03-22 22:54","Bookie.java","47540","97246","144786","","289572"
"2012-12-24 06:23","Bookie.java","11282","69639","80921","2","161842"
"2016-10-13 07:50","NetUtils.java","112110","50442","162552","","325104"
"2017-08-16 03:41","NetUtils.java","119164","114889","234053","","468106"
"2012-06-19 12:39","BookieRecoveryTest.java","10379","41255","51634","2","103268"
"2012-12-12 11:20","BookieRecoveryTest.java","14464","94879","109343","2","218686"
"2012-09-12 11:59","BookieRecoveryTest.java","11982","71807","83789","2","167578"
"2017-06-30 00:12","BookieRecoveryTest.java","36237","128055","164292","","328584"
"2014-07-24 01:41","BookieRecoveryTest.java","16459","153735","170194","","340388"
"2011-10-27 18:26","BookieRecoveryTest.java","5805","11919","17724","","35448"
"2011-11-28 19:25","BookieRecoveryTest.java","8020","20029","28049","","56098"
"2011-09-05 19:38","BookieRecoveryTest.java","4875","10511","15386","","30772"
"2011-11-16 17:05","BookieRecoveryTest.java","7037","14371","21408","","42816"
"2012-12-04 22:15","BookieRecoveryTest.java","14409","93772","108181","2","216362"
"2017-04-11 20:15","BookieRecoveryTest.java","36035","116092","152127","","304254"
"2017-05-15 19:52","BookieRecoveryTest.java","36187","119538","155725","","311450"
"2012-07-18 17:00","BookieRecoveryTest.java","11498","51289","62787","2","125574"
"2012-12-10 16:02","BookieRecoveryTest.java","14451","93816","108267","2","216534"
"2012-03-31 10:58","BookieRecoveryTest.java","9670","34945","44615","1","89230"
"2011-11-15 19:42","BookieRecoveryTest.java","6976","13575","20551","","41102"
"2011-11-18 11:18","BookieRecoveryTest.java","7801","17066","24867","","49734"
"2012-02-13 15:46","BookieRecoveryTest.java","8709","26351","35060","1","70120"
"2013-08-13 14:32","BookieRecoveryTest.java","16001","140945","156946","5","313892"
"2014-02-05 22:43","BookieRecoveryTest.java","16258","147776","164034","7","328068"
"2015-09-15 10:38","BookKeeper.java","12661","102682","115343","","230686"
"2015-10-22 09:22","BookKeeper.java","12688","104089","116777","","233554"
"2017-01-31 04:01","BookKeeper.java","67194","82374","149568","","299136"
"2012-12-13 13:07","BookKeeper.java","5258","26619","31877","2","63754"
"2015-07-10 22:48","BookKeeper.java","12423","102142","114565","","229130"
"2017-06-30 00:12","BookKeeper.java","68690","100683","169373","","338746"
"2014-02-06 09:21","BookKeeper.java","11112","82809","93921","7","187842"
"2014-01-21 05:19","BookKeeper.java","10484","81374","91858","6","183716"
"2013-10-02 06:40","BookKeeper.java","9344","74929","84273","5","168546"
"2014-02-21 19:01","BookKeeper.java","11210","84066","95276","7","190552"
"2016-10-13 07:50","BookKeeper.java","67035","68659","135694","","271388"
"2017-06-21 21:00","BookKeeper.java","68596","98118","166714","","333428"
"2013-06-12 18:41","BookKeeper.java","9141","72433","81574","5","163148"
"2013-05-06 19:32","BookKeeper.java","8943","68233","77176","5","154352"
"2013-01-10 19:13","BookKeeper.java","7305","33637","40942","2","81884"
"2017-03-28 22:35","BookKeeper.java","67268","87040","154308","","308616"
"2016-07-11 23:01","BookKeeper.java","66055","60210","126265","","252530"
"2016-10-13 09:27","BookKeeper.java","67146","68756","135902","","271804"
"2017-07-28 20:12","BookKeeper.java","69363","107911","177274","","354548"
"2017-05-15 19:52","BookKeeper.java","67845","91371","159216","","318432"
"2013-09-10 15:14","BookKeeper.java","9303","74754","84057","5","168114"
"2017-06-05 22:25","PacketProcessorBaseV3.java","1852","6494","8346","","16692"
"2015-07-10 22:48","TestLedgerUnderreplicationManager.java","4921","28216","33137","","66274"
"2016-02-23 19:16","LedgerMetadataImpl.java","15331","136884","152215","","304430"
"2012-06-27 15:35","LedgerMetadataImpl.java","1465","6670","8135","2","16270"
"2012-09-12 11:59","LedgerMetadataImpl.java","4963","33912","38875","2","77750"
"2013-08-13 14:32","LedgerMetadataImpl.java","12470","106538","119008","5","238016"
"2017-06-01 23:58","LedgerMetadataImpl.java","49427","105095","154522","","309044"
"2013-03-25 18:02","LedgerMetadataImpl.java","12026","99442","111468","4","222936"
"2013-04-26 18:38","LedgerMetadataImpl.java","12057","99836","111893","5","223786"
"2017-07-28 20:12","LedgerMetadataImpl.java","50081","117578","167659","","335318"
"2016-07-11 23:01","LedgerMetadataImpl.java","48025","71129","119154","","238308"
"2012-07-18 17:00","LedgerMetadataImpl.java","3288","12203","15491","2","30982"
"2016-02-23 19:16","LedgerMetadataImpl.java","12787","105391","118178","","236356"
"2013-08-13 14:32","LedgerMetadataImpl.java","9246","74365","83611","5","167222"
"2017-06-01 23:58","LedgerMetadataImpl.java","68544","95263","163807","","327614"
"2013-03-25 18:02","LedgerMetadataImpl.java","8732","67199","75931","4","151862"
"2013-04-26 18:38","LedgerMetadataImpl.java","8778","67608","76386","5","152772"
"2017-07-28 20:12","LedgerMetadataImpl.java","69363","107911","177274","","354548"
"2016-07-11 23:01","LedgerMetadataImpl.java","66055","60210","126265","","252530"
"2016-04-27 21:11","ZkLedgerUnderreplicationManager.java","107184","15017","122201","","244402"
"2016-07-14 23:02","ZkLedgerUnderreplicationManager.java","107502","16320","123822","","247644"
"2017-07-07 05:11","ZkLedgerUnderreplicationManager.java","115979","66242","182221","","364442"
"2017-06-28 23:28","ZkLedgerUnderreplicationManager.java","115525","60767","176292","","352584"
"2017-06-01 23:58","ZkLedgerUnderreplicationManager.java","115034","56382","171416","","342832"
"2017-03-28 22:40","ZkLedgerUnderreplicationManager.java","112925","47769","160694","","321388"
"2016-04-27 09:55","ZkLedgerUnderreplicationManager.java","107184","15017","122201","","244402"
"2017-08-02 00:49","BookieNettyServer.java","9191","45831","55022","","110044"
"2017-06-01 09:47","BookieNettyServer.java","2438","13409","15847","","31694"
"2017-05-15 19:52","BookieNettyServer.java","2089","10095","12184","","24368"
"2017-03-23 15:59","ZooKeeperClient.java","111627","37779","149406","","298812"
"2017-01-31 04:01","Bookie.java","112672","62161","174833","","349666"
"2017-03-28 22:37","Bookie.java","112781","67077","179858","","359716"
"2016-01-26 22:11","Bookie.java","6060","32673","38733","","77466"
"2015-03-18 07:38","Bookie.java","5254","28615","33869","","67738"
"2015-04-21 09:17","Bookie.java","5256","28719","33975","","67950"
"2014-09-23 17:53","Bookie.java","4839","25143","29982","","59964"
"2017-07-04 06:27","Bookie.java","115066","83329","198395","","396790"
"2017-06-05 22:25","Bookie.java","114712","77189","191901","","383802"
"2014-02-06 09:25","Bookie.java","3055","9065","12120","7","24240"
"2014-04-29 22:07","Bookie.java","3482","12997","16479","7","32958"
"2013-12-06 07:39","Bookie.java","1503","5258","6761","6","13522"
"2014-08-02 20:02","Bookie.java","4338","22550","26888","","53776"
"2017-06-28 23:24","Bookie.java","114788","79218","194006","","388012"
"2017-07-07 08:19","Bookie.java","115059","85285","200344","","400688"
"2014-01-21 17:26","Bookie.java","2004","7496","9500","6","19000"
"2013-10-12 05:42","Bookie.java","1067","1800","2867","6","5734"
"2013-10-22 16:21","Bookie.java","1419","2919","4338","6","8676"
"2017-05-16 00:31","Bookie.java","113739","71992","185731","","371462"
"2014-02-05 22:43","Bookie.java","3050","9052","12102","7","24204"
"2014-08-18 23:03","Bookie.java","4711","24391","29102","","58204"
"2014-05-09 14:04","Bookie.java","3500","13656","17156","7","34312"
"2017-06-01 23:58","Bookie.java","114528","75556","190084","","380168"
"2017-08-02 00:49","Bookie.java","118254","104723","222977","","445954"
"2013-12-02 18:45","Bookie.java","1485","5088","6573","6","13146"
"2016-11-18 00:18","Bookie.java","112610","48998","161608","","323216"
"2017-03-28 22:35","Bookie.java","112762","66843","179605","","359210"
"2016-07-14 23:02","Bookie.java","109942","38440","148382","","296764"
"2017-06-05 20:30","Bookie.java","114618","76004","190622","","381244"
"2016-11-30 00:02","Bookie.java","112636","49554","162190","","324380"
"2017-03-22 22:54","Bookie.java","112758","62535","175293","","350586"
"2012-12-08 11:18","Bookie.java","8777","57163","65940","2","131880"
"2012-09-14 15:42","Bookie.java","5284","34369","39653","2","79306"
"2012-10-25 15:35","Bookie.java","8135","46464","54599","2","109198"
"2012-10-26 16:25","Bookie.java","8331","47609","55940","2","111880"
"2017-01-31 04:01","Bookie.java","48191","92320","140511","","281022"
"2017-03-28 22:37","Bookie.java","48247","97183","145430","","290860"
"2016-01-26 22:11","Bookie.java","15248","136501","151749","","303498"
"2015-03-18 07:38","Bookie.java","14908","132909","147817","","295634"
"2015-04-21 09:17","Bookie.java","14909","133012","147921","","295842"
"2012-10-18 16:40","Bookie.java","8016","45208","53224","2","106448"
"2012-12-03 17:59","Bookie.java","8635","56976","65611","2","131222"
"2012-07-04 16:17","Bookie.java","1501","7088","8589","2","17178"
"2012-07-23 23:39","Bookie.java","3348","12331","15679","2","31358"
"2013-06-21 19:26","Bookie.java","12400","105195","117595","5","235190"
"2012-09-07 07:04","Bookie.java","4844","33268","38112","2","76224"
"2014-09-23 17:53","Bookie.java","14691","129635","144326","","288652"
"2017-07-04 06:27","Bookie.java","49576","112479","162055","","324110"
"2017-06-05 22:25","Bookie.java","49442","106559","156001","","312002"
"2014-02-06 09:25","Bookie.java","14038","114688","128726","7","257452"
"2014-04-29 22:07","Bookie.java","14173","118328","132501","7","265002"
"2013-12-06 07:39","Bookie.java","13513","111908","125421","6","250842"
"2012-07-05 14:45","Bookie.java","1523","7592","9115","2","18230"
"2014-08-02 20:02","Bookie.java","14624","127476","142100","","284200"
"2013-10-02 07:01","Bookie.java","12548","107188","119736","5","239472"
"2017-06-28 23:24","Bookie.java","49483","108553","158036","","316072"
"2017-07-07 08:19","Bookie.java","49572","114438","164010","","328020"
"2013-09-11 00:34","Bookie.java","12520","106959","119479","5","238958"
"2014-01-21 17:26","Bookie.java","13627","113759","127386","6","254772"
"2013-10-12 05:42","Bookie.java","13280","108653","121933","6","243866"
"2013-10-22 16:21","Bookie.java","13468","109608","123076","6","246152"
"2017-05-16 00:31","Bookie.java","48805","101698","150503","","301006"
"2013-07-24 16:55","Bookie.java","12450","106303","118753","5","237506"
"2014-02-05 22:43","Bookie.java","14036","114678","128714","7","257428"
"2014-08-18 23:03","Bookie.java","14632","128952","143584","","287168"
"2014-05-09 14:04","Bookie.java","14181","118977","133158","7","266316"
"2013-06-15 19:05","Bookie.java","12397","105065","117462","5","234924"
"2017-06-01 23:58","Bookie.java","49427","105095","154522","","309044"
"2017-08-02 00:49","Bookie.java","50686","131795","182481","","364962"
"2013-12-02 18:45","Bookie.java","13505","111748","125253","6","250506"
"2013-05-04 14:22","Bookie.java","12215","100354","112569","5","225138"
"2012-12-18 13:04","Bookie.java","9117","61855","70972","2","141944"
"2016-11-18 00:18","Bookie.java","48146","79174","127320","","254640"
"2017-03-28 22:35","Bookie.java","48229","96950","145179","","290358"
"2016-07-14 23:02","Bookie.java","48071","71209","119280","","238560"
"2017-06-05 20:30","Bookie.java","49427","105453","154880","","309760"
"2016-11-30 00:02","Bookie.java","48157","79715","127872","","255744"
"2012-12-24 05:50","Bookie.java","9710","62556","72266","2","144532"
"2017-03-22 22:54","Bookie.java","48231","92648","140879","","281758"
"2012-12-24 06:23","Bookie.java","9769","62837","72606","2","145212"
"2012-06-19 12:39","BookieRecoveryTest.java","11045","34587","45632","2","91264"
"2012-12-12 11:20","BookieRecoveryTest.java","16128","89209","105337","2","210674"
"2012-09-12 11:59","BookieRecoveryTest.java","13408","65899","79307","2","158614"
"2017-06-30 00:12","BookieRecoveryTest.java","40399","124883","165282","","330564"
"2014-07-24 01:41","BookieRecoveryTest.java","18739","148681","167420","","334840"
"2011-11-28 19:25","BookieRecoveryTest.java","1347","6022","7369","","14738"
"2012-12-04 22:15","BookieRecoveryTest.java","16061","88090","104151","2","208302"
"2017-04-11 20:15","BookieRecoveryTest.java","40083","112806","152889","","305778"
"2017-05-15 19:52","BookieRecoveryTest.java","40249","116266","156515","","313030"
"2012-07-18 17:00","BookieRecoveryTest.java","12586","45043","57629","2","115258"
"2012-12-10 16:02","BookieRecoveryTest.java","16115","88146","104261","2","208522"
"2012-03-31 10:58","BookieRecoveryTest.java","9907","27848","37755","1","75510"
"2011-11-18 11:18","BookieRecoveryTest.java","939","2870","3809","","7618"
"2012-02-13 15:46","BookieRecoveryTest.java","2421","12729","15150","1","30300"
"2013-08-13 14:32","BookieRecoveryTest.java","18028","135638","153666","5","307332"
"2014-02-05 22:43","BookieRecoveryTest.java","18498","142682","161180","7","322360"
"2015-09-15 10:38","GcLedgersTest.java","2902","15472","18374","","36748"
"2016-04-27 09:55","GcLedgersTest.java","107727","23480","131207","","262414"
"2017-03-28 22:37","GcLedgersTest.java","111147","53683","164830","","329660"
"2016-03-08 06:49","GcLedgersTest.java","3369","19236","22605","","45210"
"2017-07-04 06:27","GcLedgersTest.java","113825","70328","184153","","368306"
"2017-05-16 00:31","GcLedgersTest.java","112271","58764","171035","","342070"
"2015-09-15 10:38","BookKeeper.java","4797","23928","28725","","57450"
"2015-10-22 09:22","BookKeeper.java","4870","25381","30251","","60502"
"2017-01-31 04:01","BookKeeper.java","111696","55986","167682","","335364"
"2015-07-10 22:48","BookKeeper.java","4375","23204","27579","","55158"
"2017-06-30 00:12","BookKeeper.java","114143","75246","189389","","378778"
"2014-02-06 09:21","BookKeeper.java","1191","1998","3189","7","6378"
"2014-02-21 19:01","BookKeeper.java","1382","3348","4730","7","9460"
"2016-10-13 07:50","BookKeeper.java","111484","42218","153702","","307404"
"2017-06-21 21:00","BookKeeper.java","113945","72577","186522","","373044"
"2017-03-28 22:35","BookKeeper.java","111796","60678","172474","","344948"
"2016-07-11 23:01","BookKeeper.java","108860","32125","140985","","281970"
"2016-10-13 09:27","BookKeeper.java","111605","42325","153930","","307860"
"2017-07-28 20:12","BookKeeper.java","115195","82853","198048","","396096"
"2017-05-15 19:52","BookKeeper.java","112723","65359","178082","","356164"
"2012-05-25 17:13","LedgerRecoveryOp.java","498","1752","2250","1","4500"
"2013-10-14 17:38","LedgerRecoveryOp.java","14146","113228","127374","6","254748"
"2017-06-21 19:58","LedgerRecoveryOp.java","48991","110439","159430","","318860"
"2017-06-21 21:00","LedgerRecoveryOp.java","48991","111112","160103","","320206"
"2017-06-21 19:50","LedgerRecoveryOp.java","48991","110329","159320","","318640"
"2013-03-25 18:02","LedgerRecoveryOp.java","12886","103952","116838","4","233676"
"2017-07-28 20:12","AsyncCallback.java","113924","93182","207106","","414212"
"2017-01-31 04:01","AsyncCallback.java","111020","66910","177930","","355860"
"2017-07-04 06:27","AsyncCallback.java","113258","87922","201180","","402360"
"2012-05-25 17:13","ReadLastConfirmedOp.java","10978","31481","42459","1","84918"
"2017-06-30 00:12","ReadLastConfirmedOp.java","40883","124724","165607","","331214"
"2012-08-27 14:43","ReadLastConfirmedOp.java","13344","58350","71694","2","143388"
"2012-09-14 15:42","ReadLastConfirmedOp.java","13784","65768","79552","2","159104"
"2017-05-15 19:52","ReadLastConfirmedOp.java","40724","116098","156822","","313644"
"2012-02-13 15:46","ReadLastConfirmedOp.java","2237","11902","14139","1","28278"
"2012-04-02 12:38","ReadLastConfirmedOp.java","10040","27476","37516","1","75032"
"2017-06-01 23:58","ReadLastConfirmedOp.java","40847","119414","160261","","320522"
"2014-02-21 19:01","ReadLastConfirmedOp.java","18808","143512","162320","7","324640"
"2012-05-25 17:13","ReadLastConfirmedOp.java","12542","35136","47678","1","95356"
"2017-06-30 00:12","ReadLastConfirmedOp.java","40628","126560","167188","","334376"
"2012-08-27 14:43","ReadLastConfirmedOp.java","14370","61467","75837","2","151674"
"2012-09-14 15:42","ReadLastConfirmedOp.java","14779","68854","83633","2","167266"
"2011-11-16 17:05","ReadLastConfirmedOp.java","2664","4112","6776","","13552"
"2011-11-17 11:16","ReadLastConfirmedOp.java","2901","4992","7893","","15786"
"2017-05-15 19:52","ReadLastConfirmedOp.java","40538","118003","158541","","317082"
"2012-02-13 15:46","ReadLastConfirmedOp.java","4592","16348","20940","1","41880"
"2012-04-02 12:38","ReadLastConfirmedOp.java","11781","31308","43089","1","86178"
"2017-06-01 23:58","ReadLastConfirmedOp.java","40613","121271","161884","","323768"
"2014-02-21 19:01","ReadLastConfirmedOp.java","19277","146072","165349","7","330698"
"2017-06-30 00:12","PerChannelBookieClient.java","3844","14965","18809","","37618"
"2017-07-04 06:27","PerChannelBookieClient.java","4136","17218","21354","","42708"
"2017-05-15 19:52","PerChannelBookieClient.java","1608","4262","5870","","11740"
"2017-07-28 20:12","PerChannelBookieClient.java","5697","23373","29070","","58140"
"2017-08-02 00:49","PerChannelBookieClient.java","9121","40409","49530","","99060"
"2017-06-21 19:58","PerChannelBookieClient.java","3445","11422","14867","","29734"
"2017-06-01 23:58","PerChannelBookieClient.java","2935","8782","11717","","23434"
"2017-04-20 19:55","PerChannelBookieClient.java","23","44","67","","134"
"2017-03-23 00:48","ClientConfiguration.java","111395","50507","161902","","323804"
"2016-04-05 08:45","ClientConfiguration.java","107981","23973","131954","","263908"
"2017-03-28 22:35","ClientConfiguration.java","111402","54766","166168","","332336"
"2017-01-31 02:14","ClientConfiguration.java","111283","44586","155869","","311738"
"2017-04-15 13:58","ClientConfiguration.java","111600","56064","167664","","335328"
"2017-03-23 00:59","ClientConfiguration.java","111402","50526","161928","","323856"
"2017-05-15 19:52","ClientConfiguration.java","112424","59542","171966","","343932"
"2016-10-13 07:50","ClientConfiguration.java","111067","36283","147350","","294700"
"2017-06-21 19:58","ClientConfiguration.java","113686","66127","179813","","359626"
"2017-06-05 21:48","ClientConfiguration.java","113524","64577","178101","","356202"
"2017-06-21 19:50","ClientConfiguration.java","113681","66012","179693","","359386"
"2017-08-02 00:49","ClientConfiguration.java","117771","93523","211294","","422588"
"2017-08-01 08:34","ClientConfiguration.java","117216","90383","207599","","415198"
"2017-06-30 00:12","ClientConfiguration.java","113958","69543","183501","","367002"
"2014-09-18 06:47","ClientConfiguration.java","1819","11323","13142","","26284"
"2017-07-04 06:27","ClientConfiguration.java","114110","71656","185766","","371532"
"2017-01-31 04:01","ClientConfiguration.java","111289","50061","161350","","322700"
"2015-10-06 10:05","ClientConfiguration.java","3432","17369","20801","","41602"
"2015-10-06 10:48","ClientConfiguration.java","3438","17601","21039","","42078"
"2016-02-09 08:32","ClientConfiguration.java","3619","19647","23266","","46532"
"2014-12-06 07:54","ClientConfiguration.java","2090","12512","14602","","29204"
"2016-08-01 08:04","ClientConfiguration.java","108390","26836","135226","","270452"
"2017-08-02 00:49","PerChannelBookieClientFactory.java","117771","93523","211294","","422588"
"2017-07-04 06:27","Bookie.java","663","4496","5159","","10318"
"2017-07-07 08:19","Bookie.java","803","6599","7402","","14804"
"2017-08-02 00:49","Bookie.java","5929","27968","33897","","67794"
"2017-08-02 00:49","Bookie.java","5256","21499","26755","","53510"
"2012-12-18 12:00","ZkLedgerUnderreplicationManager.java","5830","41675","47505","2","95010"
"2016-04-27 21:11","ZkLedgerUnderreplicationManager.java","59135","64685","123820","","247640"
"2016-07-14 23:02","ZkLedgerUnderreplicationManager.java","59285","65820","125105","","250210"
"2017-07-07 05:11","ZkLedgerUnderreplicationManager.java","61519","109499","171018","","342036"
"2013-08-22 16:40","ZkLedgerUnderreplicationManager.java","9320","87075","96395","5","192790"
"2017-06-28 23:28","ZkLedgerUnderreplicationManager.java","61423","104382","165805","","331610"
"2013-06-15 19:05","ZkLedgerUnderreplicationManager.java","9228","85293","94521","5","189042"
"2017-06-01 23:58","ZkLedgerUnderreplicationManager.java","61347","100412","161759","","323518"
"2014-08-18 23:03","ZkLedgerUnderreplicationManager.java","11605","109322","120927","","241854"
"2012-10-04 12:40","ZkLedgerUnderreplicationManager.java","3879","20117","23996","2","47992"
"2013-01-04 11:32","ZkLedgerUnderreplicationManager.java","7030","44886","51916","2","103832"
"2014-06-03 12:35","ZkLedgerUnderreplicationManager.java","11203","100983","112186","7","224372"
"2014-06-02 11:54","ZkLedgerUnderreplicationManager.java","11198","100510","111708","7","223416"
"2017-03-28 22:40","ZkLedgerUnderreplicationManager.java","60194","92755","152949","","305898"
"2012-10-10 12:29","ZkLedgerUnderreplicationManager.java","3890","21732","25622","2","51244"
"2012-10-16 17:01","ZkLedgerUnderreplicationManager.java","3892","21901","25793","2","51586"
"2016-04-27 09:55","ZkLedgerUnderreplicationManager.java","59135","64685","123820","","247640"
"2012-12-14 20:26","ZkLedgerUnderreplicationManager.java","5790","41128","46918","2","93836"
"2012-12-14 11:18","ZkLedgerUnderreplicationManager.java","5787","41013","46800","2","93600"
"2012-12-08 11:42","ZkLedgerUnderreplicationManager.java","5487","37270","42757","2","85514"
"2017-08-02 00:49","ClientConfiguration.java","5648","25815","31463","","62926"
"2017-08-01 08:34","ClientConfiguration.java","4709","22291","27000","","54000"
"2017-07-04 06:27","ClientConfiguration.java","343","2304","2647","","5294"
"2013-02-08 19:08","HardLink.java","13125","107597","120722","4","241444"
"2017-01-31 04:01","Bookie.java","112605","62295","174900","","349800"
"2017-03-28 22:37","Bookie.java","112706","67203","179909","","359818"
"2016-01-26 22:11","Bookie.java","6021","32835","38856","","77712"
"2015-03-18 07:38","Bookie.java","5263","28825","34088","","68176"
"2015-04-21 09:17","Bookie.java","5265","28929","34194","","68388"
"2014-09-23 17:53","Bookie.java","4864","25369","30233","","60466"
"2017-07-04 06:27","Bookie.java","114955","83419","198374","","396748"
"2017-06-05 22:25","Bookie.java","114602","77280","191882","","383764"
"2014-02-06 09:25","Bookie.java","3081","9292","12373","7","24746"
"2014-04-29 22:07","Bookie.java","3505","13221","16726","7","33452"
"2013-12-06 07:39","Bookie.java","1554","5510","7064","6","14128"
"2014-08-02 20:02","Bookie.java","4363","22776","27139","","54278"
"2013-10-02 07:01","Bookie.java","55","256","311","5","622"
"2017-06-28 23:24","Bookie.java","114674","79305","193979","","387958"
"2017-07-07 08:19","Bookie.java","114946","85373","200319","","400638"
"2014-01-21 17:26","Bookie.java","2048","7741","9789","6","19578"
"2013-10-12 05:42","Bookie.java","1121","2055","3176","6","6352"
"2013-10-22 16:21","Bookie.java","1473","3174","4647","6","9294"
"2017-05-16 00:31","Bookie.java","113658","72112","185770","","371540"
"2014-02-05 22:43","Bookie.java","3076","9279","12355","7","24710"
"2014-08-18 23:03","Bookie.java","4736","24617","29353","","58706"
"2014-05-09 14:04","Bookie.java","3523","13880","17403","7","34806"
"2017-06-01 23:58","Bookie.java","114447","75676","190123","","380246"
"2017-08-02 00:49","Bookie.java","118141","104811","222952","","445904"
"2013-12-02 18:45","Bookie.java","1536","5340","6876","6","13752"
"2016-11-18 00:18","Bookie.java","112543","49132","161675","","323350"
"2017-03-28 22:35","Bookie.java","112687","66969","179656","","359312"
"2016-07-14 23:02","Bookie.java","109875","38574","148449","","296898"
"2017-06-05 20:30","Bookie.java","114508","76095","190603","","381206"
"2016-11-30 00:02","Bookie.java","112569","49688","162257","","324514"
"2017-03-22 22:54","Bookie.java","112687","62665","175352","","350704"
"2012-12-12 11:20","BookieRecoveryTest.java","1397","2449","3846","2","7692"
"2017-06-30 00:12","BookieRecoveryTest.java","80950","93405","174355","","348710"
"2014-07-24 01:41","BookieRecoveryTest.java","8825","66738","75563","","151126"
"2017-04-11 20:15","BookieRecoveryTest.java","79453","80147","159600","","319200"
"2017-05-15 19:52","BookieRecoveryTest.java","79946","83934","163880","","327760"
"2012-12-10 16:02","BookieRecoveryTest.java","1349","1351","2700","2","5400"
"2013-08-13 14:32","BookieRecoveryTest.java","6078","51659","57737","5","115474"
"2014-02-05 22:43","BookieRecoveryTest.java","8222","60377","68599","7","137198"
"2015-09-15 10:38","BookKeeper.java","5941","30377","36318","","72636"
"2015-10-22 09:22","BookKeeper.java","6010","31826","37836","","75672"
"2017-01-31 04:01","BookKeeper.java","112653","62248","174901","","349802"
"2015-07-10 22:48","BookKeeper.java","5520","29654","35174","","70348"
"2017-06-30 00:12","BookKeeper.java","114907","81315","196222","","392444"
"2014-02-06 09:21","BookKeeper.java","3045","9157","12202","7","24404"
"2014-01-21 05:19","BookKeeper.java","1925","7230","9155","6","18310"
"2014-02-21 19:01","BookKeeper.java","3225","10496","13721","7","27442"
"2016-10-13 07:50","BookKeeper.java","112472","48511","160983","","321966"
"2017-06-21 21:00","BookKeeper.java","114718","78655","193373","","386746"
"2017-03-28 22:35","BookKeeper.java","112739","66926","179665","","359330"
"2016-07-11 23:01","BookKeeper.java","109857","38427","148284","","296568"
"2016-10-13 09:27","BookKeeper.java","112592","48617","161209","","322418"
"2017-07-28 20:12","BookKeeper.java","115696","88659","204355","","408710"
"2017-05-15 19:52","BookKeeper.java","113609","71550","185159","","370318"
"2015-04-21 09:17","PendingAddOp.java","2903","19201","22104","","44208"
"2015-10-06 10:48","PendingAddOp.java","3727","21442","25169","","50338"
"2015-10-22 09:22","PendingAddOp.java","3755","22300","26055","","52110"
"2017-06-30 00:12","PendingAddOp.java","113438","72575","186013","","372026"
"2017-08-02 00:49","PendingAddOp.java","117144","96448","213592","","427184"
"2017-05-15 19:52","PendingAddOp.java","111919","62589","174508","","349016"
"2013-08-21 13:19","BookKeeperAdmin.java","18477","137583","156060","5","312120"
"2017-10-17 09:32","BookKeeperAdmin.java","41938","145820","187758","","375516"
"2017-06-01 23:58","BookKeeperAdmin.java","40373","120803","161176","","322352"
"2017-04-11 20:19","BookKeeperAdmin.java","40105","114050","154155","","308310"
"2014-02-21 19:01","BookKeeperAdmin.java","18870","145437","164307","7","328614"
"2014-02-05 22:43","BookKeeperAdmin.java","18838","144242","163080","7","326160"
"2012-03-31 10:58","BookKeeperAdmin.java","11072","30233","41305","1","82610"
"2017-07-07 05:11","BookKeeperAdmin.java","40416","129761","170177","","340354"
"2011-11-18 11:18","BookKeeperAdmin.java","2545","5696","8241","","16482"
"2011-11-15 19:42","BookKeeperAdmin.java","1566","2051","3617","","7234"
"2013-02-26 04:12","BookKeeperAdmin.java","18129","129539","147668","4","295336"
"2016-11-09 03:05","BookKeeperAdmin.java","40104","95759","135863","","271726"
"2016-11-30 00:07","BookKeeperAdmin.java","40102","96421","136523","","273046"
"2016-09-10 21:01","BookKeeperAdmin.java","40023","91993","132016","","264032"
"2016-07-14 23:02","BookKeeperAdmin.java","40020","87920","127940","","255880"
"2016-10-13 09:27","BookKeeperAdmin.java","40104","95425","135529","","271058"
"2012-11-30 04:54","BookKeeperAdmin.java","16594","89160","105754","2","211508"
"2012-07-18 17:00","BookKeeperAdmin.java","13312","46989","60301","2","120602"
"2013-02-08 19:08","BookKeeperAdmin.java","17427","128809","146236","4","292472"
"2011-11-28 19:25","BookKeeperAdmin.java","2895","8790","11685","","23370"
"2016-03-16 05:03","BookKeeperAdmin.java","39982","83390","123372","","246744"
"2016-03-08 07:18","BookKeeperAdmin.java","19272","166966","186238","","372476"
"2011-11-16 17:05","BookKeeperAdmin.java","1661","2881","4542","","9084"
"2014-12-06 08:03","BookKeeperAdmin.java","19202","159827","179029","","358058"
"2012-09-03 18:54","BookKeeperAdmin.java","13965","65685","79650","2","159300"
"2014-04-24 10:43","BookKeeperAdmin.java","18875","147414","166289","7","332578"
"2012-10-05 16:24","BookKeeperAdmin.java","15800","74589","90389","2","180778"
"2012-09-07 07:04","BookKeeperAdmin.java","13983","67169","81152","2","162304"
"2014-09-06 07:51","BookKeeperAdmin.java","19185","158673","177858","","355716"
"2012-08-19 11:39","BookKeeperAdmin.java","13803","59664","73467","2","146934"
"2012-05-10 14:47","BookKeeperAdmin.java","11494","32606","44100","1","88200"
"2013-05-10 12:45","BookKeeperAdmin.java","18311","131542","149853","5","299706"
"2012-08-24 22:44","BookKeeperAdmin.java","13805","60558","74363","2","148726"
"2016-07-14 23:02","Value.java","110113","46631","156744","","313488"
"2017-05-26 16:52","Value.java","112363","80554","192917","","385834"
"2016-07-11 23:01","BookieWriteLedgerTest.java","107975","24679","132654","","265308"
"2015-10-22 09:22","BookieWriteLedgerTest.java","2982","16932","19914","","39828"
"2012-12-24 05:50","LedgerManagerFactory.java","6450","42693","49143","2","98286"
"2017-06-01 23:58","LedgerManagerFactory.java","61347","100412","161759","","323518"
"2012-09-07 07:04","LedgerManagerFactory.java","1215","13036","14251","2","28502"
"2015-09-15 10:38","LedgerManagerFactory.java","12294","114661","126955","","253910"
"2014-07-24 01:41","AsyncLedgerOpsTest.java","19016","148315","167331","","334662"
"2012-06-19 12:39","AsyncLedgerOpsTest.java","11183","34082","45265","2","90530"
"2017-06-30 00:12","PerChannelBookieClient.java","2341","10808","13149","","26298"
"2017-07-04 06:27","PerChannelBookieClient.java","2652","13080","15732","","31464"
"2017-07-28 20:12","PerChannelBookieClient.java","4229","19251","23480","","46960"
"2017-08-02 00:49","PerChannelBookieClient.java","7739","36373","44112","","88224"
"2017-06-21 19:58","PerChannelBookieClient.java","1939","7262","9201","","18402"
"2017-06-01 23:58","PerChannelBookieClient.java","1414","4607","6021","","12042"
"2017-06-01 23:58","ReadEntryProcessor.java","1414","4607","6021","","12042"
"2017-05-16 00:31","ReadEntryProcessor.java","263","681","944","","1888"
"2016-02-23 19:16","LedgerMetadataImpl.java","6223","33708","39931","","79862"
"2017-06-01 23:58","LedgerMetadataImpl.java","114493","76093","190586","","381172"
"2017-07-28 20:12","LedgerMetadataImpl.java","115674","89103","204777","","409554"
"2016-07-11 23:01","LedgerMetadataImpl.java","109890","38926","148816","","297632"
"2015-10-06 10:05","TestPerChannelBookieClient.java","3740","22392","26132","","52264"
"2014-07-24 01:41","TestPerChannelBookieClient.java","1183","6941","8124","","16248"
"2014-05-27 13:56","TestPerChannelBookieClient.java","695","5410","6105","7","12210"
"2017-05-16 00:31","TestPerChannelBookieClient.java","111999","64250","176249","","352498"
"2017-01-31 02:14","TestPerChannelBookieClient.java","110820","48838","159658","","319316"
"2016-04-05 08:45","TestPerChannelBookieClient.java","107546","28253","135799","","271598"
"2017-05-15 19:52","TestPerChannelBookieClient.java","111874","63707","175581","","351162"
"2016-07-14 23:02","BenchThroughputLatency.java","66115","60304","126419","","252838"
"2013-10-29 05:14","BenchThroughputLatency.java","10352","77679","88031","6","176062"
"2013-10-14 16:43","BenchThroughputLatency.java","10169","76627","86796","6","173592"
"2014-07-15 09:09","BenchThroughputLatency.java","11400","88875","100275","","200550"
"2013-02-08 19:08","BenchThroughputLatency.java","7585","65256","72841","4","145682"
"2014-12-10 19:43","ReadOnlyBookieTest.java","5494","34414","39908","","79816"
"2016-03-08 06:49","ReadOnlyBookieTest.java","6503","41662","48165","","96330"
"2016-04-14 00:51","ReadOnlyBookieTest.java","109325","43858","153183","","306366"
"2014-07-24 01:41","ReadOnlyBookieTest.java","4722","24014","28736","","57472"
"2014-01-22 14:35","ReadOnlyBookieTest.java","3213","16613","19826","6","39652"
"2014-01-21 17:26","ReadOnlyBookieTest.java","3085","16109","19194","6","38388"
"2016-04-07 21:39","ReadOnlyBookieTest.java","109314","43806","153120","","306240"
"2016-02-09 08:12","FlatLedgerManager.java","16107","143361","159468","","318936"
"2013-04-04 11:21","FlatLedgerManager.java","13351","106976","120327","5","240654"
"2012-12-24 05:50","FlatLedgerManager.java","11231","70119","81350","2","162700"
"2017-06-01 23:58","EntryLogger.java","113339","47092","160431","","320862"
"2017-11-08 12:27","EntryLogger.java","132644","99869","232513","","465026"
"2017-01-31 02:11","EntryLogger.java","110714","26847","137561","","275122"
"2017-03-23 00:48","EntryLogger.java","110877","33431","144308","","288616"
"2016-07-14 23:02","EntryLogger.java","105495","6718","112213","","224426"
"2015-09-15 10:38","TestWatchEnsembleChange.java","2902","15472","18374","","36748"
"2012-08-17 12:41","RoundRobinDistributionSchedule.java","12604","43258","55862","2","111724"
"2012-09-12 11:59","RoundRobinDistributionSchedule.java","13319","55502","68821","2","137642"
"2014-12-05 17:51","RoundRobinDistributionSchedule.java","20144","148952","169096","","338192"
"2017-06-30 00:12","RoundRobinDistributionSchedule.java","46370","120546","166916","","333832"
"2013-10-22 16:21","BufferedChannel.java","1821","4724","6545","6","13090"
"2013-10-12 05:42","BufferedChannel.java","1472","3608","5080","6","10160"
"2014-01-22 14:35","BufferedChannel.java","2537","9808","12345","6","24690"
"2013-08-22 16:40","ZkUtils.java","18951","132176","151127","5","302254"
"2017-06-12 17:20","ZkUtils.java","42687","118999","161686","","323372"
"2012-12-24 05:50","ZkUtils.java","17146","88859","106005","2","212010"
"2017-03-28 22:40","ZkUtils.java","42181","110212","152393","","304786"
"2012-09-07 07:04","ZkUtils.java","13543","60834","74377","2","148754"
"2017-08-16 03:41","TestRackawareEnsemblePlacementPolicy.java","10268","45759","56027","","112054"
"2017-07-04 06:27","FileInfo.java","4508","22916","27424","","54848"
"2017-06-01 23:58","FileInfo.java","3336","14509","17845","","35690"
"2017-07-17 23:27","FileInfo.java","4786","26301","31087","","62174"
"2017-05-16 00:31","FileInfo.java","2284","10682","12966","","25932"
"2017-05-16 00:31","ReadLacProcessorV3.java","263","681","944","","1888"
"2016-01-26 22:11","BookieZKExpireTest.java","1301","6526","7827","","15654"
"2015-04-21 09:17","PendingAddOp.java","2945","20406","23351","","46702"
"2015-10-06 10:48","PendingAddOp.java","3746","22624","26370","","52740"
"2015-10-22 09:22","PendingAddOp.java","3774","23482","27256","","54512"
"2017-06-30 00:12","PendingAddOp.java","113338","73638","186976","","373952"
"2014-02-21 19:01","PendingAddOp.java","201","1364","1565","7","3130"
"2017-08-02 00:49","PendingAddOp.java","117040","97507","214547","","429094"
"2017-05-15 19:52","PendingAddOp.java","111874","63707","175581","","351162"
"2014-01-21 05:19","PerChannelBookieClient.java","8057","59926","67983","6","135966"
"2013-10-22 07:35","PerChannelBookieClient.java","7740","55255","62995","6","125990"
"2014-01-09 07:30","PerChannelBookieClient.java","7907","58344","66251","6","132502"
"2017-06-30 00:12","PerChannelBookieClient.java","81146","94118","175264","","350528"
"2014-05-27 13:56","PerChannelBookieClient.java","9010","66397","75407","7","150814"
"2017-07-04 06:27","PerChannelBookieClient.java","81235","96168","177403","","354806"
"2017-01-31 04:01","PerChannelBookieClient.java","79472","75631","155103","","310206"
"2015-10-06 10:05","PerChannelBookieClient.java","10538","81862","92400","","184800"
"2016-04-05 18:47","PerChannelBookieClient.java","78020","51641","129661","","259322"
"2017-04-15 13:58","PerChannelBookieClient.java","79660","81511","161171","","322342"
"2017-05-15 19:52","PerChannelBookieClient.java","80147","84652","164799","","329598"
"2016-04-05 08:45","PerChannelBookieClient.java","78018","51397","129415","","258830"
"2017-07-28 20:12","PerChannelBookieClient.java","81835","101362","183197","","366394"
"2017-01-31 02:14","PerChannelBookieClient.java","79459","70149","149608","","299216"
"2017-03-28 22:35","PerChannelBookieClient.java","79543","80294","159837","","319674"
"2017-03-23 00:48","PerChannelBookieClient.java","79549","76048","155597","","311194"
"2013-01-10 19:13","PerChannelBookieClient.java","4445","11756","16201","2","32402"
"2014-07-25 00:34","PerChannelBookieClient.java","9553","73805","83358","","166716"
"2017-08-02 00:49","PerChannelBookieClient.java","84219","117358","201577","","403154"
"2017-06-21 19:58","PerChannelBookieClient.java","81041","90869","171910","","343820"
"2017-06-01 23:58","PerChannelBookieClient.java","80937","88635","169572","","339144"
"2013-10-29 05:14","PerChannelBookieClient.java","7867","56173","64040","6","128080"
"2013-06-28 17:27","PerChannelBookieClient.java","6557","51564","58121","5","116242"
"2014-02-21 19:01","PerChannelBookieClient.java","8890","62725","71615","7","143230"
"2014-02-05 22:43","PerChannelBookieClient.java","8785","61457","70242","7","140484"
"2017-04-20 19:55","PerChannelBookieClient.java","79661","81533","161194","","322388"
"2013-09-11 00:34","PerChannelBookieClient.java","6765","53234","59999","5","119998"
"2013-08-20 12:51","PerChannelBookieClient.java","6657","52839","59496","5","118992"
"2014-02-05 22:43","TestReplicationWorker.java","11245","86527","97772","7","195544"
"2013-05-31 12:02","TestReplicationWorker.java","9263","72471","81734","5","163468"
"2013-06-15 19:05","TestReplicationWorker.java","9336","76644","85980","5","171960"
"2012-12-18 12:00","TestReplicationWorker.java","5782","32870","38652","2","77304"
"2013-01-14 16:59","TestReplicationWorker.java","7584","38131","45715","2","91430"
"2016-04-27 09:00","TestReplicationWorker.java","64429","60723","125152","","250304"
"2012-08-31 15:25","TestReplicationWorker.java","96","243","339","2","678"
"2012-09-12 20:34","TestReplicationWorker.java","739","4522","5261","2","10522"
"2012-12-08 11:18","TestReplicationWorker.java","5243","28269","33512","2","67024"
"2012-10-05 16:24","TestReplicationWorker.java","3482","12149","15631","2","31262"
"2015-07-10 22:48","TestReplicationWorker.java","12462","105770","118232","","236464"
"2014-07-24 01:41","TestReplicationWorker.java","11781","92821","104602","","209204"
"2016-07-14 23:02","BenchThroughputLatency.java","47652","74507","122159","","244318"
"2013-10-29 05:14","BenchThroughputLatency.java","14316","114309","128625","6","257250"
"2013-10-14 16:43","BenchThroughputLatency.java","14162","113286","127448","6","254896"
"2012-09-12 11:59","BenchThroughputLatency.java","6318","38984","45302","2","90604"
"2012-06-12 17:37","BenchThroughputLatency.java","712","2544","3256","1","6512"
"2014-07-15 09:09","BenchThroughputLatency.java","14983","125124","140107","","280214"
"2013-02-08 19:08","BenchThroughputLatency.java","11847","102184","114031","4","228062"
"2017-07-07 08:19","GetBookieInfoProcessorV3.java","1351","10549","11900","","23800"
"2017-01-31 04:01","Bookie.java","111655","55652","167307","","334614"
"2017-03-28 22:37","Bookie.java","111795","60599","172394","","344788"
"2016-01-26 22:11","Bookie.java","4824","25945","30769","","61538"
"2015-03-18 07:38","Bookie.java","3917","21786","25703","","51406"
"2015-04-21 09:17","Bookie.java","3959","21930","25889","","51778"
"2014-09-23 17:53","Bookie.java","3444","18256","21700","","43400"
"2017-07-04 06:27","Bookie.java","114243","77014","191257","","382514"
"2017-06-05 22:25","Bookie.java","113842","70827","184669","","369338"
"2014-02-06 09:25","Bookie.java","1095","1613","2708","7","5416"
"2014-04-29 22:07","Bookie.java","1571","5594","7165","7","14330"
"2014-08-02 20:02","Bookie.java","2814","15534","18348","","36696"
"2017-06-28 23:24","Bookie.java","113937","72875","186812","","373624"
"2017-07-07 08:19","Bookie.java","114242","78976","193218","","386436"
"2017-05-16 00:31","Bookie.java","112808","65569","178377","","356754"
"2014-02-05 22:43","Bookie.java","1083","1593","2676","7","5352"
"2014-08-18 23:03","Bookie.java","3187","17375","20562","","41124"
"2014-05-09 14:04","Bookie.java","1589","6253","7842","7","15684"
"2017-06-01 23:58","Bookie.java","113631","69167","182798","","365596"
"2017-08-02 00:49","Bookie.java","117740","98717","216457","","432914"
"2016-11-18 00:18","Bookie.java","111581","42477","154058","","308116"
"2017-03-28 22:35","Bookie.java","111755","60344","172099","","344198"
"2016-07-14 23:02","Bookie.java","108887","31893","140780","","281560"
"2017-06-05 20:30","Bookie.java","113744","69638","183382","","366764"
"2016-11-30 00:02","Bookie.java","111606","43032","154638","","309276"
"2017-03-22 22:54","Bookie.java","111751","56036","167787","","335574"
"2017-06-01 23:58","EntryLogger.java","40340","120555","160895","","321790"
"2014-01-21 17:26","EntryLogger.java","18332","143011","161343","6","322686"
"2013-10-02 06:23","EntryLogger.java","18179","137176","155355","5","310710"
"2014-01-22 14:35","EntryLogger.java","18397","143452","161849","6","323698"
"2017-11-08 12:27","EntryLogger.java","42188","155875","198063","","396126"
"2013-10-22 07:44","EntryLogger.java","18239","138532","156771","6","313542"
"2012-03-16 10:41","EntryLogger.java","9683","26591","36274","1","72548"
"2012-06-13 16:57","EntryLogger.java","11254","35035","46289","","92578"
"2012-02-15 16:11","EntryLogger.java","2940","14265","17205","1","34410"
"2013-05-04 14:22","EntryLogger.java","17946","130632","148578","5","297156"
"2011-11-18 11:18","EntryLogger.java","1533","4469","6002","","12004"
"2011-12-16 12:43","EntryLogger.java","2447","8592","11039","1","22078"
"2012-03-08 12:13","EntryLogger.java","3204","16367","19571","1","39142"
"2017-01-31 02:11","EntryLogger.java","40071","102666","142737","","285474"
"2017-03-23 00:48","EntryLogger.java","40075","109091","149166","","298332"
"2016-07-14 23:02","EntryLogger.java","39975","87660","127635","","255270"
"2012-12-24 06:23","EntryLogger.java","16516","94131","110647","2","221294"
"2012-12-10 11:04","EntryLogger.java","16294","89326","105620","2","211240"
"2016-02-24 00:44","EntryLogger.java","18960","165422","184382","","368764"
"2011-11-17 11:16","EntryLogger.java","858","2506","3364","","6728"
"2015-04-21 10:02","EntryLogger.java","18921","161775","180696","","361392"
"2012-10-18 16:40","EntryLogger.java","15939","77678","93617","2","187234"
"2012-07-26 04:32","EntryLogger.java","12908","46449","59357","2","118714"
"2013-01-04 11:32","EntryLogger.java","16735","95741","112476","2","224952"
"2015-04-21 09:44","EntryLogger.java","18921","161591","180512","","361024"
"2012-05-09 10:39","EntryLogger.java","10670","31281","41951","1","83902"
"2012-05-07 18:48","EntryLogger.java","10662","30849","41511","1","83022"
"2012-05-10 14:47","EntryLogger.java","10914","31811","42725","1","85450"
"2012-05-17 19:07","EntryLogger.java","11190","33142","44332","1","88664"
"2014-07-24 01:41","TestWatchEnsembleChange.java","720","2006","2726","","5452"
"2015-09-15 10:38","TestWatchEnsembleChange.java","3534","17390","20924","","41848"
"2017-07-07 05:11","LedgerUnderreplicationManager.java","82269","92393","174662","","349324"
"2014-06-03 12:35","LedgerUnderreplicationManager.java","6042","57966","64008","7","128016"
"2017-01-31 04:01","Bookie.java","112101","60857","172958","","345916"
"2017-03-28 22:37","Bookie.java","112207","65770","177977","","355954"
"2016-01-26 22:11","Bookie.java","5442","31322","36764","","73528"
"2015-03-18 07:38","Bookie.java","4629","27257","31886","","63772"
"2015-04-21 09:17","Bookie.java","4631","27361","31992","","63984"
"2014-09-23 17:53","Bookie.java","4205","23776","27981","","55962"
"2017-07-04 06:27","Bookie.java","114520","82050","196570","","393140"
"2017-06-05 22:25","Bookie.java","114154","75898","190052","","380104"
"2014-02-06 09:25","Bookie.java","2373","7650","10023","7","20046"
"2014-04-29 22:07","Bookie.java","2831","11613","14444","7","28888"
"2013-12-06 07:39","Bookie.java","796","3818","4614","6","9228"
"2014-08-02 20:02","Bookie.java","3699","21178","24877","","49754"
"2017-06-28 23:24","Bookie.java","114231","77928","192159","","384318"
"2017-07-07 08:19","Bookie.java","114509","84002","198511","","397022"
"2014-01-21 17:26","Bookie.java","1306","6065","7371","6","14742"
"2013-10-22 16:21","Bookie.java","695","1462","2157","6","4314"
"2017-05-16 00:31","Bookie.java","113176","70696","183872","","367744"
"2014-02-05 22:43","Bookie.java","2368","7637","10005","7","20010"
"2014-08-18 23:03","Bookie.java","4072","23019","27091","","54182"
"2014-05-09 14:04","Bookie.java","2849","12272","15121","7","30242"
"2017-06-01 23:58","Bookie.java","113967","74262","188229","","376458"
"2017-08-02 00:49","Bookie.java","117767","103503","221270","","442540"
"2013-12-02 18:45","Bookie.java","761","3631","4392","6","8784"
"2016-11-18 00:18","Bookie.java","112037","47692","159729","","319458"
"2017-03-28 22:35","Bookie.java","112188","65536","177724","","355448"
"2016-07-14 23:02","Bookie.java","109358","37123","146481","","292962"
"2017-06-05 20:30","Bookie.java","114060","74713","188773","","377546"
"2016-11-30 00:02","Bookie.java","112062","48247","160309","","320618"
"2017-03-22 22:54","Bookie.java","112187","61231","173418","","346836"
"2017-06-21 19:58","LedgerRecoveryOp.java","114126","76492","190618","","381236"
"2017-06-21 21:00","LedgerRecoveryOp.java","114131","77170","191301","","382602"
"2017-06-21 19:50","LedgerRecoveryOp.java","114120","76376","190496","","380992"
"2016-10-13 07:50","LocalBookieEnsemblePlacementPolicy.java","110534","19537","130071","","260142"
"2017-03-28 22:35","LocalBookieEnsemblePlacementPolicy.java","111045","38196","149241","","298482"
"2017-07-28 20:12","LocalBookieEnsemblePlacementPolicy.java","115630","61557","177187","","354374"
"2012-12-24 05:50","InterleavedLedgerStorage.java","10294","65536","75830","2","151660"
"2012-12-18 13:04","InterleavedLedgerStorage.java","9901","65035","74936","2","149872"
"2016-11-18 00:18","InterleavedLedgerStorage.java","48136","81560","129696","","259392"
"2013-12-02 18:45","InterleavedLedgerStorage.java","13979","114618","128597","6","257194"
"2013-05-04 14:22","InterleavedLedgerStorage.java","12756","103291","116047","5","232094"
"2012-06-13 16:57","InterleavedLedgerStorage.java","168","1798","1966","","3932"
"2014-01-15 15:58","InterleavedLedgerStorage.java","14000","114983","128983","6","257966"
"2014-01-21 17:26","InterleavedLedgerStorage.java","14093","116621","130714","6","261428"
"2013-10-02 06:23","InterleavedLedgerStorage.java","13048","109894","122942","5","245884"
"2017-05-16 00:31","InterleavedLedgerStorage.java","48744","104033","152777","","305554"
"2014-08-02 20:02","InterleavedLedgerStorage.java","15040","130288","145328","","290656"
"2017-07-04 06:27","InterleavedLedgerStorage.java","49493","114792","164285","","328570"
"2012-10-18 16:40","InterleavedLedgerStorage.java","8847","48435","57282","2","114564"
"2015-04-21 09:55","InterleavedLedgerStorage.java","15343","136013","151356","","302712"
"2017-01-31 04:01","InterleavedLedgerStorage.java","48182","94707","142889","","285778"
"2016-03-08 06:49","InterleavedLedgerStorage.java","15787","140450","156237","","312474"
"2017-03-28 22:37","InterleavedLedgerStorage.java","48230","99562","147792","","295584"
"2015-04-21 09:17","InterleavedLedgerStorage.java","15327","135826","151153","","302306"
"2015-04-21 09:17","PendingAddOp.java","5265","28929","34194","","68388"
"2015-10-06 10:48","PendingAddOp.java","5964","31045","37009","","74018"
"2015-10-22 09:22","PendingAddOp.java","5991","31902","37893","","75786"
"2017-06-30 00:12","PendingAddOp.java","114845","81348","196193","","392386"
"2014-01-21 05:19","PendingAddOp.java","1962","7362","9324","6","18648"
"2014-02-21 19:01","PendingAddOp.java","3253","10619","13872","7","27744"
"2014-02-05 22:43","PendingAddOp.java","3076","9279","12355","7","24710"
"2013-10-14 18:32","PendingAddOp.java","1229","2256","3485","6","6970"
"2017-08-02 00:49","PendingAddOp.java","118141","104811","222952","","445904"
"2017-05-15 19:52","PendingAddOp.java","113551","71587","185138","","370276"
"2014-02-05 22:43","TestReplicationWorker.java","11294","86429","97723","7","195446"
"2013-05-31 12:02","TestReplicationWorker.java","9311","72372","81683","5","163366"
"2013-06-15 19:05","TestReplicationWorker.java","9384","76545","85929","5","171858"
"2012-12-18 12:00","TestReplicationWorker.java","5830","32771","38601","2","77202"
"2013-01-14 16:59","TestReplicationWorker.java","7632","38032","45664","2","91328"
"2016-04-27 09:00","TestReplicationWorker.java","64515","60662","125177","","250354"
"2012-09-12 20:34","TestReplicationWorker.java","644","4280","4924","2","9848"
"2012-12-08 11:18","TestReplicationWorker.java","5290","28169","33459","2","66918"
"2012-10-05 16:24","TestReplicationWorker.java","3529","12049","15578","2","31156"
"2015-07-10 22:48","TestReplicationWorker.java","12511","105672","118183","","236366"
"2014-07-24 01:41","TestReplicationWorker.java","11830","92723","104553","","209106"
"2017-01-31 04:01","Bookie.java","111574","59563","171137","","342274"
"2017-03-28 22:37","Bookie.java","111701","64497","176198","","352396"
"2016-01-26 22:11","Bookie.java","4847","29960","34807","","69614"
"2015-03-18 07:38","Bookie.java","4034","25895","29929","","59858"
"2015-04-21 09:17","Bookie.java","4036","25999","30035","","60070"
"2014-09-23 17:53","Bookie.java","3592","22396","25988","","51976"
"2017-07-04 06:27","Bookie.java","114075","80838","194913","","389826"
"2017-06-05 22:25","Bookie.java","113674","74651","188325","","376650"
"2014-02-06 09:25","Bookie.java","1744","6254","7998","7","15996"
"2014-04-29 22:07","Bookie.java","2202","10217","12419","7","24838"
"2013-12-06 07:39","Bookie.java","171","2426","2597","6","5194"
"2014-08-02 20:02","Bookie.java","3086","19798","22884","","45768"
"2017-06-28 23:24","Bookie.java","113769","76699","190468","","380936"
"2017-07-07 08:19","Bookie.java","114064","82790","196854","","393708"
"2014-01-21 17:26","Bookie.java","671","4663","5334","6","10668"
"2017-05-16 00:31","Bookie.java","112683","69436","182119","","364238"
"2014-02-05 22:43","Bookie.java","1739","6241","7980","7","15960"
"2014-08-18 23:03","Bookie.java","3459","21639","25098","","50196"
"2014-05-09 14:04","Bookie.java","2220","10876","13096","7","26192"
"2017-06-01 23:58","Bookie.java","113485","73013","186498","","372996"
"2017-08-02 00:49","Bookie.java","117442","102411","219853","","439706"
"2013-12-02 18:45","Bookie.java","136","2239","2375","6","4750"
"2016-11-18 00:18","Bookie.java","111510","46398","157908","","315816"
"2017-03-28 22:35","Bookie.java","111662","64243","175905","","351810"
"2016-07-14 23:02","Bookie.java","108831","35829","144660","","289320"
"2017-06-05 20:30","Bookie.java","113578","73464","187042","","374084"
"2016-11-30 00:02","Bookie.java","111535","46953","158488","","316976"
"2017-03-22 22:54","Bookie.java","111661","59938","171599","","343198"
"2015-04-21 09:17","PendingAddOp.java","4523","27160","31683","","63366"
"2015-10-06 10:48","PendingAddOp.java","5276","29330","34606","","69212"
"2015-10-22 09:22","PendingAddOp.java","5304","30188","35492","","70984"
"2017-06-30 00:12","PendingAddOp.java","114324","79800","194124","","388248"
"2014-01-21 05:19","PendingAddOp.java","1112","5485","6597","6","13194"
"2014-02-21 19:01","PendingAddOp.java","2441","8780","11221","7","22442"
"2014-02-05 22:43","PendingAddOp.java","2261","7437","9698","7","19396"
"2017-08-02 00:49","PendingAddOp.java","117699","103342","221041","","442082"
"2017-05-15 19:52","PendingAddOp.java","112963","69972","182935","","365870"
"2016-02-09 08:28","BookieShell.java","3908","24645","28553","","57106"
"2016-03-16 05:03","BookieShell.java","107526","25530","133056","","266112"
"2014-12-06 07:47","BookieShell.java","2503","17520","20023","","40046"
"2014-12-06 08:03","BookieShell.java","2510","17731","20241","","40482"
"2014-09-29 16:29","BookieShell.java","2430","17094","19524","","39048"
"2014-06-03 12:35","BookieShell.java","839","6580","7419","7","14838"
"2015-01-13 13:06","BookieShell.java","2844","19910","22754","","45508"
"2017-06-01 23:58","BookieShell.java","112825","67851","180676","","361352"
"2017-07-07 05:11","BookieShell.java","113496","77437","190933","","381866"
"2017-01-11 07:37","BookieShell.java","110818","47991","158809","","317618"
"2016-12-21 01:42","BookieShell.java","110815","47630","158445","","316890"
"2017-01-11 07:34","BookieShell.java","110818","47867","158685","","317370"
"2016-11-30 00:02","BookieShell.java","110782","41698","152480","","304960"
"2017-01-30 23:25","BookieShell.java","110823","48171","158994","","317988"
"2017-03-28 22:35","BookieShell.java","110928","59007","169935","","339870"
"2017-01-30 21:31","BookieShell.java","110820","48060","158880","","317760"
"2017-03-22 22:54","BookieShell.java","110918","54693","165611","","331222"
"2016-02-09 08:28","BookieShell.java","6121","32942","39063","","78126"
"2016-03-16 05:03","BookieShell.java","109579","33667","143246","","286492"
"2014-12-06 07:47","BookieShell.java","4894","25995","30889","","61778"
"2014-12-06 08:03","BookieShell.java","4900","26205","31105","","62210"
"2014-09-29 16:29","BookieShell.java","4837","25585","30422","","60844"
"2014-06-03 12:35","BookieShell.java","3685","15510","19195","7","38390"
"2014-02-05 22:43","BookieShell.java","3050","9134","12184","7","24368"
"2015-01-13 13:06","BookieShell.java","5195","28345","33540","","67080"
"2017-06-01 23:58","BookieShell.java","114504","75614","190118","","380236"
"2017-07-07 05:11","BookieShell.java","115001","85026","200027","","400054"
"2017-01-11 07:37","BookieShell.java","112639","55896","168535","","337070"
"2016-12-21 01:42","BookieShell.java","112636","55535","168171","","336342"
"2017-01-11 07:34","BookieShell.java","112639","55772","168411","","336822"
"2016-11-30 00:02","BookieShell.java","112612","49612","162224","","324448"
"2017-01-30 23:25","BookieShell.java","112640","56072","168712","","337424"
"2017-03-28 22:35","BookieShell.java","112738","66901","179639","","359278"
"2017-01-30 21:31","BookieShell.java","112639","55963","168602","","337204"
"2017-03-22 22:54","BookieShell.java","112734","62593","175327","","350654"
"2015-09-15 10:38","LedgerManager.java","6053","37440","43493","","86986"
"2014-01-17 18:13","LedgerManager.java","2537","13897","16434","6","32868"
"2017-07-04 06:27","Bookie.java","2419","12429","14848","","29696"
"2017-06-05 22:25","Bookie.java","1604","5828","7432","","14864"
"2017-06-28 23:24","Bookie.java","1763","7940","9703","","19406"
"2017-07-07 08:19","Bookie.java","2510","14483","16993","","33986"
"2017-06-01 23:58","Bookie.java","1160","3935","5095","","10190"
"2017-08-02 00:49","Bookie.java","7527","35743","43270","","86540"
"2017-06-05 20:30","Bookie.java","1328","4461","5789","","11578"
"2016-07-14 23:02","BenchThroughputLatency.java","47482","75064","122546","","245092"
"2013-10-29 05:14","BenchThroughputLatency.java","14541","115261","129802","6","259604"
"2013-10-14 16:43","BenchThroughputLatency.java","14387","114238","128625","6","257250"
"2012-09-12 11:59","BenchThroughputLatency.java","6610","40003","46613","2","93226"
"2012-05-09 13:20","BenchThroughputLatency.java","335","1062","1397","1","2794"
"2012-06-12 17:37","BenchThroughputLatency.java","1048","3607","4655","1","9310"
"2014-07-15 09:09","BenchThroughputLatency.java","15205","126073","141278","","282556"
"2013-02-08 19:08","BenchThroughputLatency.java","12094","103158","115252","4","230504"
"2016-10-13 07:50","LocalBookieEnsemblePlacementPolicy.java","110548","19742","130290","","260580"
"2017-03-28 22:35","LocalBookieEnsemblePlacementPolicy.java","111059","38401","149460","","298920"
"2017-07-28 20:12","LocalBookieEnsemblePlacementPolicy.java","115632","61750","177382","","354764"
"2016-02-24 00:34","LocalBookieEnsemblePlacementPolicy.java","40","231","271","","542"
"2017-06-30 00:12","BookieRecoveryTest.java","4035","15796","19831","","39662"
"2017-05-15 19:52","BookieRecoveryTest.java","1805","5099","6904","","13808"
"2017-06-21 19:58","BookieClientTest.java","114763","56533","171296","","342592"
"2017-03-28 22:35","BookieClientTest.java","112086","44779","156865","","313730"
"2016-12-17 02:39","BookieClientTest.java","111862","32838","144700","","289400"
"2017-05-15 19:52","BookieClientTest.java","113296","49743","163039","","326078"
"2015-10-06 10:05","BookieClientTest.java","1219","4485","5704","","11408"
"2017-06-01 23:58","SaslClientState.java","1148","2055","3203","","6406"
"2012-12-18 12:00","ZkLedgerUnderreplicationManager.java","3466","23073","26539","2","53078"
"2016-04-27 21:11","ZkLedgerUnderreplicationManager.java","69083","58395","127478","","254956"
"2016-07-14 23:02","ZkLedgerUnderreplicationManager.java","69264","59561","128825","","257650"
"2017-07-07 05:11","ZkLedgerUnderreplicationManager.java","71991","103733","175724","","351448"
"2013-08-22 16:40","ZkLedgerUnderreplicationManager.java","7316","68833","76149","5","152298"
"2017-06-28 23:28","ZkLedgerUnderreplicationManager.java","71839","98560","170399","","340798"
"2013-06-15 19:05","ZkLedgerUnderreplicationManager.java","7172","66999","74171","5","148342"
"2017-06-01 23:58","ZkLedgerUnderreplicationManager.java","71763","94590","166353","","332706"
"2014-08-18 23:03","ZkLedgerUnderreplicationManager.java","9932","91411","101343","","202686"
"2013-01-04 11:32","ZkLedgerUnderreplicationManager.java","4805","26423","31228","2","62456"
"2014-06-03 12:35","ZkLedgerUnderreplicationManager.java","9474","83016","92490","7","184980"
"2014-06-02 11:54","ZkLedgerUnderreplicationManager.java","9460","82534","91994","7","183988"
"2017-03-28 22:40","ZkLedgerUnderreplicationManager.java","70495","86818","157313","","314626"
"2012-10-10 12:29","ZkLedgerUnderreplicationManager.java","202","1806","2008","2","4016"
"2012-10-16 17:01","ZkLedgerUnderreplicationManager.java","207","1978","2185","2","4370"
"2016-04-27 09:55","ZkLedgerUnderreplicationManager.java","69083","58395","127478","","254956"
"2012-12-14 20:26","ZkLedgerUnderreplicationManager.java","3225","22325","25550","2","51100"
"2012-12-14 11:18","ZkLedgerUnderreplicationManager.java","3216","22204","25420","2","50840"
"2012-12-08 11:42","ZkLedgerUnderreplicationManager.java","2907","18452","21359","2","42718"
"2017-06-30 00:12","BookieRecoveryTest.java","2341","10808","13149","","26298"
"2015-10-06 10:05","TestPerChannelBookieClient.java","6076","31218","37294","","74588"
"2014-07-24 01:41","TestPerChannelBookieClient.java","4172","16420","20592","","41184"
"2014-05-27 13:56","TestPerChannelBookieClient.java","3737","14942","18679","7","37358"
"2014-02-05 22:43","TestPerChannelBookieClient.java","3224","9714","12938","7","25876"
"2017-05-16 00:31","TestPerChannelBookieClient.java","113730","72471","186201","","372402"
"2017-01-31 02:14","TestPerChannelBookieClient.java","112693","57201","169894","","339788"
"2016-04-05 08:45","TestPerChannelBookieClient.java","109650","36847","146497","","292994"
"2017-05-15 19:52","TestPerChannelBookieClient.java","113623","71946","185569","","371138"
"2017-01-31 04:01","Bookie.java","112737","63013","175750","","351500"
"2017-03-28 22:37","Bookie.java","112837","67920","180757","","361514"
"2016-01-26 22:11","Bookie.java","6163","33563","39726","","79452"
"2015-03-18 07:38","Bookie.java","5420","29568","34988","","69976"
"2015-04-21 09:17","Bookie.java","5422","29672","35094","","70188"
"2014-09-23 17:53","Bookie.java","5027","26118","31145","","62290"
"2017-07-04 06:27","Bookie.java","115030","84080","199110","","398220"
"2017-06-05 22:25","Bookie.java","114684","77948","192632","","385264"
"2014-02-06 09:25","Bookie.java","3280","10077","13357","7","26714"
"2014-04-29 22:07","Bookie.java","3699","14001","17700","7","35400"
"2013-12-06 07:39","Bookie.java","1776","6318","8094","6","16188"
"2014-08-02 20:02","Bookie.java","4526","23525","28051","","56102"
"2013-10-02 07:01","Bookie.java","298","1085","1383","5","2766"
"2017-06-28 23:24","Bookie.java","114756","79973","194729","","389458"
"2017-07-07 08:19","Bookie.java","115021","86034","201055","","402110"
"2013-09-11 00:34","Bookie.java","244","830","1074","5","2148"
"2014-01-21 17:26","Bookie.java","2272","8551","10823","6","21646"
"2013-10-12 05:42","Bookie.java","1345","2865","4210","6","8420"
"2013-10-22 16:21","Bookie.java","1695","3982","5677","6","11354"
"2017-05-16 00:31","Bookie.java","113747","72787","186534","","373068"
"2014-02-05 22:43","Bookie.java","3275","10064","13339","7","26678"
"2014-08-18 23:03","Bookie.java","4899","25366","30265","","60530"
"2014-05-09 14:04","Bookie.java","3717","14660","18377","7","36754"
"2017-06-01 23:58","Bookie.java","114529","76344","190873","","381746"
"2017-08-02 00:49","Bookie.java","118212","105468","223680","","447360"
"2013-12-02 18:45","Bookie.java","1758","6148","7906","6","15812"
"2016-11-18 00:18","Bookie.java","112677","49852","162529","","325058"
"2017-03-28 22:35","Bookie.java","112819","67687","180506","","361012"
"2016-07-14 23:02","Bookie.java","110005","39290","149295","","298590"
"2017-06-05 20:30","Bookie.java","114590","76763","191353","","382706"
"2016-11-30 00:02","Bookie.java","112703","50408","163111","","326222"
"2017-03-22 22:54","Bookie.java","112819","63383","176202","","352404"
"2014-07-24 01:41","TestMetaStore.java","8858","67263","76121","","152242"
"2012-12-12 11:20","BookieRecoveryTest.java","5924","46548","52472","2","104944"
"2012-09-12 11:59","BookieRecoveryTest.java","1877","21911","23788","2","47576"
"2017-06-30 00:12","BookieRecoveryTest.java","55310","107337","162647","","325294"
"2014-07-24 01:41","BookieRecoveryTest.java","11656","109141","120797","","241594"
"2012-12-04 22:15","BookieRecoveryTest.java","5784","45356","51140","2","102280"
"2017-04-11 20:15","BookieRecoveryTest.java","54103","94369","148472","","296944"
"2017-05-15 19:52","BookieRecoveryTest.java","54557","98117","152674","","305348"
"2012-12-10 16:02","BookieRecoveryTest.java","5890","45464","51354","2","102708"
"2013-08-13 14:32","BookieRecoveryTest.java","9568","94721","104289","5","208578"
"2014-02-05 22:43","BookieRecoveryTest.java","11220","102947","114167","7","228334"
"2017-06-21 19:58","PendingReadOp.java","114806","54501","169307","","338614"
"2017-06-05 21:48","PendingReadOp.java","114494","52801","167295","","334590"
"2017-06-05 22:13","PendingReadOp.java","114501","53221","167722","","335444"
"2017-06-01 11:42","PendingReadOp.java","113616","51214","164830","","329660"
"2017-06-01 22:39","PendingReadOp.java","114274","51454","165728","","331456"
"2017-05-15 19:52","PendingReadOp.java","113312","47684","160996","","321992"
"2016-02-09 08:39","PendingReadOp.java","1316","4655","5971","","11942"
"2016-02-09 08:32","PendingReadOp.java","1316","4598","5914","","11828"
"2017-07-04 06:27","PendingReadOp.java","115326","60126","175452","","350904"
"2015-09-15 10:38","BookKeeper.java","3675","20840","24515","","49030"
"2015-10-22 09:22","BookKeeper.java","3755","22300","26055","","52110"
"2017-01-31 04:01","BookKeeper.java","110821","53145","163966","","327932"
"2015-07-10 22:48","BookKeeper.java","3233","20096","23329","","46658"
"2017-06-30 00:12","BookKeeper.java","113438","72575","186013","","372026"
"2016-10-13 07:50","BookKeeper.java","110610","39378","149988","","299976"
"2017-06-21 21:00","BookKeeper.java","113169","69835","183004","","366008"
"2017-03-28 22:35","BookKeeper.java","110925","57841","168766","","337532"
"2016-07-11 23:01","BookKeeper.java","107855","29154","137009","","274018"
"2016-10-13 09:27","BookKeeper.java","110726","39480","150206","","300412"
"2017-07-28 20:12","BookKeeper.java","114568","80260","194828","","389656"
"2017-05-15 19:52","BookKeeper.java","111919","62589","174508","","349016"
"2017-01-31 04:01","Bookie.java","110826","54313","165139","","330278"
"2017-03-28 22:37","Bookie.java","110968","59262","170230","","340460"
"2016-01-26 22:11","Bookie.java","3814","24425","28239","","56478"
"2015-03-18 07:38","Bookie.java","2903","20262","23165","","46330"
"2015-04-21 09:17","Bookie.java","2945","20406","23351","","46702"
"2014-09-23 17:53","Bookie.java","2426","16728","19154","","38308"
"2017-07-04 06:27","Bookie.java","113475","75736","189211","","378422"
"2017-06-05 22:25","Bookie.java","113037","69512","182549","","365098"
"2014-02-06 09:25","Bookie.java","12","20","32","7","64"
"2014-04-29 22:07","Bookie.java","491","4004","4495","7","8990"
"2014-08-02 20:02","Bookie.java","1789","13999","15788","","31576"
"2017-06-28 23:24","Bookie.java","113132","71560","184692","","369384"
"2017-07-07 08:19","Bookie.java","113505","77729","191234","","382468"
"2017-05-16 00:31","Bookie.java","111999","64250","176249","","352498"
"2014-08-18 23:03","Bookie.java","2163","15841","18004","","36008"
"2014-05-09 14:04","Bookie.java","510","4664","5174","7","10348"
"2017-06-01 23:58","Bookie.java","112825","67851","180676","","361352"
"2017-08-02 00:49","Bookie.java","117040","97507","214547","","429094"
"2016-11-18 00:18","Bookie.java","110757","41143","151900","","303800"
"2017-03-28 22:35","Bookie.java","110928","59007","169935","","339870"
"2016-07-14 23:02","Bookie.java","107943","30439","138382","","276764"
"2017-06-05 20:30","Bookie.java","112938","68322","181260","","362520"
"2016-11-30 00:02","Bookie.java","110782","41698","152480","","304960"
"2017-03-22 22:54","Bookie.java","110918","54693","165611","","331222"
"2014-06-02 11:54","AuditorLedgerCheckerTest.java","7219","60686","67905","7","135810"
"2014-07-24 01:41","AuditorLedgerCheckerTest.java","7530","61482","69012","","138024"
"2016-03-08 07:18","AuditorLedgerCheckerTest.java","9056","79540","88596","","177192"
"2016-12-17 02:44","AuditorLedgerCheckerTest.java","80474","65322","145796","","291592"
"2017-07-07 05:11","AuditorLedgerCheckerTest.java","82359","94494","176853","","353706"
"2014-02-05 22:43","AuditorLedgerCheckerTest.java","6786","54980","61766","7","123532"
"2013-08-21 13:19","AuditorLedgerCheckerTest.java","4546","46442","50988","5","101976"
"2017-10-17 09:32","AuditorLedgerCheckerTest.java","92072","118744","210816","","421632"
"2017-05-12 15:20","AuditorLedgerCheckerTest.java","80972","80194","161166","","322332"
"2013-06-15 19:05","AuditorLedgerCheckerTest.java","4352","44572","48924","5","97848"
"2013-05-31 12:02","AuditorLedgerCheckerTest.java","4249","40369","44618","5","89236"
"2013-08-21 13:19","BookKeeperAdmin.java","2342","10066","12408","5","24816"
"2017-10-17 09:32","BookKeeperAdmin.java","123748","116248","239996","","479992"
"2017-06-01 23:58","BookKeeperAdmin.java","113060","82108","195168","","390336"
"2017-04-11 20:19","BookKeeperAdmin.java","111653","74216","185869","","371738"
"2014-02-21 19:01","BookKeeperAdmin.java","5008","20193","25201","7","50402"
"2014-02-05 22:43","BookKeeperAdmin.java","4847","18869","23716","7","47432"
"2017-07-07 05:11","BookKeeperAdmin.java","113524","91487","205011","","410022"
"2013-02-26 04:12","BookKeeperAdmin.java","991","1019","2010","4","4020"
"2016-11-09 03:05","BookKeeperAdmin.java","111423","55696","167119","","334238"
"2016-11-30 00:07","BookKeeperAdmin.java","111433","56370","167803","","335606"
"2016-09-10 21:01","BookKeeperAdmin.java","111306","51894","163200","","326400"
"2016-07-14 23:02","BookKeeperAdmin.java","110113","46631","156744","","313488"
"2016-10-13 09:27","BookKeeperAdmin.java","111420","55359","166779","","333558"
"2016-03-16 05:03","BookKeeperAdmin.java","109856","41882","151738","","303476"
"2016-03-08 07:18","BookKeeperAdmin.java","7341","43653","50994","","101988"
"2014-12-06 08:03","BookKeeperAdmin.java","6089","35332","41421","","82842"
"2014-04-24 10:43","BookKeeperAdmin.java","5137","22294","27431","7","54862"
"2014-09-06 07:51","BookKeeperAdmin.java","5900","34006","39906","","79812"
"2013-05-10 12:45","BookKeeperAdmin.java","1848","3697","5545","5","11090"
"2015-10-06 10:05","WriteEntryProcessor.java","2400","9472","11872","","23744"
"2015-04-21 09:17","WriteEntryProcessor.java","1509","7390","8899","","17798"
"2014-08-02 20:02","WriteEntryProcessor.java","165","795","960","","1920"
"2017-05-15 19:52","WriteEntryProcessor.java","114182","54435","168617","","337234"
"2012-12-24 05:50","InterleavedLedgerStorage.java","10916","67698","78614","2","157228"
"2012-12-18 13:04","InterleavedLedgerStorage.java","10531","67205","77736","2","155472"
"2016-11-18 00:18","InterleavedLedgerStorage.java","47875","82839","130714","","261428"
"2013-12-02 18:45","InterleavedLedgerStorage.java","14541","116720","131261","6","262522"
"2013-05-04 14:22","InterleavedLedgerStorage.java","13326","105401","118727","5","237454"
"2012-06-13 16:57","InterleavedLedgerStorage.java","989","4159","5148","","10296"
"2014-01-15 15:58","InterleavedLedgerStorage.java","14560","117083","131643","6","263286"
"2014-01-21 17:26","InterleavedLedgerStorage.java","14653","118721","133374","6","266748"
"2013-10-02 06:23","InterleavedLedgerStorage.java","13615","112001","125616","5","251232"
"2017-05-16 00:31","InterleavedLedgerStorage.java","48478","105307","153785","","307570"
"2012-05-25 17:13","InterleavedLedgerStorage.java","827","2367","3194","1","6388"
"2014-08-02 20:02","InterleavedLedgerStorage.java","15588","132376","147964","","295928"
"2017-07-04 06:27","InterleavedLedgerStorage.java","49221","116060","165281","","330562"
"2012-10-18 16:40","InterleavedLedgerStorage.java","9489","50617","60106","2","120212"
"2015-04-21 09:55","InterleavedLedgerStorage.java","15872","138082","153954","","307908"
"2017-01-31 04:01","InterleavedLedgerStorage.java","47921","95986","143907","","287814"
"2016-03-08 06:49","InterleavedLedgerStorage.java","16315","142518","158833","","317666"
"2017-03-28 22:37","InterleavedLedgerStorage.java","47968","100840","148808","","297616"
"2015-04-21 09:17","InterleavedLedgerStorage.java","15856","137895","153751","","307502"
"2015-10-06 10:05","TestPerChannelBookieClient.java","6190","32816","39006","","78012"
"2014-07-24 01:41","TestPerChannelBookieClient.java","4324","18056","22380","","44760"
"2014-05-27 13:56","TestPerChannelBookieClient.java","3897","16586","20483","7","40966"
"2014-02-05 22:43","TestPerChannelBookieClient.java","3442","11416","14858","7","29716"
"2017-05-16 00:31","TestPerChannelBookieClient.java","113568","73793","187361","","374722"
"2013-08-20 12:51","TestPerChannelBookieClient.java","297","1781","2078","5","4156"
"2013-06-28 17:27","TestPerChannelBookieClient.java","52","361","413","5","826"
"2017-01-31 02:14","TestPerChannelBookieClient.java","112582","58574","171156","","342312"
"2016-04-05 08:45","TestPerChannelBookieClient.java","109534","38215","147749","","295498"
"2017-05-15 19:52","TestPerChannelBookieClient.java","113469","73276","186745","","373490"
"2017-06-01 11:42","LedgerInputStream.java","40521","121462","161983","","323966"
"2015-10-06 10:05","BenchBookie.java","21009","150285","171294","","342588"
"2012-05-09 13:20","BenchBookie.java","9134","15399","24533","1","49066"
"2012-04-03 18:02","BenchBookie.java","8321","12876","21197","1","42394"
"2013-10-14 16:43","BenchBookie.java","19589","124978","144567","6","289134"
"2014-02-05 22:43","BenchBookie.java","20163","130787","150950","7","301900"
"2017-05-15 19:52","BenchBookie.java","46548","109005","155553","","311106"
"2016-07-14 23:02","BenchBookie.java","45986","79106","125092","","250184"
"2017-01-31 04:01","Bookie.java","112654","42463","155117","","310234"
"2017-03-28 22:37","Bookie.java","112857","47473","160330","","320660"
"2016-01-26 22:11","Bookie.java","2132","9065","11197","","22394"
"2015-03-18 07:38","Bookie.java","929","4610","5539","","11078"
"2015-04-21 09:17","Bookie.java","1007","4790","5797","","11594"
"2014-09-23 17:53","Bookie.java","405","1029","1434","","2868"
"2017-07-04 06:27","Bookie.java","115943","64526","180469","","360938"
"2017-06-05 22:25","Bookie.java","115389","58186","173575","","347150"
"2017-06-28 23:24","Bookie.java","115494","60244","175738","","351476"
"2017-07-07 08:19","Bookie.java","115987","66533","182520","","365040"
"2017-05-16 00:31","Bookie.java","114165","52738","166903","","333806"
"2017-06-01 23:58","Bookie.java","115034","56382","171416","","342832"
"2017-08-02 00:49","Bookie.java","119697","86486","206183","","412366"
"2016-11-18 00:18","Bookie.java","112580","29288","141868","","283736"
"2017-03-28 22:35","Bookie.java","112817","47218","160035","","320070"
"2016-07-14 23:02","Bookie.java","107502","16320","123822","","247644"
"2017-06-05 20:30","Bookie.java","115152","56858","172010","","344020"
"2016-11-30 00:02","Bookie.java","112606","29844","142450","","284900"
"2017-03-22 22:54","Bookie.java","112764","42861","155625","","311250"
"2012-07-23 23:39","LocalBookKeeper.java","12315","42909","55224","2","110448"
"2014-12-10 19:43","LocalBookKeeper.java","19127","156766","175893","","351786"
"2013-02-08 19:08","LocalBookKeeper.java","16980","125211","142191","4","284382"
"2012-05-10 14:47","LocalBookKeeper.java","10188","28149","38337","1","76674"
"2015-07-10 22:48","LocalBookKeeper.java","19160","159439","178599","","357198"
"2017-05-26 12:38","LocalBookKeeper.java","41082","117484","158566","","317132"
"2017-06-01 11:31","LocalBookKeeper.java","41115","118431","159546","","319092"
"2017-06-01 23:58","LocalBookKeeper.java","41147","118426","159573","","319146"
"2013-01-14 16:59","LocalBookKeeper.java","16862","94380","111242","2","222484"
"2017-06-01 23:58","EntryLogger.java","40516","121424","161940","","323880"
"2014-01-21 17:26","EntryLogger.java","18998","144370","163368","6","326736"
"2013-10-02 06:23","EntryLogger.java","18868","138558","157426","5","314852"
"2014-01-22 14:35","EntryLogger.java","19065","144813","163878","6","327756"
"2017-11-08 12:27","EntryLogger.java","42113","156493","198606","","397212"
"2013-10-22 07:44","EntryLogger.java","18919","139905","158824","6","317648"
"2012-03-16 10:41","EntryLogger.java","11321","28922","40243","1","80486"
"2012-06-13 16:57","EntryLogger.java","12599","37073","49672","","99344"
"2012-02-15 16:11","EntryLogger.java","4626","16644","21270","1","42540"
"2013-05-04 14:22","EntryLogger.java","18739","132118","150857","5","301714"
"2011-11-18 11:18","EntryLogger.java","3592","7221","10813","","21626"
"2011-12-16 12:43","EntryLogger.java","4277","11115","15392","1","30784"
"2012-03-08 12:13","EntryLogger.java","4874","18730","23604","1","47208"
"2017-01-31 02:11","EntryLogger.java","40280","103568","143848","","287696"
"2017-03-23 00:48","EntryLogger.java","40286","109995","150281","","300562"
"2016-07-14 23:02","EntryLogger.java","40229","88607","128836","","257672"
"2012-12-24 06:23","EntryLogger.java","17395","95703","113098","2","226196"
"2012-12-10 11:04","EntryLogger.java","17197","90922","108119","2","216238"
"2016-02-24 00:44","EntryLogger.java","19473","166628","186101","","372202"
"2011-11-11 11:24","EntryLogger.java","2245","2938","5183","","10366"
"2011-11-17 11:16","EntryLogger.java","2969","5310","8279","","16558"
"2015-04-21 10:02","EntryLogger.java","19430","162977","182407","","364814"
"2012-10-18 16:40","EntryLogger.java","16852","79284","96136","2","192272"
"2012-07-26 04:32","EntryLogger.java","13989","48223","62212","2","124424"
"2013-01-04 11:32","EntryLogger.java","17610","97309","114919","2","229838"
"2015-04-21 09:44","EntryLogger.java","19430","162793","182223","","364446"
"2012-05-09 10:39","EntryLogger.java","12018","33322","45340","1","90680"
"2012-05-07 18:48","EntryLogger.java","12010","32890","44900","1","89800"
"2012-05-10 14:47","EntryLogger.java","12253","33843","46096","1","92192"
"2012-05-17 19:07","EntryLogger.java","12540","35185","47725","1","95450"
"2017-05-16 00:31","BookieJournalTest.java","263","681","944","","1888"
"2014-12-10 19:43","IOUtils.java","2558","14431","16989","","33978"
"2012-12-24 05:50","LedgerManagerFactory.java","9710","62556","72266","2","144532"
"2017-06-01 23:58","LedgerManagerFactory.java","49427","105095","154522","","309044"
"2012-08-14 11:40","LedgerManagerFactory.java","3878","20481","24359","2","48718"
"2012-09-07 07:04","LedgerManagerFactory.java","4844","33268","38112","2","76224"
"2015-09-15 10:38","LedgerManagerFactory.java","15234","134204","149438","","298876"
"2015-07-10 22:48","ZooKeeperUtil.java","5783","37378","43161","","86322"
"2014-08-18 23:00","ZooKeeperUtil.java","5044","32299","37343","","74686"
"2014-12-10 19:43","ZooKeeperUtil.java","5497","34452","39949","","79898"
"2016-04-05 21:52","ZooKeeperUtil.java","109314","43835","153149","","306298"
"2012-12-18 12:00","TestLedgerUnderreplicationManager.java","3466","23073","26539","2","53078"
"2013-05-31 12:02","TestLedgerUnderreplicationManager.java","7094","62821","69915","5","139830"
"2013-10-12 05:42","TestLedgerUnderreplicationManager.java","8160","70692","78852","6","157704"
"2015-07-10 22:48","TestLedgerUnderreplicationManager.java","10506","96333","106839","","213678"
"2012-12-08 11:42","TestLedgerUnderreplicationManager.java","2907","18452","21359","2","42718"
"2012-10-16 17:01","TestLedgerUnderreplicationManager.java","207","1978","2185","2","4370"
"2017-03-23 00:48","ClientConfiguration.java","112574","42182","154756","","309512"
"2016-04-05 08:45","ClientConfiguration.java","106892","13380","120272","","240544"
"2017-03-28 22:35","ClientConfiguration.java","112626","46486","159112","","318224"
"2017-01-31 02:14","ClientConfiguration.java","112457","36256","148713","","297426"
"2017-04-15 13:58","ClientConfiguration.java","112881","47841","160722","","321444"
"2017-03-23 00:59","ClientConfiguration.java","112581","42201","154782","","309564"
"2017-05-15 19:52","ClientConfiguration.java","113824","51438","165262","","330524"
"2016-10-13 07:50","ClientConfiguration.java","112206","27918","140124","","280248"
"2017-06-21 19:58","ClientConfiguration.java","115278","58215","173493","","346986"
"2017-06-05 21:48","ClientConfiguration.java","114978","56527","171505","","343010"
"2017-06-21 19:50","ClientConfiguration.java","115273","58100","173373","","346746"
"2017-08-02 00:49","ClientConfiguration.java","119520","85768","205288","","410576"
"2017-08-01 08:34","ClientConfiguration.java","118955","82618","201573","","403146"
"2017-06-30 00:12","ClientConfiguration.java","115603","61684","177287","","354574"
"2017-07-04 06:27","ClientConfiguration.java","115763","63805","179568","","359136"
"2017-01-31 04:01","ClientConfiguration.java","112459","41727","154186","","308372"
"2015-10-06 10:05","ClientConfiguration.java","1849","6282","8131","","16262"
"2015-10-06 10:48","ClientConfiguration.java","1855","6514","8369","","16738"
"2016-02-09 08:32","ClientConfiguration.java","2041","8565","10606","","21212"
"2014-12-06 07:54","ClientConfiguration.java","277","1195","1472","","2944"
"2016-08-01 08:04","ClientConfiguration.java","107317","16259","123576","","247152"
"2013-08-21 13:19","BookKeeperAdmin.java","18946","132157","151103","5","302206"
"2017-10-17 09:32","BookKeeperAdmin.java","44532","142519","187051","","374102"
"2017-06-01 23:58","BookKeeperAdmin.java","42667","117202","159869","","319738"
"2017-04-11 20:19","BookKeeperAdmin.java","42182","110232","152414","","304828"
"2014-02-21 19:01","BookKeeperAdmin.java","19558","140230","159788","7","319576"
"2014-02-05 22:43","BookKeeperAdmin.java","19520","139029","158549","7","317098"
"2012-03-31 10:58","BookKeeperAdmin.java","9341","22607","31948","1","63896"
"2017-07-07 05:11","BookKeeperAdmin.java","42742","126192","168934","","337868"
"2013-02-26 04:12","BookKeeperAdmin.java","18505","124020","142525","4","285050"
"2016-11-09 03:05","BookKeeperAdmin.java","42136","91896","134032","","268064"
"2016-11-30 00:07","BookKeeperAdmin.java","42136","92560","134696","","269392"
"2016-09-10 21:01","BookKeeperAdmin.java","42054","88129","130183","","260366"
"2016-07-14 23:02","BookKeeperAdmin.java","42049","84054","126103","","252206"
"2016-10-13 09:27","BookKeeperAdmin.java","42136","91562","133698","","267396"
"2012-11-30 04:54","BookKeeperAdmin.java","16599","83270","99869","2","199738"
"2012-07-18 17:00","BookKeeperAdmin.java","12704","40486","53190","2","106380"
"2013-02-08 19:08","BookKeeperAdmin.java","17756","123243","140999","4","281998"
"2016-03-16 05:03","BookKeeperAdmin.java","41999","79512","121511","","243022"
"2016-03-08 07:18","BookKeeperAdmin.java","20196","161995","182191","","364382"
"2014-12-06 08:03","BookKeeperAdmin.java","19978","154708","174686","","349372"
"2012-09-03 18:54","BookKeeperAdmin.java","13513","59338","72851","2","145702"
"2014-04-24 10:43","BookKeeperAdmin.java","19566","142210","161776","7","323552"
"2012-10-05 16:24","BookKeeperAdmin.java","15762","68656","84418","2","168836"
"2012-09-07 07:04","BookKeeperAdmin.java","13543","60834","74377","2","148754"
"2014-09-06 07:51","BookKeeperAdmin.java","19961","153554","173515","","347030"
"2012-08-19 11:39","BookKeeperAdmin.java","13332","53298","66630","2","133260"
"2012-05-10 14:47","BookKeeperAdmin.java","9997","25214","35211","1","70422"
"2013-05-10 12:45","BookKeeperAdmin.java","18740","126076","144816","5","289632"
"2012-08-24 22:44","BookKeeperAdmin.java","13330","54188","67518","2","135036"
"2016-12-21 01:48","EntryMemTable.java","112852","37565","150417","","300834"
"2017-01-31 04:01","Bookie.java","111377","50710","162087","","324174"
"2017-03-28 22:37","Bookie.java","111530","55670","167200","","334400"
"2016-01-26 22:11","Bookie.java","3624","20081","23705","","47410"
"2015-03-18 07:38","Bookie.java","2678","15883","18561","","37122"
"2015-04-21 09:17","Bookie.java","2721","16028","18749","","37498"
"2014-09-23 17:53","Bookie.java","2169","12317","14486","","28972"
"2017-07-04 06:27","Bookie.java","114172","72279","186451","","372902"
"2017-06-05 22:25","Bookie.java","113690","66011","179701","","359402"
"2014-08-02 20:02","Bookie.java","1394","9450","10844","","21688"
"2017-06-28 23:24","Bookie.java","113786","68060","181846","","363692"
"2017-07-07 08:19","Bookie.java","114199","74269","188468","","376936"
"2017-05-16 00:31","Bookie.java","112642","60739","173381","","346762"
"2014-08-18 23:03","Bookie.java","1768","11292","13060","","26120"
"2017-06-01 23:58","Bookie.java","113479","64351","177830","","355660"
"2017-08-02 00:49","Bookie.java","117826","94139","211965","","423930"
"2016-11-18 00:18","Bookie.java","111302","37534","148836","","297672"
"2017-03-28 22:35","Bookie.java","111490","55415","166905","","333810"
"2016-07-14 23:02","Bookie.java","108469","26811","135280","","270560"
"2017-06-05 20:30","Bookie.java","113591","64821","178412","","356824"
"2016-11-30 00:02","Bookie.java","111328","38090","149418","","298836"
"2017-03-22 22:54","Bookie.java","111482","51103","162585","","325170"
"2017-08-16 03:37","BookieServer.java","121440","96330","217770","","435540"
"2017-08-02 00:49","BookieServer.java","119826","88083","207909","","415818"
"2017-06-28 23:24","BookieServer.java","115626","61844","177470","","354940"
"2017-06-01 23:58","BookieServer.java","115213","58029","173242","","346484"
"2017-10-17 09:32","BookieServer.java","131088","97356","228444","","456888"
"2013-01-14 16:59","BookieServer.java","11947","71845","83792","2","167584"
"2013-01-09 17:18","BookieServer.java","11824","70658","82482","2","164964"
"2013-02-12 11:16","BookieServer.java","12933","103417","116350","4","232700"
"2013-04-02 17:38","BookieServer.java","13190","104677","117867","5","235734"
"2017-08-16 03:37","BookieServer.java","51018","142751","193769","","387538"
"2017-08-02 00:49","BookieServer.java","50127","135227","185354","","370708"
"2013-07-03 17:39","BookieServer.java","13538","110514","124052","5","248104"
"2013-07-24 16:55","BookieServer.java","13567","111411","124978","5","249956"
"2014-02-05 22:43","BookieServer.java","15043","119676","134719","7","269438"
"2017-06-28 23:24","BookieServer.java","49174","112235","161409","","322818"
"2013-06-15 19:05","BookieServer.java","13515","110174","123689","5","247378"
"2017-06-01 23:58","BookieServer.java","49118","108777","157895","","315790"
"2017-10-17 09:32","BookieServer.java","51933","135044","186977","","373954"
"2014-08-02 20:02","BookieServer.java","15601","132444","148045","","296090"
"2013-12-06 07:39","BookieServer.java","14560","116946","131506","6","263012"
"2012-07-23 23:39","BookieServer.java","5105","18079","23184","2","46368"
"2012-07-09 04:09","BookieServer.java","3302","13367","16669","2","33338"
"2012-10-18 16:40","BookieServer.java","9516","50699","60215","2","120430"
"2014-01-21 05:05","BookieServer.java","14600","118084","132684","6","265368"
"2016-02-09 08:28","BookieShell.java","1455","5126","6581","","13162"
"2016-03-16 05:03","BookieShell.java","106259","7197","113456","","226912"
"2017-06-01 23:58","BookieShell.java","114412","52372","166784","","333568"
"2017-07-07 05:11","BookieShell.java","115375","62250","177625","","355250"
"2017-01-11 07:37","BookieShell.java","111970","32077","144047","","288094"
"2016-12-21 01:42","BookieShell.java","111959","31708","143667","","287334"
"2017-01-11 07:34","BookieShell.java","111970","31953","143923","","287846"
"2016-11-30 00:02","BookieShell.java","111925","25775","137700","","275400"
"2017-01-30 23:25","BookieShell.java","111975","32257","144232","","288464"
"2017-03-28 22:35","BookieShell.java","112159","43172","155331","","310662"
"2017-01-30 21:31","BookieShell.java","111972","32146","144118","","288236"
"2017-03-22 22:54","BookieShell.java","112102","38811","150913","","301826"
"2017-06-21 19:58","PendingReadOp.java","81111","90421","171532","","343064"
"2017-06-05 21:48","PendingReadOp.java","81062","88984","170046","","340092"
"2017-06-05 22:13","PendingReadOp.java","81064","89399","170463","","340926"
"2017-06-01 11:42","PendingReadOp.java","80373","87586","167959","","335918"
"2017-06-01 22:39","PendingReadOp.java","80974","87769","168743","","337486"
"2013-09-11 00:34","PendingReadOp.java","6792","52743","59535","5","119070"
"2014-02-05 22:43","PendingReadOp.java","8838","60992","69830","7","139660"
"2013-03-25 18:02","PendingReadOp.java","6036","44964","51000","4","102000"
"2017-05-15 19:52","PendingReadOp.java","80204","84191","164395","","328790"
"2015-04-21 09:17","PendingReadOp.java","10093","79708","89801","","179602"
"2016-02-09 08:39","PendingReadOp.java","10715","83669","94384","","188768"
"2016-02-09 08:32","PendingReadOp.java","10715","83612","94327","","188654"
"2012-12-13 13:07","PendingReadOp.java","2248","4070","6318","2","12636"
"2017-07-04 06:27","PendingReadOp.java","81339","95754","177093","","354186"
"2014-01-21 05:19","PendingReadOp.java","8085","59436","67521","6","135042"
"2012-12-24 05:50","InterleavedLedgerStorage.java","10970","68176","79146","2","158292"
"2012-12-18 13:04","InterleavedLedgerStorage.java","10585","67683","78268","2","156536"
"2016-11-18 00:18","InterleavedLedgerStorage.java","47561","82949","130510","","261020"
"2013-12-02 18:45","InterleavedLedgerStorage.java","14547","117150","131697","6","263394"
"2013-05-04 14:22","InterleavedLedgerStorage.java","13338","105837","119175","5","238350"
"2012-06-13 16:57","InterleavedLedgerStorage.java","1054","4648","5702","","11404"
"2014-01-15 15:58","InterleavedLedgerStorage.java","14566","117513","132079","6","264158"
"2014-01-21 17:26","InterleavedLedgerStorage.java","14659","119151","133810","6","267620"
"2013-10-02 06:23","InterleavedLedgerStorage.java","13624","112434","126058","5","252116"
"2017-05-16 00:31","InterleavedLedgerStorage.java","48163","105416","153579","","307158"
"2012-05-25 17:13","InterleavedLedgerStorage.java","890","2854","3744","1","7488"
"2012-05-09 13:00","InterleavedLedgerStorage.java","63","487","550","1","1100"
"2014-08-02 20:02","InterleavedLedgerStorage.java","15591","132803","148394","","296788"
"2017-07-04 06:27","InterleavedLedgerStorage.java","48920","116183","165103","","330206"
"2012-10-18 16:40","InterleavedLedgerStorage.java","9546","51098","60644","2","121288"
"2015-04-21 09:55","InterleavedLedgerStorage.java","15868","138502","154370","","308740"
"2017-01-31 04:01","InterleavedLedgerStorage.java","47607","96096","143703","","287406"
"2016-03-08 06:49","InterleavedLedgerStorage.java","16306","142933","159239","","318478"
"2017-03-28 22:37","InterleavedLedgerStorage.java","47654","100950","148604","","297208"
"2015-04-21 09:17","InterleavedLedgerStorage.java","15857","138320","154177","","308354"
"2016-11-12 03:35","PacketProcessorBaseV3.java","110926","22531","133457","","266914"
"2017-05-15 19:52","PacketProcessorBaseV3.java","112499","45680","158179","","316358"
"2017-06-05 22:25","PacketProcessorBaseV3.java","113935","51758","165693","","331386"
"2015-09-15 10:38","GcLedgersTest.java","6053","37440","43493","","86986"
"2016-04-27 09:55","GcLedgersTest.java","109476","44046","153522","","307044"
"2017-03-28 22:37","GcLedgersTest.java","111195","72548","183743","","367486"
"2016-03-08 06:49","GcLedgersTest.java","6373","41057","47430","","94860"
"2017-07-04 06:27","GcLedgersTest.java","113323","88643","201966","","403932"
"2014-07-24 01:41","GcLedgersTest.java","4586","23403","27989","","55978"
"2013-07-29 12:30","GcLedgersTest.java","848","7162","8010","5","16020"
"2017-05-16 00:31","GcLedgersTest.java","112069","77379","189448","","378896"
"2016-11-18 00:18","InterleavedLedgerStorage.java","112786","30962","143748","","287496"
"2017-05-16 00:31","InterleavedLedgerStorage.java","114344","54385","168729","","337458"
"2017-07-04 06:27","InterleavedLedgerStorage.java","116075","66126","182201","","364402"
"2015-04-21 09:55","InterleavedLedgerStorage.java","1421","6843","8264","","16528"
"2017-01-31 04:01","InterleavedLedgerStorage.java","112860","44137","156997","","313994"
"2016-03-08 06:49","InterleavedLedgerStorage.java","2704","12119","14823","","29646"
"2017-03-28 22:37","InterleavedLedgerStorage.java","113036","49120","162156","","324312"
"2015-04-21 09:17","InterleavedLedgerStorage.java","1381","6632","8013","","16026"
"2017-05-15 19:52","SlowBookieTest.java","112606","66682","179288","","358576"
"2014-02-05 22:43","SlowBookieTest.java","1599","3842","5441","7","10882"
"2014-01-21 05:05","SlowBookieTest.java","347","1441","1788","6","3576"
"2017-08-02 00:49","ClientConfiguration.java","5371","23577","28948","","57896"
"2017-08-01 08:34","ClientConfiguration.java","4431","20052","24483","","48966"
"2012-12-18 12:00","TestLedgerUnderreplicationManager.java","5830","41675","47505","2","95010"
"2013-05-31 12:02","TestLedgerUnderreplicationManager.java","9164","81129","90293","5","180586"
"2013-10-12 05:42","TestLedgerUnderreplicationManager.java","10149","88919","99068","6","198136"
"2012-10-04 12:40","TestLedgerUnderreplicationManager.java","3879","20117","23996","2","47992"
"2015-07-10 22:48","TestLedgerUnderreplicationManager.java","12064","114129","126193","","252386"
"2012-08-28 14:25","TestLedgerUnderreplicationManager.java","1040","9797","10837","2","21674"
"2012-08-24 21:51","TestLedgerUnderreplicationManager.java","787","5355","6142","2","12284"
"2012-08-27 12:09","TestLedgerUnderreplicationManager.java","796","6299","7095","2","14190"
"2012-12-08 11:42","TestLedgerUnderreplicationManager.java","5487","37270","42757","2","85514"
"2012-10-16 17:01","TestLedgerUnderreplicationManager.java","3892","21901","25793","2","51586"
"2017-07-28 20:12","LedgerMetadataImpl.java","2875","14704","17579","","35158"
"2016-11-12 03:35","PacketProcessorBase.java","111832","24628","136460","","272920"
"2017-05-15 19:52","PacketProcessorBase.java","113312","47684","160996","","321992"
"2012-12-12 11:20","BookieRecoveryTest.java","48","1098","1146","2","2292"
"2017-06-30 00:12","BookieRecoveryTest.java","80705","93158","173863","","347726"
"2014-07-24 01:41","BookieRecoveryTest.java","7602","65513","73115","","146230"
"2017-04-11 20:15","BookieRecoveryTest.java","79203","79895","159098","","318196"
"2017-05-15 19:52","BookieRecoveryTest.java","79700","83686","163386","","326772"
"2013-08-13 14:32","BookieRecoveryTest.java","4819","50398","55217","5","110434"
"2014-02-05 22:43","BookieRecoveryTest.java","6994","59147","66141","7","132282"
"2012-05-07 18:48","LedgerCache.java","1259","4187","5446","1","10892"
"2017-07-04 06:27","LedgerCache.java","47942","118133","166075","","332150"
"2017-05-16 00:31","LedgerCache.java","47209","107390","154599","","309198"
"2012-12-18 13:04","LedgerCache.java","11232","71258","82490","2","164980"
"2016-11-18 00:18","LedgerCache.java","46669","84985","131654","","263308"
"2017-05-15 19:52","CRC32DigestManager.java","43342","112240","155582","","311164"
"2014-07-24 01:41","BookieShutdownTest.java","2731","10980","13711","","27422"
"2017-01-31 04:01","Bookie.java","112589","64050","176639","","353278"
"2017-03-28 22:37","Bookie.java","112689","68957","181646","","363292"
"2016-01-26 22:11","Bookie.java","6246","34831","41077","","82154"
"2015-03-18 07:38","Bookie.java","5505","30838","36343","","72686"
"2015-04-21 09:17","Bookie.java","5507","30942","36449","","72898"
"2013-06-21 19:26","Bookie.java","17","144","161","5","322"
"2014-09-23 17:53","Bookie.java","5134","27410","32544","","65088"
"2017-07-04 06:27","Bookie.java","114840","85075","199915","","399830"
"2017-06-05 22:25","Bookie.java","114498","78947","193445","","386890"
"2014-02-06 09:25","Bookie.java","3444","11426","14870","7","29740"
"2014-04-29 22:07","Bookie.java","3819","15306","19125","7","38250"
"2013-12-06 07:39","Bookie.java","1970","7697","9667","6","19334"
"2014-08-02 20:02","Bookie.java","4633","24817","29450","","58900"
"2013-10-02 07:01","Bookie.java","514","2486","3000","5","6000"
"2017-06-28 23:24","Bookie.java","114567","80969","195536","","391072"
"2017-07-07 08:19","Bookie.java","114830","87028","201858","","403716"
"2013-09-11 00:34","Bookie.java","461","2232","2693","5","5386"
"2014-01-21 17:26","Bookie.java","2460","9924","12384","6","24768"
"2013-10-12 05:42","Bookie.java","1526","4231","5757","6","11514"
"2013-10-22 16:21","Bookie.java","1895","5367","7262","6","14524"
"2017-05-16 00:31","Bookie.java","113568","73793","187361","","374722"
"2013-07-24 16:55","Bookie.java","224","1409","1633","5","3266"
"2014-02-05 22:43","Bookie.java","3442","11416","14858","7","29716"
"2014-08-18 23:03","Bookie.java","5006","26658","31664","","63328"
"2014-05-09 14:04","Bookie.java","3837","15965","19802","7","39604"
"2017-06-01 23:58","Bookie.java","114345","77345","191690","","383380"
"2017-08-02 00:49","Bookie.java","117951","106392","224343","","448686"
"2013-12-02 18:45","Bookie.java","1956","7531","9487","6","18974"
"2016-11-18 00:18","Bookie.java","112529","50889","163418","","326836"
"2017-03-28 22:35","Bookie.java","112671","68724","181395","","362790"
"2016-07-14 23:02","Bookie.java","109862","40332","150194","","300388"
"2017-06-05 20:30","Bookie.java","114404","77762","192166","","384332"
"2016-11-30 00:02","Bookie.java","112555","51445","164000","","328000"
"2017-03-22 22:54","Bookie.java","112671","64420","177091","","354182"
"2017-06-21 19:58","PendingReadOp.java","40535","123573","164108","","328216"
"2017-06-05 21:48","PendingReadOp.java","40515","122165","162680","","325360"
"2017-06-05 22:13","PendingReadOp.java","40516","122579","163095","","326190"
"2017-06-01 11:42","PendingReadOp.java","40521","121462","161983","","323966"
"2017-06-01 22:39","PendingReadOp.java","40527","121050","161577","","323154"
"2013-09-11 00:34","PendingReadOp.java","18868","138547","157415","5","314830"
"2014-02-05 22:43","PendingReadOp.java","19159","145041","164200","7","328400"
"2012-03-31 10:58","PendingReadOp.java","11840","31479","43319","1","86638"
"2013-03-25 18:02","PendingReadOp.java","18737","131393","150130","4","300260"
"2017-05-15 19:52","PendingReadOp.java","40437","118152","158589","","317178"
"2012-11-07 17:27","PendingReadOp.java","17036","85396","102432","2","204864"
"2015-04-21 09:17","PendingReadOp.java","19430","162773","182203","","364406"
"2012-12-03 10:46","PendingReadOp.java","17081","90809","107890","2","215780"
"2016-02-09 08:39","PendingReadOp.java","19474","166156","185630","","371260"
"2016-02-09 08:32","PendingReadOp.java","19474","166099","185573","","371146"
"2012-12-13 13:07","PendingReadOp.java","17306","92856","110162","2","220324"
"2017-07-04 06:27","PendingReadOp.java","40546","128689","169235","","338470"
"2014-01-21 05:19","PendingReadOp.java","19001","144080","163081","6","326162"
"2017-10-17 09:32","BookKeeperAdmin.java","26351","86825","113176","","226352"
"2017-06-01 23:58","BookKeeperAdmin.java","8607","45629","54236","","108472"
"2017-04-11 20:19","BookKeeperAdmin.java","6420","36957","43377","","86754"
"2017-07-07 05:11","BookKeeperAdmin.java","9676","55613","65289","","130578"
"2016-11-09 03:05","BookKeeperAdmin.java","5932","18179","24111","","48222"
"2016-11-30 00:07","BookKeeperAdmin.java","6001","18912","24913","","49826"
"2016-09-10 21:01","BookKeeperAdmin.java","4250","12812","17062","","34124"
"2016-07-14 23:02","BookKeeperAdmin.java","816","5308","6124","","12248"
"2016-10-13 09:27","BookKeeperAdmin.java","5904","17817","23721","","47442"
"2017-10-17 09:32","BookKeeperAdmin.java","130873","87061","217934","","435868"
"2017-06-01 23:58","BookKeeperAdmin.java","113153","45889","159042","","318084"
"2017-04-11 20:19","BookKeeperAdmin.java","110967","37218","148185","","296370"
"2017-07-07 05:11","BookKeeperAdmin.java","114218","55869","170087","","340174"
"2016-11-09 03:05","BookKeeperAdmin.java","110483","18444","128927","","257854"
"2016-11-30 00:07","BookKeeperAdmin.java","110552","19177","129729","","259458"
"2016-09-10 21:01","BookKeeperAdmin.java","108809","13085","121894","","243788"
"2016-07-14 23:02","BookKeeperAdmin.java","105375","5581","110956","","221912"
"2016-10-13 09:27","BookKeeperAdmin.java","110455","18082","128537","","257074"
"2016-03-16 05:03","BookKeeperAdmin.java","104561","275","104836","","209672"
"2017-07-04 06:27","Bookie.java","1257","8492","9749","","19498"
"2017-06-05 22:25","Bookie.java","449","1898","2347","","4694"
"2017-06-28 23:24","Bookie.java","613","4015","4628","","9256"
"2017-07-07 08:19","Bookie.java","1351","10549","11900","","23800"
"2017-08-02 00:49","Bookie.java","6431","31872","38303","","76606"
"2017-06-05 20:30","Bookie.java","168","526","694","","1388"
"2016-07-14 23:02","TestClient.java","66128","60806","126934","","253868"
"2013-02-08 19:08","TestClient.java","7671","65831","73502","4","147004"
"2014-02-05 22:43","TestReplicationWorker.java","11016","82515","93531","7","187062"
"2013-05-31 12:02","TestReplicationWorker.java","8982","68407","77389","5","154778"
"2013-06-15 19:05","TestReplicationWorker.java","9057","72582","81639","5","163278"
"2012-12-18 12:00","TestReplicationWorker.java","5425","28730","34155","2","68310"
"2013-01-14 16:59","TestReplicationWorker.java","7291","34055","41346","2","82692"
"2016-04-27 09:00","TestReplicationWorker.java","65830","58341","124171","","248342"
"2012-12-08 11:18","TestReplicationWorker.java","4880","24123","29003","2","58006"
"2012-10-05 16:24","TestReplicationWorker.java","3002","7886","10888","2","21776"
"2015-07-10 22:48","TestReplicationWorker.java","12342","101867","114209","","228418"
"2014-07-24 01:41","TestReplicationWorker.java","11574","88831","100405","","200810"
"2015-09-15 10:38","LedgerManager.java","19790","156149","175939","","351878"
"2012-06-19 12:39","LedgerManager.java","10420","27809","38229","2","76458"
"2014-01-17 18:13","LedgerManager.java","18782","135114","153896","6","307792"
"2013-04-04 11:21","LedgerManager.java","18287","123259","141546","5","283092"
"2012-12-24 05:50","LedgerManager.java","16706","86941","103647","2","207294"
"2017-06-21 19:58","PendingReadOp.java","113875","50231","164106","","328212"
"2017-06-05 21:48","PendingReadOp.java","113555","48523","162078","","324156"
"2017-06-05 22:13","PendingReadOp.java","113564","48945","162509","","325018"
"2017-06-01 11:42","PendingReadOp.java","112666","46925","159591","","319182"
"2017-06-01 22:39","PendingReadOp.java","113327","47168","160495","","320990"
"2017-05-15 19:52","PendingReadOp.java","112343","43376","155719","","311438"
"2017-07-04 06:27","PendingReadOp.java","114402","55863","170265","","340530"
"2016-10-13 07:50","UpdateLedgerCmdTest.java","111718","24583","136301","","272602"
"2015-10-06 10:05","TestPerChannelBookieClient.java","6202","32519","38721","","77442"
"2014-07-24 01:41","TestPerChannelBookieClient.java","4316","17739","22055","","44110"
"2014-05-27 13:56","TestPerChannelBookieClient.java","3888","16268","20156","7","40312"
"2014-02-05 22:43","TestPerChannelBookieClient.java","3424","11089","14513","7","29026"
"2017-05-16 00:31","TestPerChannelBookieClient.java","113609","73525","187134","","374268"
"2013-08-20 12:51","TestPerChannelBookieClient.java","250","1425","1675","5","3350"
"2017-01-31 02:14","TestPerChannelBookieClient.java","112599","58282","170881","","341762"
"2016-04-05 08:45","TestPerChannelBookieClient.java","109547","37919","147466","","294932"
"2017-05-15 19:52","TestPerChannelBookieClient.java","113510","73008","186518","","373036"
"2017-07-07 08:19","CreateNewLogTest.java","114509","84002","198511","","397022"
"2017-01-30 23:25","CreateNewLogTest.java","112091","54708","166799","","333598"
"2013-08-21 13:19","AutoRecoveryMainTest.java","7447","67997","75444","5","150888"
"2017-01-31 04:01","BookKeeper.java","1002","14558","15560","","31120"
"2017-06-30 00:12","BookKeeper.java","4934","35303","40237","","80474"
"2017-06-21 21:00","BookKeeper.java","4593","32491","37084","","74168"
"2017-03-28 22:35","BookKeeper.java","1240","19388","20628","","41256"
"2017-07-28 20:12","BookKeeper.java","6467","43391","49858","","99716"
"2017-05-15 19:52","BookKeeper.java","2924","24826","27750","","55500"
"2017-03-28 22:40","TestZkLedgerIdGenerator.java","111394","41588","152982","","305964"
"2017-07-07 05:11","BookieShell.java","1305","10220","11525","","23050"
"2016-11-12 03:35","PacketProcessorBaseV3.java","111832","24628","136460","","272920"
"2017-05-15 19:52","PacketProcessorBaseV3.java","113312","47684","160996","","321992"
"2015-10-06 10:05","PacketProcessorBaseV3.java","1056","2247","3303","","6606"
"2017-06-05 22:25","PacketProcessorBaseV3.java","114737","53751","168488","","336976"
"2012-12-13 18:34","BookieReadWriteTest.java","16953","81689","98642","2","197284"
"2014-01-21 05:05","BookieReadWriteTest.java","19367","132174","151541","6","303082"
"2012-06-19 12:39","BookieReadWriteTest.java","10527","23841","34368","2","68736"
"2012-05-25 17:13","BookieReadWriteTest.java","9784","20702","30486","1","60972"
"2014-07-24 01:41","BookieReadWriteTest.java","20055","139769","159824","","319648"
"2013-05-31 12:02","BookieReadWriteTest.java","18953","120835","139788","5","279576"
"2013-08-21 13:19","BookKeeperAdmin.java","18033","135919","153952","5","307904"
"2017-10-17 09:32","BookKeeperAdmin.java","41993","144655","186648","","373296"
"2017-06-01 23:58","BookKeeperAdmin.java","40364","119574","159938","","319876"
"2017-04-11 20:19","BookKeeperAdmin.java","40084","112809","152893","","305786"
"2014-02-21 19:01","BookKeeperAdmin.java","18534","143881","162415","7","324830"
"2014-02-05 22:43","BookKeeperAdmin.java","18498","142682","161180","7","322360"
"2012-03-31 10:58","BookKeeperAdmin.java","9907","27848","37755","1","75510"
"2017-07-07 05:11","BookKeeperAdmin.java","40427","128552","168979","","337958"
"2011-11-18 11:18","BookKeeperAdmin.java","939","2870","3809","","7618"
"2013-02-26 04:12","BookKeeperAdmin.java","17613","127803","145416","4","290832"
"2016-11-09 03:05","BookKeeperAdmin.java","40071","94506","134577","","269154"
"2016-11-30 00:07","BookKeeperAdmin.java","40078","95177","135255","","270510"
"2016-09-10 21:01","BookKeeperAdmin.java","39989","90739","130728","","261456"
"2016-07-14 23:02","BookKeeperAdmin.java","39986","86666","126652","","253304"
"2016-10-13 09:27","BookKeeperAdmin.java","40071","94172","134243","","268486"
"2012-11-30 04:54","BookKeeperAdmin.java","15960","87306","103266","2","206532"
"2012-07-18 17:00","BookKeeperAdmin.java","12586","45043","57629","2","115258"
"2013-02-08 19:08","BookKeeperAdmin.java","16880","127042","143922","4","287844"
"2011-11-28 19:25","BookKeeperAdmin.java","1347","6022","7369","","14738"
"2016-03-16 05:03","BookKeeperAdmin.java","39948","82136","122084","","244168"
"2016-03-08 07:18","BookKeeperAdmin.java","18976","165450","184426","","368852"
"2014-12-06 08:03","BookKeeperAdmin.java","18903","158308","177211","","354422"
"2012-09-03 18:54","BookKeeperAdmin.java","13311","63811","77122","2","154244"
"2014-04-24 10:43","BookKeeperAdmin.java","18538","145857","164395","7","328790"
"2012-10-05 16:24","BookKeeperAdmin.java","15163","72732","87895","2","175790"
"2012-09-07 07:04","BookKeeperAdmin.java","13332","65298","78630","2","157260"
"2014-09-06 07:51","BookKeeperAdmin.java","18886","157154","176040","","352080"
"2012-08-19 11:39","BookKeeperAdmin.java","13147","57788","70935","2","141870"
"2012-05-10 14:47","BookKeeperAdmin.java","10538","30430","40968","1","81936"
"2013-05-10 12:45","BookKeeperAdmin.java","17838","129849","147687","5","295374"
"2012-08-24 22:44","BookKeeperAdmin.java","13149","58682","71831","2","143662"
"2017-06-21 19:58","PendingReadOp.java","113872","50285","164157","","328314"
"2017-06-05 21:48","PendingReadOp.java","113555","48580","162135","","324270"
"2017-06-05 22:13","PendingReadOp.java","113562","49000","162562","","325124"
"2017-06-01 11:42","PendingReadOp.java","112666","46982","159648","","319296"
"2017-06-01 22:39","PendingReadOp.java","113327","47225","160552","","321104"
"2017-05-15 19:52","PendingReadOp.java","112343","43433","155776","","311552"
"2017-07-04 06:27","PendingReadOp.java","114399","55917","170316","","340632"
"2017-06-30 00:12","BookKeeper.java","397","2868","3265","","6530"
"2017-07-28 20:12","BookKeeper.java","2421","11447","13868","","27736"
"2014-12-09 19:57","LedgerCloseTest.java","4167","24655","28822","","57644"
"2016-03-16 04:43","LedgerCloseTest.java","108886","31834","140720","","281440"
"2014-02-05 22:43","LedgerCloseTest.java","2261","7437","9698","7","19396"
"2017-05-16 00:31","LedgerCloseTest.java","113071","70498","183569","","367138"
"2013-10-29 05:14","LedgerCloseTest.java","630","1440","2070","6","4140"
"2015-03-12 08:21","AuditorPeriodicCheckTest.java","5119","34424","39543","","79086"
"2014-04-24 14:44","AuditorPeriodicCheckTest.java","3762","18973","22735","7","45470"
"2013-10-11 08:36","AuditorPeriodicCheckTest.java","1488","7752","9240","6","18480"
"2014-02-05 22:43","AuditorPeriodicCheckTest.java","3429","15503","18932","7","37864"
"2017-05-16 00:31","AuditorPeriodicCheckTest.java","111835","76160","187995","","375990"
"2014-07-25 00:34","AuditorPeriodicCheckTest.java","4588","28242","32830","","65660"
"2016-09-10 21:01","AuditorPeriodicCheckTest.java","110690","49330","160020","","320040"
"2017-05-02 23:04","HierarchicalLedgerManagerFactory.java","67633","90194","157827","","315654"
"2015-09-15 10:38","HierarchicalLedgerManagerFactory.java","12707","103253","115960","","231920"
"2017-03-28 22:40","HierarchicalLedgerManagerFactory.java","67349","88089","155438","","310876"
"2017-05-04 20:58","AbstractZkLedgerManager.java","65822","91473","157295","","314590"
"2013-07-29 12:30","AbstractZkLedgerManager.java","9407","77944","87351","5","174702"
"2017-06-01 23:58","AbstractZkLedgerManager.java","66732","97040","163772","","327544"
"2017-06-12 17:20","AbstractZkLedgerManager.java","66754","98839","165593","","331186"
"2012-12-24 05:50","AbstractZkLedgerManager.java","6402","33888","40290","2","80580"
"2013-03-25 06:27","AbstractZkLedgerManager.java","8845","70558","79403","4","158806"
"2017-03-28 22:40","AbstractZkLedgerManager.java","65566","89370","154936","","309872"
"2016-02-09 08:23","AbstractZkLedgerManager.java","12793","108648","121441","","242882"
"2015-09-15 10:38","AbstractZkLedgerManager.java","12696","106306","119002","","238004"
"2012-12-08 11:18","AbstractZkLedgerManager.java","5243","28269","33512","2","67024"
"2016-02-23 19:16","AbstractZkLedgerManager.java","12798","108991","121789","","243578"
"2014-05-12 08:10","AbstractZkLedgerManager.java","11412","91166","102578","7","205156"
"2014-01-17 18:13","AbstractZkLedgerManager.java","10571","84154","94725","6","189450"
"2014-07-24 01:41","TestFencing.java","7615","61277","68892","","137784"
"2014-02-05 22:43","TestFencing.java","6869","54773","61642","7","123284"
"2013-08-23 18:48","TestFencing.java","4670","46285","50955","5","101910"
"2014-08-02 20:02","ServerConfiguration.java","6116","63061","69177","","138354"
"2014-05-06 12:30","ServerConfiguration.java","5423","53718","59141","7","118282"
"2014-05-15 00:41","ServerConfiguration.java","5443","54652","60095","7","120190"
"2014-09-18 06:47","ServerConfiguration.java","6188","65142","71330","","142660"
"2017-07-04 06:27","ServerConfiguration.java","82922","89918","172840","","345680"
"2014-03-07 13:14","ServerConfiguration.java","5255","51191","56446","7","112892"
"2014-04-29 22:07","ServerConfiguration.java","5420","53668","59088","7","118176"
"2016-04-14 00:51","ServerConfiguration.java","79268","45002","124270","","248540"
"2015-01-16 15:57","ServerConfiguration.java","6587","68513","75100","","150200"
"2013-02-08 19:08","ServerConfiguration.java","269","30982","31251","4","62502"
"2016-03-08 06:49","ServerConfiguration.java","7581","73941","81522","","163044"
"2016-01-26 22:11","ServerConfiguration.java","7329","72675","80004","","160008"
"2014-01-21 05:05","ServerConfiguration.java","4130","47716","51846","6","103692"
"2014-03-12 21:26","ServerConfiguration.java","5329","53067","58396","7","116792"
"2016-04-05 18:47","ServerConfiguration.java","79248","44932","124180","","248360"
"2016-04-27 09:55","ServerConfiguration.java","79316","45562","124878","","249756"
"2015-04-21 09:55","ServerConfiguration.java","6639","69006","75645","","151290"
"2015-01-12 15:18","ServerConfiguration.java","6584","67572","74156","","148312"
"2015-04-21 10:02","ServerConfiguration.java","6635","69035","75670","","151340"
"2017-05-15 19:52","ServerConfiguration.java","81626","78194","159820","","319640"
"2017-03-22 22:54","ServerConfiguration.java","80941","69451","150392","","300784"
"2017-03-23 00:48","ServerConfiguration.java","80945","69507","150452","","300904"
"2017-01-31 02:11","ServerConfiguration.java","80853","62994","143847","","287694"
"2013-02-19 16:19","ServerConfiguration.java","1253","31919","33172","4","66344"
"2013-02-19 16:15","ServerConfiguration.java","1247","31894","33141","4","66282"
"2016-04-05 08:45","ServerConfiguration.java","79246","44688","123934","","247868"
"2016-11-09 03:02","ServerConfiguration.java","80820","55789","136609","","273218"
"2016-11-30 00:02","ServerConfiguration.java","80830","56481","137311","","274622"
"2017-06-05 20:30","ServerConfiguration.java","82510","82629","165139","","330278"
"2016-09-10 20:27","ServerConfiguration.java","80691","51871","132562","","265124"
"2017-08-02 00:49","ServerConfiguration.java","85987","111189","197176","","394352"
"2017-10-03 12:31","ServerConfiguration.java","92636","107995","200631","","401262"
"2017-08-16 03:37","ServerConfiguration.java","87208","119043","206251","","412502"
"2013-07-20 19:59","ServerConfiguration.java","2451","39781","42232","5","84464"
"2013-12-02 18:45","ServerConfiguration.java","4014","46350","50364","6","100728"
"2014-05-09 14:04","ServerConfiguration.java","5438","54327","59765","7","119530"
"2017-05-26 12:38","ServerConfiguration.java","81757","80641","162398","","324796"
"2013-06-15 19:05","ServerConfiguration.java","2361","39122","41483","5","82966"
"2014-01-15 15:58","ServerConfiguration.java","4094","46774","50868","6","101736"
"2013-10-22 07:44","ServerConfiguration.java","3889","43728","47617","6","95234"
"2017-07-07 08:19","ServerConfiguration.java","82912","91871","174783","","349566"
"2017-06-28 23:24","ServerConfiguration.java","82658","85821","168479","","336958"
"2017-11-08 12:27","ServerConfiguration.java","93984","127217","221201","","442402"
"2014-01-22 14:35","ServerConfiguration.java","4415","49016","53431","6","106862"
"2013-10-12 05:42","ServerConfiguration.java","3684","43150","46834","6","93668"
"2016-02-09 08:12","FlatLedgerManager.java","6198","39827","46025","","92050"
"2017-07-28 20:12","ClientConnectionPeer.java","5908","34745","40653","","81306"
"2014-01-21 05:19","LedgerDeleteOp.java","5379","52372","57751","6","115502"
"2015-04-21 09:17","LedgerDeleteOp.java","7603","72860","80463","","160926"
"2015-10-06 10:05","LedgerDeleteOp.java","8250","74698","82948","","165896"
"2017-05-15 19:52","RequestProcessor.java","112690","65672","178362","","356724"
"2011-11-17 11:16","AsyncLedgerOpsTest.java","2969","5310","8279","","16558"
"2011-10-18 10:42","AsyncLedgerOpsTest.java","45","275","320","","640"
"2014-07-24 01:41","AsyncLedgerOpsTest.java","19365","151005","170370","","340740"
"2012-06-19 12:39","AsyncLedgerOpsTest.java","12679","37919","50598","2","101196"
"2016-07-14 23:02","BenchThroughputLatency.java","48305","73328","121633","","243266"
"2013-10-29 05:14","BenchThroughputLatency.java","13940","112101","126041","6","252082"
"2013-10-14 16:43","BenchThroughputLatency.java","13764","111056","124820","6","249640"
"2012-09-12 11:59","BenchThroughputLatency.java","5682","36516","42198","2","84396"
"2014-07-15 09:09","BenchThroughputLatency.java","14646","122955","137601","","275202"
"2013-02-08 19:08","BenchThroughputLatency.java","11382","99887","111269","4","222538"
"2011-11-18 11:18","BookieFailureTest.java","2545","5696","8241","","16482"
"2012-02-13 15:46","BookieFailureTest.java","3724","15252","18976","1","37952"
"2012-12-20 06:48","BookieFailureTest.java","16886","94394","111280","2","222560"
"2012-08-13 11:38","BookieFailureTest.java","13701","53341","67042","2","134084"
"2014-07-24 01:41","BookieFailureTest.java","19054","150216","169270","","338540"
"2012-06-19 12:39","BookieFailureTest.java","11948","36710","48658","2","97316"
"2013-01-04 11:32","ServerConfiguration.java","3971","10626","14597","2","29194"
"2014-08-02 20:02","ServerConfiguration.java","9557","74605","84162","","168324"
"2014-05-06 12:30","ServerConfiguration.java","8949","65347","74296","7","148592"
"2014-05-15 00:41","ServerConfiguration.java","8965","66277","75242","7","150484"
"2014-09-18 06:47","ServerConfiguration.java","9625","76682","86307","","172614"
"2017-07-04 06:27","ServerConfiguration.java","81128","96227","177355","","354710"
"2014-03-07 13:14","ServerConfiguration.java","8884","62923","71807","7","143614"
"2014-04-29 22:07","ServerConfiguration.java","8949","65300","74249","7","148498"
"2016-04-14 00:51","ServerConfiguration.java","77936","51773","129709","","259418"
"2015-01-16 15:57","ServerConfiguration.java","9994","80023","90017","","180034"
"2013-02-08 19:08","ServerConfiguration.java","4817","43633","48450","4","96900"
"2016-03-08 06:49","ServerConfiguration.java","10769","85232","96001","","192002"
"2016-01-26 22:11","ServerConfiguration.java","10556","84005","94561","","189122"
"2014-01-21 05:05","ServerConfiguration.java","7996","59685","67681","6","135362"
"2014-03-12 21:26","ServerConfiguration.java","8909","64750","73659","7","147318"
"2016-04-05 18:47","ServerConfiguration.java","77916","51703","129619","","259238"
"2016-04-27 09:55","ServerConfiguration.java","77972","52321","130293","","260586"
"2015-04-21 09:55","ServerConfiguration.java","10038","80508","90546","","181092"
"2015-01-12 15:18","ServerConfiguration.java","9992","79083","89075","","178150"
"2015-04-21 10:02","ServerConfiguration.java","10034","80537","90571","","181142"
"2013-01-14 16:59","ServerConfiguration.java","4596","12699","17295","2","34590"
"2017-05-15 19:52","ServerConfiguration.java","80036","84707","164743","","329486"
"2017-03-22 22:54","ServerConfiguration.java","79441","76054","155495","","310990"
"2012-12-11 18:59","ServerConfiguration.java","2046","3002","5048","2","10096"
"2017-03-23 00:48","ServerConfiguration.java","79445","76110","155555","","311110"
"2017-01-31 02:11","ServerConfiguration.java","79355","69599","148954","","297908"
"2013-02-19 16:19","ServerConfiguration.java","5704","44473","50177","4","100354"
"2013-02-19 16:15","ServerConfiguration.java","5699","44449","50148","4","100296"
"2016-04-05 08:45","ServerConfiguration.java","77914","51459","129373","","258746"
"2016-11-09 03:02","ServerConfiguration.java","79322","62394","141716","","283432"
"2016-11-30 00:02","ServerConfiguration.java","79332","63086","142418","","284836"
"2017-06-05 20:30","ServerConfiguration.java","80883","89105","169988","","339976"
"2016-09-10 20:27","ServerConfiguration.java","79197","58480","137677","","275354"
"2017-08-02 00:49","ServerConfiguration.java","84109","117414","201523","","403046"
"2017-10-03 12:31","ServerConfiguration.java","89832","113294","203126","","406252"
"2017-08-16 03:37","ServerConfiguration.java","85141","125079","210220","","420440"
"2013-07-20 19:59","ServerConfiguration.java","6599","52032","58631","5","117262"
"2013-12-02 18:45","ServerConfiguration.java","7885","58324","66209","6","132418"
"2014-05-09 14:04","ServerConfiguration.java","8963","65955","74918","7","149836"
"2017-05-26 12:38","ServerConfiguration.java","80162","87149","167311","","334622"
"2013-06-15 19:05","ServerConfiguration.java","6526","51390","57916","5","115832"
"2014-01-15 15:58","ServerConfiguration.java","7965","58748","66713","6","133426"
"2013-10-22 07:44","ServerConfiguration.java","7769","55711","63480","6","126960"
"2017-07-07 08:19","ServerConfiguration.java","81117","98179","179296","","358592"
"2017-06-28 23:24","ServerConfiguration.java","80942","92208","173150","","346300"
"2017-11-08 12:27","ServerConfiguration.java","91032","132368","223400","","446800"
"2014-01-22 14:35","ServerConfiguration.java","8258","60962","69220","6","138440"
"2013-10-12 05:42","ServerConfiguration.java","7661","55230","62891","6","125782"
"2011-11-18 11:18","BookieZKExpireTest.java","3592","7221","10813","","21626"
"2012-03-15 10:37","BookieZKExpireTest.java","11307","28799","40106","1","80212"
"2013-03-25 06:27","BookieZKExpireTest.java","18695","131008","149703","4","299406"
"2012-12-15 03:08","BookieZKExpireTest.java","17338","94584","111922","2","223844"
"2014-12-10 19:43","BookieZKExpireTest.java","19422","160690","180112","","360224"
"2016-01-26 22:11","BookieZKExpireTest.java","19475","165968","185443","","370886"
"2017-06-01 23:58","SASLBookieAuthProvider.java","1148","2055","3203","","6406"
"2017-05-15 19:52","LedgerHandle.java","52076","99016","151092","","302184"
"2017-05-02 22:07","LedgerHandle.java","51633","96219","147852","","295704"
"2017-03-23 15:55","LedgerHandle.java","51569","90529","142098","","284196"
"2012-12-28 12:32","LedgerHandle.java","8637","55970","64607","2","129214"
"2016-09-10 21:01","LedgerHandle.java","51400","73073","124473","","248946"
"2016-07-11 23:01","LedgerHandle.java","50997","68566","119563","","239126"
"2013-04-26 18:38","LedgerHandle.java","10630","92874","103504","5","207008"
"2013-10-14 18:32","LedgerHandle.java","11945","101876","113821","6","227642"
"2014-02-05 22:43","LedgerHandle.java","12641","107748","120389","7","240778"
"2014-02-21 19:01","LedgerHandle.java","12731","109001","121732","7","243464"
"2017-05-17 08:57","LedgerHandle.java","52151","99568","151719","","303438"
"2017-05-25 14:23","LedgerHandle.java","52180","101402","153582","","307164"
"2017-06-21 19:50","LedgerHandle.java","52807","104960","157767","","315534"
"2017-06-21 21:00","LedgerHandle.java","52810","105746","158556","","317112"
"2017-06-01 23:58","LedgerHandle.java","52761","102894","155655","","311310"
"2012-09-12 11:59","LedgerHandle.java","3511","26925","30436","2","60872"
"2014-01-21 05:19","LedgerHandle.java","12217","106521","118738","6","237476"
"2014-09-18 06:47","LedgerHandle.java","13265","122591","135856","","271712"
"2014-12-09 19:57","LedgerHandle.java","13333","123752","137085","","274170"
"2017-07-04 06:27","LedgerHandle.java","52912","110280","163192","","326384"
"2017-06-30 00:12","LedgerHandle.java","52827","108234","161061","","322122"
"2014-05-30 14:01","LedgerHandle.java","12831","113035","125866","7","251732"
"2014-05-30 15:07","LedgerHandle.java","12851","113094","125945","7","251890"
"2014-01-17 18:13","LedgerHandle.java","12152","105560","117712","6","235424"
"2013-01-07 12:25","LedgerHandle.java","8898","58034","66932","2","133864"
"2012-08-28 10:51","LedgerHandle.java","3228","23058","26286","2","52572"
"2012-09-14 11:53","LedgerHandle.java","3604","27253","30857","2","61714"
"2016-02-09 08:32","LedgerHandle.java","13955","129805","143760","","287520"
"2016-03-16 05:03","LedgerHandle.java","50931","64042","114973","","229946"
"2015-10-22 09:22","LedgerHandle.java","13872","128687","142559","","285118"
"2015-10-06 10:05","LedgerHandle.java","13863","127622","141485","","282970"
"2017-01-31 04:01","LedgerHandle.java","51519","90113","141632","","283264"
"2015-04-21 09:39","LedgerHandle.java","13536","126124","139660","","279320"
"2015-10-06 11:12","LedgerHandle.java","13864","127863","141727","","283454"
"2014-12-05 14:10","LedgerHandle.java","13315","123285","136600","","273200"
"2014-12-10 19:43","BookieInitializationTest.java","5481","28794","34275","","68550"
"2014-06-06 15:29","BookieInitializationTest.java","4017","17694","21711","7","43422"
"2015-07-10 22:48","BookieInitializationTest.java","5795","31748","37543","","75086"
"2013-10-02 07:01","BookieInitializationTest.java","513","2438","2951","5","5902"
"2013-07-24 16:55","BookieInitializationTest.java","223","1361","1584","5","3168"
"2014-01-21 17:26","BookieInitializationTest.java","2460","9877","12337","6","24674"
"2013-10-12 05:42","BookieInitializationTest.java","1526","4184","5710","6","11420"
"2017-07-07 08:19","BookieInitializationTest.java","114848","86999","201847","","403694"
"2017-06-28 23:24","BookieInitializationTest.java","114586","80941","195527","","391054"
"2017-07-28 06:39","BookieInitializationTest.java","115493","89533","205026","","410052"
"2017-08-02 00:49","BookieInitializationTest.java","117969","106363","224332","","448664"
"2017-06-05 20:30","BookieInitializationTest.java","114423","77734","192157","","384314"
"2017-05-15 19:52","BookieInitializationTest.java","113487","73247","186734","","373468"
"2014-02-05 22:43","BookieClientTest.java","19072","137282","156354","7","312708"
"2013-10-12 05:42","BookieClientTest.java","18583","131524","150107","6","300214"
"2017-06-21 19:58","BookieClientTest.java","43269","118635","161904","","323808"
"2014-07-25 00:34","BookieClientTest.java","19510","149300","168810","","337620"
"2017-03-28 22:35","BookieClientTest.java","42728","109017","151745","","303490"
"2016-12-17 02:39","BookieClientTest.java","42694","97266","139960","","279920"
"2017-05-15 19:52","BookieClientTest.java","43098","113141","156239","","312478"
"2014-12-10 19:43","BookieClientTest.java","19552","153148","172700","","345400"
"2015-10-06 10:05","BookieClientTest.java","19748","156610","176358","","352716"
"2014-07-24 01:41","BookieClientTest.java","19368","143336","162704","","325408"
"2014-03-07 13:30","NativeIO.java","3642","12248","15890","7","31780"
"2013-10-14 16:43","NativeIO.java","1547","3717","5264","6","10528"
"2014-02-05 22:43","BookieClientTest.java","18498","142682","161180","7","322360"
"2013-10-12 05:42","BookieClientTest.java","18094","137009","155103","6","310206"
"2017-06-21 19:58","BookieClientTest.java","40393","121733","162126","","324252"
"2011-11-18 11:18","BookieClientTest.java","939","2870","3809","","7618"
"2014-07-25 00:34","BookieClientTest.java","18889","154653","173542","","347084"
"2017-03-28 22:35","BookieClientTest.java","40082","112345","152427","","304854"
"2016-12-17 02:39","BookieClientTest.java","40083","100629","140712","","281424"
"2017-05-15 19:52","BookieClientTest.java","40249","116266","156515","","313030"
"2014-12-10 19:43","BookieClientTest.java","18915","158485","177400","","354800"
"2012-01-13 18:06","BookieClientTest.java","2014","7988","10002","1","20004"
"2015-10-06 10:05","BookieClientTest.java","18962","161798","180760","","361520"
"2014-07-24 01:41","BookieClientTest.java","18739","148681","167420","","334840"
"2016-11-18 00:44","BookieWatcher.java","110766","41295","152061","","304122"
"2016-12-21 01:48","LedgerCacheTest.java","110979","42144","153123","","306246"
"2019-02-20 11:43","LedgerCacheTest.java","135568","405410","540978","","1081956"
"2017-05-16 00:31","LedgerCacheTest.java","112271","58764","171035","","342070"
"2014-12-10 19:43","LedgerCacheTest.java","1949","11577","13526","","27052"
"2016-03-08 06:49","LedgerCacheTest.java","3369","19236","22605","","45210"
"2016-09-10 20:27","LocalBookiesRegistry.java","4363","9859","14222","","28444"
"2017-03-23 15:58","LocalBookiesRegistry.java","6809","29772","36581","","73162"
"2017-05-16 00:31","BookieProtocol.java","40269","116704","156973","","313946"
"2017-06-01 21:20","BookieProtocol.java","40382","119144","159526","","319052"
"2012-02-13 11:19","BookieProtocol.java","2295","12523","14818","1","29636"
"2012-04-02 12:38","BookieProtocol.java","9922","28001","37923","1","75846"
"2013-03-18 00:31","BookieProtocol.java","17715","127963","145678","4","291356"
"2016-04-05 08:45","BookieProtocol.java","39944","84835","124779","","249558"
"2013-02-12 11:16","BookieProtocol.java","17617","127652","145269","4","290538"
"2017-05-15 19:52","BookieProtocol.java","40249","116266","156515","","313030"
"2012-10-18 16:40","BookieProtocol.java","15728","76462","92190","2","184380"
"2017-06-05 22:25","BookieProtocol.java","40372","121031","161403","","322806"
"2012-05-25 17:13","BookieProtocol.java","10849","31995","42844","1","85688"
"2017-07-04 06:27","ServerConfiguration.java","2652","13080","15732","","31464"
"2017-06-05 20:30","ServerConfiguration.java","1582","5133","6715","","13430"
"2017-08-02 00:49","ServerConfiguration.java","7739","36373","44112","","88224"
"2017-10-03 12:31","ServerConfiguration.java","32773","51564","84337","","168674"
"2017-08-16 03:37","ServerConfiguration.java","10175","45442","55617","","111234"
"2017-05-26 12:38","ServerConfiguration.java","366","2682","3048","","6096"
"2017-07-07 08:19","ServerConfiguration.java","2743","15134","17877","","35754"
"2017-06-28 23:24","ServerConfiguration.java","2009","8604","10613","","21226"
"2017-11-08 12:27","ServerConfiguration.java","36593","73258","109851","","219702"
"2017-07-04 06:27","ServerConfiguration.java","4542","23028","27570","","55140"
"2017-05-15 19:52","ServerConfiguration.java","2093","10151","12244","","24488"
"2017-03-23 00:48","ServerConfiguration.java","7","59","66","","132"
"2017-06-05 20:30","ServerConfiguration.java","3538","15147","18685","","37370"
"2017-08-02 00:49","ServerConfiguration.java","9194","45886","55080","","110160"
"2017-10-03 12:31","ServerConfiguration.java","32188","59037","91225","","182450"
"2017-08-16 03:37","ServerConfiguration.java","11628","54953","66581","","133162"
"2017-05-26 12:38","ServerConfiguration.java","2402","12776","15178","","30356"
"2017-07-07 08:19","ServerConfiguration.java","4606","25055","29661","","59322"
"2017-06-28 23:24","ServerConfiguration.java","3944","18597","22541","","45082"
"2017-11-08 12:27","ServerConfiguration.java","35668","80391","116059","","232118"
"2017-08-16 03:41","RackawareEnsemblePlacementPolicy.java","12047","69440","81487","","162974"
"2016-11-18 00:44","RackawareEnsemblePlacementPolicy.java","327","925","1252","","2504"
"2017-03-28 22:35","RackawareEnsemblePlacementPolicy.java","1240","19388","20628","","41256"
"2017-07-28 20:12","RackawareEnsemblePlacementPolicy.java","6467","43391","49858","","99716"
"2017-07-28 20:12","AuthProviderFactoryFactory.java","11588","57736","69324","","138648"
"2017-01-31 02:14","AuthProviderFactoryFactory.java","6577","23888","30465","","60930"
"2016-07-14 23:02","FileSystemUpgrade.java","110113","46631","156744","","313488"
"2017-03-22 22:54","FileSystemUpgrade.java","111544","69341","180885","","361770"
"2014-09-18 06:57","FileSystemUpgrade.java","6005","34273","40278","","80556"
"2017-07-28 20:12","LedgerChecker.java","114568","80260","194828","","389656"
"2017-05-15 19:52","LedgerChecker.java","111919","62589","174508","","349016"
"2016-10-13 07:50","EnsemblePlacementPolicy.java","110618","40549","151167","","302334"
"2017-03-28 22:35","EnsemblePlacementPolicy.java","110928","59007","169935","","339870"
"2017-07-28 20:12","EnsemblePlacementPolicy.java","114467","81322","195789","","391578"
"2016-11-18 00:44","EnsemblePlacementPolicy.java","110766","41295","152061","","304122"
"2017-06-01 23:58","Journal.java","1071","1928","2999","","5998"
"2017-06-01 23:58","ReplicationWorker.java","114369","51934","166303","","332606"
"2017-04-11 20:14","ReplicationWorker.java","112261","43338","155599","","311198"
"2016-03-16 04:51","ReplicationWorker.java","106139","6479","112618","","225236"
"2016-09-10 21:01","ReplicationWorker.java","110171","19276","129447","","258894"
"2017-05-26 16:52","ReplicationWorker.java","113541","50249","163790","","327580"
"2012-03-15 10:37","TestLedgerManager.java","8486","19605","28091","1","56182"
"2013-03-25 06:27","TestLedgerManager.java","18652","124592","143244","4","286488"
"2012-11-23 11:49","TestLedgerManager.java","16580","81123","97703","2","195406"
"2012-12-10 10:58","TestLedgerManager.java","16781","84027","100808","2","201616"
"2017-03-28 22:40","TestLedgerManager.java","42181","110212","152393","","304786"
"2015-07-10 22:48","TestLedgerManager.java","20034","157569","177603","","355206"
"2014-07-24 01:41","TestLedgerManager.java","19806","145073","164879","","329758"
"2012-06-19 12:39","TestLedgerManager.java","10996","29863","40859","2","81718"
"2017-07-04 06:27","SyncThreadTest.java","4948","36823","41771","","83542"
"2017-01-31 04:01","SyncThreadTest.java","779","13880","14659","","29318"
"2017-03-28 22:37","SyncThreadTest.java","1057","18965","20022","","40044"
"2017-05-16 00:31","SyncThreadTest.java","2889","24754","27643","","55286"
"2017-06-01 08:55","StatsLogger.java","112801","71410","184211","","368422"
"2014-02-05 22:43","BookieClientTest.java","19159","145041","164200","7","328400"
"2013-10-12 05:42","BookieClientTest.java","18908","139521","158429","6","316858"
"2017-06-21 19:58","BookieClientTest.java","40535","123573","164108","","328216"
"2011-11-18 11:18","BookieClientTest.java","3592","7221","10813","","21626"
"2014-07-25 00:34","BookieClientTest.java","19399","156861","176260","","352520"
"2017-03-28 22:35","BookieClientTest.java","40277","114238","154515","","309030"
"2016-12-17 02:39","BookieClientTest.java","40280","102524","142804","","285608"
"2017-05-15 19:52","BookieClientTest.java","40437","118152","158589","","317178"
"2014-12-10 19:43","BookieClientTest.java","19422","160690","180112","","360224"
"2012-01-13 18:06","BookieClientTest.java","4405","12077","16482","1","32964"
"2011-11-16 17:05","BookieClientTest.java","2735","4433","7168","","14336"
"2015-10-06 10:05","BookieClientTest.java","19469","164003","183472","","366944"
"2011-10-27 15:41","BookieClientTest.java","147","598","745","","1490"
"2014-07-24 01:41","BookieClientTest.java","19365","151005","170370","","340740"
"2014-12-09 19:57","LedgerCloseTest.java","2516","17828","20344","","40688"
"2016-03-16 04:43","LedgerCloseTest.java","107518","25290","132808","","265616"
"2017-05-16 00:31","LedgerCloseTest.java","111999","64250","176249","","352498"
"2017-05-02 23:04","StringUtils.java","80510","78649","159159","","318318"
"2017-06-01 23:58","MSLedgerManagerFactory.java","113588","50286","163874","","327748"
"2017-03-28 22:40","MSLedgerManagerFactory.java","111394","41588","152982","","305964"
"2016-12-21 01:48","SortedLedgerStorage.java","112852","37565","150417","","300834"
"2017-05-12 16:39","SortedLedgerStorage.java","113669","52482","166151","","332302"
"2017-05-16 00:31","SortedLedgerStorage.java","114344","54385","168729","","337458"
"2016-03-08 06:49","SortedLedgerStorage.java","2704","12119","14823","","29646"
"2015-04-21 10:02","SortedLedgerStorage.java","1434","6889","8323","","16646"
"2017-05-16 00:31","BookieProtocol.java","40457","118590","159047","","318094"
"2017-06-01 21:20","BookieProtocol.java","40527","120987","161514","","323028"
"2012-02-13 11:19","BookieProtocol.java","4520","16446","20966","1","41932"
"2012-04-02 12:38","BookieProtocol.java","11814","31591","43405","1","86810"
"2013-03-18 00:31","BookieProtocol.java","18654","130600","149254","4","298508"
"2016-04-05 08:45","BookieProtocol.java","40190","86779","126969","","253938"
"2013-02-12 11:16","BookieProtocol.java","18566","130299","148865","4","297730"
"2017-05-15 19:52","BookieProtocol.java","40437","118152","158589","","317178"
"2011-11-16 17:05","BookieProtocol.java","2735","4433","7168","","14336"
"2011-10-27 15:41","BookieProtocol.java","147","598","745","","1490"
"2012-10-18 16:40","BookieProtocol.java","16852","79284","96136","2","192272"
"2017-06-05 22:25","BookieProtocol.java","40519","122876","163395","","326790"
"2012-05-25 17:13","BookieProtocol.java","12570","35414","47984","1","95968"
"2017-05-15 19:52","LedgerHandle.java","48676","103547","152223","","304446"
"2017-05-02 22:07","LedgerHandle.java","48279","100796","149075","","298150"
"2017-03-23 15:55","LedgerHandle.java","48220","95111","143331","","286662"
"2012-12-28 12:32","LedgerHandle.java","10631","65895","76526","2","153052"
"2016-09-10 21:01","LedgerHandle.java","48069","77673","125742","","251484"
"2016-07-11 23:01","LedgerHandle.java","48018","73518","121536","","243072"
"2013-04-26 18:38","LedgerHandle.java","12599","102774","115373","5","230746"
"2013-10-14 18:32","LedgerHandle.java","13842","111704","125546","6","251092"
"2014-02-05 22:43","LedgerHandle.java","14477","117515","131992","7","263984"
"2014-02-21 19:01","LedgerHandle.java","14544","118745","133289","7","266578"
"2017-05-17 08:57","LedgerHandle.java","48753","104101","152854","","305708"
"2017-05-25 14:23","LedgerHandle.java","48782","105935","154717","","309434"
"2017-06-21 19:50","LedgerHandle.java","49410","109494","158904","","317808"
"2017-06-21 21:00","LedgerHandle.java","49411","110278","159689","","319378"
"2017-06-01 23:58","LedgerHandle.java","49362","107426","156788","","313576"
"2012-06-29 18:43","LedgerHandle.java","2417","10348","12765","2","25530"
"2012-09-12 11:59","LedgerHandle.java","5809","37154","42963","2","85926"
"2012-06-19 12:39","LedgerHandle.java","952","3348","4300","2","8600"
"2014-01-21 05:19","LedgerHandle.java","14086","116321","130407","6","260814"
"2012-06-27 15:35","LedgerHandle.java","2403","10004","12407","2","24814"
"2014-09-18 06:47","LedgerHandle.java","15072","132329","147401","","294802"
"2014-12-09 19:57","LedgerHandle.java","15139","133489","148628","","297256"
"2017-07-04 06:27","LedgerHandle.java","49493","114792","164285","","328570"
"2017-06-30 00:12","LedgerHandle.java","49423","112761","162184","","324368"
"2014-05-30 14:01","LedgerHandle.java","14637","122772","137409","7","274818"
"2014-05-30 15:07","LedgerHandle.java","14655","122829","137484","7","274968"
"2014-01-17 18:13","LedgerHandle.java","14025","115364","129389","6","258778"
"2013-01-07 12:25","LedgerHandle.java","10906","67973","78879","2","157758"
"2012-08-28 10:51","LedgerHandle.java","5582","33343","38925","2","77850"
"2012-09-14 11:53","LedgerHandle.java","5894","37474","43368","2","86736"
"2016-02-09 08:32","LedgerHandle.java","15675","139456","155131","","310262"
"2016-03-16 05:03","LedgerHandle.java","47955","68997","116952","","233904"
"2015-10-22 09:22","LedgerHandle.java","15595","138341","153936","","307872"
"2015-10-06 10:05","LedgerHandle.java","15584","137274","152858","","305716"
"2017-01-31 04:01","LedgerHandle.java","48182","94707","142889","","285778"
"2015-04-21 09:39","LedgerHandle.java","15328","135847","151175","","302350"
"2015-10-06 11:12","LedgerHandle.java","15585","137515","153100","","306200"
"2014-12-05 14:10","LedgerHandle.java","15122","133023","148145","","296290"
"2017-05-04 20:58","AbstractZkLedgerManager.java","771","2618","3389","","6778"
"2017-06-01 23:58","AbstractZkLedgerManager.java","3184","9688","12872","","25744"
"2017-06-12 17:20","AbstractZkLedgerManager.java","3623","11904","15527","","31054"
"2017-05-26 16:52","Journal.java","2416","12810","15226","","30452"
"2017-06-01 23:58","Journal.java","3370","14621","17991","","35982"
"2017-05-09 22:24","Journal.java","1037","7633","8670","","17340"
"2017-05-16 00:31","Journal.java","2320","10796","13116","","26232"
"2014-02-21 19:01","LedgerChecker.java","201","1364","1565","7","3130"
"2017-07-28 20:12","LedgerChecker.java","114467","81322","195789","","391578"
"2017-05-15 19:52","LedgerChecker.java","111874","63707","175581","","351162"
"2017-06-30 00:12","ReadLastConfirmedOp.java","2341","10808","13149","","26298"
"2017-06-01 23:58","ReadLastConfirmedOp.java","1414","4607","6021","","12042"
"2017-08-02 00:49","DefaultPerChannelBookieClientPool.java","119734","88621","208355","","416710"
"2015-03-12 08:21","AuditorPeriodicCheckTest.java","4732","27773","32505","","65010"
"2014-04-24 14:44","AuditorPeriodicCheckTest.java","2906","11853","14759","7","29518"
"2014-02-05 22:43","AuditorPeriodicCheckTest.java","2518","8328","10846","7","21692"
"2017-05-16 00:31","AuditorPeriodicCheckTest.java","113235","71296","184531","","369062"
"2014-07-25 00:34","AuditorPeriodicCheckTest.java","3788","21178","24966","","49932"
"2016-09-10 21:01","AuditorPeriodicCheckTest.java","110649","43025","153674","","307348"
"2017-07-04 06:27","LedgerDescriptorImpl.java","833","6619","7452","","14904"
"2017-06-21 19:58","BookieClientTest.java","114006","52510","166516","","333032"
"2017-03-28 22:35","BookieClientTest.java","111228","40655","151883","","303766"
"2016-12-17 02:39","BookieClientTest.java","110963","28673","139636","","279272"
"2017-05-15 19:52","BookieClientTest.java","112499","45680","158179","","316358"
"2017-10-17 09:32","AuditorElector.java","91860","119151","211011","","422022"
"2013-08-21 13:19","AuditorElector.java","4775","47290","52065","5","104130"
"2016-07-14 23:02","AuditorElector.java","79103","50412","129515","","259030"
"2016-09-10 21:01","AuditorElector.java","80293","55672","135965","","271930"
"2013-03-05 18:45","AuditorElector.java","3733","38557","42290","4","84580"
"2012-12-18 12:00","AuditorElector.java","265","884","1149","2","2298"
"2017-03-28 22:40","AuditorElector.java","80607","77942","158549","","317098"
"2014-06-02 11:54","AuditorElector.java","7362","61448","68810","7","137620"
"2014-04-24 10:43","AuditorElector.java","7188","59136","66324","7","132648"
"2014-09-06 07:58","AuditorElector.java","7916","70945","78861","","157722"
"2013-01-04 11:32","AuditorElector.java","1915","4545","6460","2","12920"
"2015-09-15 10:38","GcLedgersTest.java","16013","141025","157038","","314076"
"2016-04-27 09:55","GcLedgersTest.java","47142","75337","122479","","244958"
"2017-03-28 22:37","GcLedgersTest.java","47360","102338","149698","","299396"
"2016-03-08 06:49","GcLedgersTest.java","16206","144515","160721","","321442"
"2012-06-19 12:39","GcLedgersTest.java","2472","8514","10986","2","21972"
"2017-07-04 06:27","GcLedgersTest.java","48600","117545","166145","","332290"
"2014-07-24 01:41","GcLedgersTest.java","15358","127800","143158","","286316"
"2013-04-04 11:21","GcLedgersTest.java","13351","106976","120327","5","240654"
"2013-07-29 12:30","GcLedgersTest.java","13612","113551","127163","5","254326"
"2017-05-16 00:31","GcLedgersTest.java","47857","106792","154649","","309298"
"2012-12-24 05:50","GcLedgersTest.java","11231","70119","81350","2","162700"
"2017-04-11 20:19","BookKeeperCloseTest.java","112702","47148","159850","","319700"
"2017-05-16 00:31","BookKeeperCloseTest.java","113857","52013","165870","","331740"
"2014-12-06 07:38","BookKeeperCloseTest.java","148","1051","1199","","2398"
"2017-05-15 19:52","LedgerHandle.java","48257","104382","152639","","305278"
"2017-05-02 22:07","LedgerHandle.java","47860","101631","149491","","298982"
"2017-03-23 15:55","LedgerHandle.java","47801","95946","143747","","287494"
"2012-12-28 12:32","LedgerHandle.java","10957","67475","78432","2","156864"
"2016-09-10 21:01","LedgerHandle.java","47650","78508","126158","","252316"
"2016-07-11 23:01","LedgerHandle.java","47599","74353","121952","","243904"
"2013-04-26 18:38","LedgerHandle.java","12909","104338","117247","5","234494"
"2013-10-14 18:32","LedgerHandle.java","14150","113266","127416","6","254832"
"2014-02-05 22:43","LedgerHandle.java","14782","119074","133856","7","267712"
"2014-02-21 19:01","LedgerHandle.java","14849","120304","135153","7","270306"
"2017-05-17 08:57","LedgerHandle.java","48334","104936","153270","","306540"
"2017-05-25 14:23","LedgerHandle.java","48363","106770","155133","","310266"
"2017-06-21 19:50","LedgerHandle.java","48991","110329","159320","","318640"
"2017-06-21 21:00","LedgerHandle.java","48991","111112","160103","","320206"
"2017-06-01 23:58","LedgerHandle.java","48943","108261","157204","","314408"
"2012-06-29 18:43","LedgerHandle.java","2909","12094","15003","2","30006"
"2012-05-25 17:13","LedgerHandle.java","498","1752","2250","1","4500"
"2012-09-12 11:59","LedgerHandle.java","6248","38847","45095","2","90190"
"2012-06-19 12:39","LedgerHandle.java","1445","5095","6540","2","13080"
"2014-01-21 05:19","LedgerHandle.java","14389","117878","132267","6","264534"
"2012-06-27 15:35","LedgerHandle.java","2895","11750","14645","2","29290"
"2014-09-18 06:47","LedgerHandle.java","15368","133879","149247","","298494"
"2014-12-09 19:57","LedgerHandle.java","15433","135037","150470","","300940"
"2017-07-04 06:27","LedgerHandle.java","49074","115627","164701","","329402"
"2017-06-30 00:12","LedgerHandle.java","49003","113595","162598","","325196"
"2014-05-30 14:01","LedgerHandle.java","14942","124331","139273","7","278546"
"2014-05-30 15:07","LedgerHandle.java","14959","124387","139346","7","278692"
"2014-01-17 18:13","LedgerHandle.java","14328","116921","131249","6","262498"
"2013-01-07 12:25","LedgerHandle.java","11232","69553","80785","2","161570"
"2012-08-28 10:51","LedgerHandle.java","6022","35037","41059","2","82118"
"2012-09-14 11:53","LedgerHandle.java","6331","39165","45496","2","90992"
"2016-02-09 08:32","LedgerHandle.java","15963","140998","156961","","313922"
"2016-03-16 05:03","LedgerHandle.java","47544","69840","117384","","234768"
"2015-10-22 09:22","LedgerHandle.java","15883","139883","155766","","311532"
"2015-10-06 10:05","LedgerHandle.java","15872","138816","154688","","309376"
"2017-01-31 04:01","LedgerHandle.java","47763","95542","143305","","286610"
"2015-04-21 09:39","LedgerHandle.java","15616","137389","153005","","306010"
"2015-10-06 11:12","LedgerHandle.java","15873","139057","154930","","309860"
"2014-12-05 14:10","LedgerHandle.java","15416","134571","149987","","299974"
"2017-03-22 22:54","CompactionTest.java","6499","28740","35239","","70478"
"2017-06-21 21:07","CompactionTest.java","9648","46308","55956","","111912"
"2017-11-08 12:27","CompactionTest.java","29479","96443","125922","","251844"
"2017-05-16 00:31","CompactionTest.java","8174","38891","47065","","94130"
"2017-07-07 08:19","CompactionTest.java","10233","52923","63156","","126312"
"2016-04-27 21:11","ZkLedgerUnderreplicationManager.java","78703","46397","125100","","250200"
"2016-07-14 23:02","ZkLedgerUnderreplicationManager.java","78895","47574","126469","","252938"
"2017-07-07 05:11","ZkLedgerUnderreplicationManager.java","82269","92393","174662","","349324"
"2013-08-22 16:40","ZkLedgerUnderreplicationManager.java","3236","43135","46371","5","92742"
"2017-06-28 23:28","ZkLedgerUnderreplicationManager.java","82064","87167","169231","","338462"
"2013-06-15 19:05","ZkLedgerUnderreplicationManager.java","2979","41188","44167","5","88334"
"2017-06-01 23:58","ZkLedgerUnderreplicationManager.java","81833","83042","164875","","329750"
"2014-08-18 23:03","ZkLedgerUnderreplicationManager.java","6550","66411","72961","","145922"
"2014-06-03 12:35","ZkLedgerUnderreplicationManager.java","6042","57966","64008","7","128016"
"2014-06-02 11:54","ZkLedgerUnderreplicationManager.java","6022","57478","63500","7","127000"
"2017-03-28 22:40","ZkLedgerUnderreplicationManager.java","80400","75105","155505","","311010"
"2016-04-27 09:55","ZkLedgerUnderreplicationManager.java","78703","46397","125100","","250200"
"2014-12-10 19:43","BookieInitializationTest.java","5377","27552","32929","","65858"
"2014-06-06 15:29","BookieInitializationTest.java","3907","16446","20353","7","40706"
"2015-07-10 22:48","BookieInitializationTest.java","5691","30506","36197","","72394"
"2013-10-02 07:01","BookieInitializationTest.java","298","1085","1383","5","2766"
"2014-01-21 17:26","BookieInitializationTest.java","2272","8551","10823","6","21646"
"2013-10-12 05:42","BookieInitializationTest.java","1345","2865","4210","6","8420"
"2017-07-07 08:19","BookieInitializationTest.java","115021","86034","201055","","402110"
"2017-06-28 23:24","BookieInitializationTest.java","114756","79973","194729","","389458"
"2017-07-28 06:39","BookieInitializationTest.java","115668","88570","204238","","408476"
"2017-08-02 00:49","BookieInitializationTest.java","118212","105468","223680","","447360"
"2017-06-05 20:30","BookieInitializationTest.java","114590","76763","191353","","382706"
"2017-05-15 19:52","BookieInitializationTest.java","113641","72263","185904","","371808"
"2011-11-17 11:16","AsyncLedgerOpsTest.java","2939","5050","7989","","15978"
"2014-07-24 01:41","AsyncLedgerOpsTest.java","19449","150859","170308","","340616"
"2012-06-19 12:39","AsyncLedgerOpsTest.java","12697","37707","50404","2","100808"
"2015-03-12 08:21","AuditorPeriodicCheckTest.java","2883","20114","22997","","45994"
"2014-04-24 14:44","AuditorPeriodicCheckTest.java","430","3567","3997","7","7994"
"2017-05-16 00:31","AuditorPeriodicCheckTest.java","111999","64250","176249","","352498"
"2014-07-25 00:34","AuditorPeriodicCheckTest.java","1736","13316","15052","","30104"
"2016-09-10 21:01","AuditorPeriodicCheckTest.java","109171","35737","144908","","289816"
"2012-12-18 12:00","BookKeeperClusterTestCase.java","514","3423","3937","2","7874"
"2017-05-15 19:52","BookKeeperClusterTestCase.java","80153","83089","163242","","326484"
"2013-01-09 17:18","BookKeeperClusterTestCase.java","2592","7896","10488","2","20976"
"2016-04-05 08:45","BookKeeperClusterTestCase.java","78015","49825","127840","","255680"
"2017-08-01 08:34","BookKeeperClusterTestCase.java","83757","112742","196499","","392998"
"2013-10-12 05:42","BookKeeperClusterTestCase.java","5941","51775","57716","6","115432"
"2014-02-05 22:43","BookKeeperClusterTestCase.java","7110","58213","65323","7","130646"
"2017-11-08 12:27","BookKeeperClusterTestCase.java","91351","130952","222303","","444606"
"2013-06-15 19:05","BookKeeperClusterTestCase.java","4786","47915","52701","5","105402"
"2014-05-09 14:04","BookKeeperClusterTestCase.java","7350","62607","69957","7","139914"
"2017-07-04 06:27","BookKeeperClusterTestCase.java","81248","94612","175860","","351720"
"2014-07-24 01:41","BookKeeperClusterTestCase.java","7769","64630","72399","","144798"
"2014-05-23 18:46","BookKeeperClusterTestCase.java","7349","62936","70285","7","140570"
"2017-06-30 00:12","BookKeeperClusterTestCase.java","81159","92562","173721","","347442"
"2014-04-24 10:43","BookKeeperClusterTestCase.java","7297","61535","68832","7","137664"
"2012-12-13 12:33","BookKeeperClusterTestCase.java","177","418","595","2","1190"
"2013-01-07 12:25","BookKeeperClusterTestCase.java","2224","7356","9580","2","19160"
"2016-04-27 09:55","BookKeeperClusterTestCase.java","78074","50688","128762","","257524"
"2013-01-03 11:06","BookKeeperClusterTestCase.java","2100","6205","8305","2","16610"
"2015-10-06 10:48","BookKeeperClusterTestCase.java","9018","78999","88017","","176034"
"2014-12-10 19:43","BookKeeperClusterTestCase.java","8395","74884","83279","","166558"
"2017-10-17 09:32","AuditorElector.java","90022","120756","210778","","421556"
"2013-08-21 13:19","AuditorElector.java","4901","50859","55760","5","111520"
"2016-07-14 23:02","AuditorElector.java","77841","52593","130434","","260868"
"2016-09-10 21:01","AuditorElector.java","78886","57708","136594","","273188"
"2013-03-05 18:45","AuditorElector.java","3892","42159","46051","4","92102"
"2012-12-18 12:00","AuditorElector.java","631","4693","5324","2","10648"
"2012-12-14 11:18","AuditorElector.java","371","3814","4185","2","8370"
"2017-03-28 22:40","AuditorElector.java","79199","79977","159176","","318352"
"2014-06-02 11:54","AuditorElector.java","7333","64862","72195","7","144390"
"2014-04-24 10:43","AuditorElector.java","7166","62557","69723","7","139446"
"2014-09-06 07:58","AuditorElector.java","7878","74350","82228","","164456"
"2013-01-04 11:32","AuditorElector.java","2096","8169","10265","2","20530"
"2014-01-21 05:05","BookieRequestHandler.java","1887","6941","8828","6","17656"
"2017-08-02 00:49","BookieRequestHandler.java","118141","104811","222952","","445904"
"2017-05-15 19:52","BookieRequestHandler.java","113551","71587","185138","","370276"
"2014-12-09 19:57","LedgerCloseTest.java","5189","28308","33497","","66994"
"2016-03-16 04:43","LedgerCloseTest.java","109522","35101","144623","","289246"
"2013-10-14 18:32","LedgerCloseTest.java","1610","4241","5851","6","11702"
"2014-02-05 22:43","LedgerCloseTest.java","3427","11234","14661","7","29322"
"2017-05-16 00:31","LedgerCloseTest.java","113577","73635","187212","","374424"
"2013-10-29 05:14","LedgerCloseTest.java","1917","5358","7275","6","14550"
"2017-06-01 22:39","TestSpeculativeRead.java","113034","61917","174951","","349902"
"2017-06-01 23:58","EntryLogger.java","40847","119414","160261","","320522"
"2014-01-21 17:26","EntryLogger.java","18497","141528","160025","6","320050"
"2013-10-02 06:23","EntryLogger.java","18282","135631","153913","5","307826"
"2014-01-22 14:35","EntryLogger.java","18572","141979","160551","6","321102"
"2017-11-08 12:27","EntryLogger.java","42823","154862","197685","","395370"
"2013-10-22 07:44","EntryLogger.java","18369","137014","155383","6","310766"
"2012-03-16 10:41","EntryLogger.java","9310","24570","33880","1","67760"
"2012-06-13 16:57","EntryLogger.java","11016","33149","44165","","88330"
"2012-02-15 16:11","EntryLogger.java","2238","11915","14153","1","28306"
"2013-05-04 14:22","EntryLogger.java","18037","129075","147112","5","294224"
"2011-11-18 11:18","EntryLogger.java","717","2005","2722","","5444"
"2011-12-16 12:43","EntryLogger.java","1686","6183","7869","1","15738"
"2012-03-08 12:13","EntryLogger.java","2510","14025","16535","1","33070"
"2017-01-31 02:11","EntryLogger.java","40563","101510","142073","","284146"
"2017-03-23 00:48","EntryLogger.java","40567","107935","148502","","297004"
"2016-07-14 23:02","EntryLogger.java","40466","86503","126969","","253938"
"2012-12-24 06:23","EntryLogger.java","16547","92514","109061","2","218122"
"2012-12-10 11:04","EntryLogger.java","16319","87703","104022","2","208044"
"2016-02-24 00:44","EntryLogger.java","19290","164104","183394","","366788"
"2015-04-21 10:02","EntryLogger.java","19209","160415","179624","","359248"
"2012-10-18 16:40","EntryLogger.java","15934","76025","91959","2","183918"
"2012-07-26 04:32","EntryLogger.java","12759","44652","57411","2","114822"
"2013-01-04 11:32","EntryLogger.java","16783","94141","110924","2","221848"
"2015-04-21 09:44","EntryLogger.java","19209","160231","179440","","358880"
"2012-05-09 10:39","EntryLogger.java","10413","29376","39789","1","79578"
"2012-05-07 18:48","EntryLogger.java","10405","28944","39349","1","78698"
"2012-05-10 14:47","EntryLogger.java","10664","29913","40577","1","81154"
"2012-05-17 19:07","EntryLogger.java","10943","31247","42190","1","84380"
"2017-05-16 00:31","BookieProtocol.java","40674","118356","159030","","318060"
"2017-06-01 21:20","BookieProtocol.java","40775","120784","161559","","323118"
"2012-02-13 11:19","BookieProtocol.java","4426","15901","20327","1","40654"
"2012-04-02 12:38","BookieProtocol.java","11728","31054","42782","1","85564"
"2013-03-18 00:31","BookieProtocol.java","18714","130209","148923","4","297846"
"2016-04-05 08:45","BookieProtocol.java","40402","86540","126942","","253884"
"2013-02-12 11:16","BookieProtocol.java","18626","129908","148534","4","297068"
"2017-05-15 19:52","BookieProtocol.java","40654","117918","158572","","317144"
"2011-11-16 17:05","BookieProtocol.java","2605","3852","6457","","12914"
"2012-10-18 16:40","BookieProtocol.java","16868","78849","95717","2","191434"
"2017-06-05 22:25","BookieProtocol.java","40763","122669","163432","","326864"
"2012-05-25 17:13","BookieProtocol.java","12489","34882","47371","1","94742"
"2017-07-07 05:11","LedgerUnderreplicationManager.java","71991","103733","175724","","351448"
"2013-01-04 11:32","LedgerUnderreplicationManager.java","4805","26423","31228","2","62456"
"2014-06-03 12:35","LedgerUnderreplicationManager.java","9474","83016","92490","7","184980"
"2012-12-18 12:00","BookKeeperClusterTestCase.java","5533","29032","34565","2","69130"
"2017-05-15 19:52","BookKeeperClusterTestCase.java","67845","91371","159216","","318432"
"2013-01-09 17:18","BookKeeperClusterTestCase.java","7226","33120","40346","2","80692"
"2016-04-05 08:45","BookKeeperClusterTestCase.java","65891","58291","124182","","248364"
"2017-08-01 08:34","BookKeeperClusterTestCase.java","69704","119279","188983","","377966"
"2013-10-12 05:42","BookKeeperClusterTestCase.java","10109","76533","86642","6","173284"
"2014-02-05 22:43","BookKeeperClusterTestCase.java","11112","82805","93917","7","187834"
"2017-11-08 12:27","BookKeeperClusterTestCase.java","76592","136783","213375","","426750"
"2013-06-15 19:05","BookKeeperClusterTestCase.java","9161","72880","82041","5","164082"
"2014-05-09 14:04","BookKeeperClusterTestCase.java","11281","87128","98409","7","196818"
"2012-12-12 11:20","BookKeeperClusterTestCase.java","5077","25667","30744","2","61488"
"2017-07-04 06:27","BookKeeperClusterTestCase.java","68778","102732","171510","","343020"
"2014-07-24 01:41","BookKeeperClusterTestCase.java","11666","89117","100783","","201566"
"2014-05-23 18:46","BookKeeperClusterTestCase.java","11279","87456","98735","7","197470"
"2017-06-30 00:12","BookKeeperClusterTestCase.java","68690","100683","169373","","338746"
"2014-04-24 10:43","BookKeeperClusterTestCase.java","11229","86057","97286","7","194572"
"2012-12-13 12:33","BookKeeperClusterTestCase.java","5243","26074","31317","2","62634"
"2013-01-07 12:25","BookKeeperClusterTestCase.java","6921","32643","39564","2","79128"
"2016-04-27 09:55","BookKeeperClusterTestCase.java","65934","59138","125072","","250144"
"2013-01-03 11:06","BookKeeperClusterTestCase.java","6808","31503","38311","2","76622"
"2015-10-06 10:48","BookKeeperClusterTestCase.java","12665","103236","115901","","231802"
"2014-12-10 19:43","BookKeeperClusterTestCase.java","12235","99314","111549","","223098"
"2017-10-03 12:31","IndexPersistenceMgr.java","30576","38939","69515","","139030"
"2014-12-10 19:43","BookieInitializationTest.java","3852","19748","23600","","47200"
"2014-06-06 15:29","BookieInitializationTest.java","1892","8152","10044","7","20088"
"2015-07-10 22:48","BookieInitializationTest.java","4289","22825","27114","","54228"
"2017-07-07 08:19","BookieInitializationTest.java","114242","78976","193218","","386436"
"2017-06-28 23:24","BookieInitializationTest.java","113937","72875","186812","","373624"
"2017-07-28 06:39","BookieInitializationTest.java","115135","81758","196893","","393786"
"2017-08-02 00:49","BookieInitializationTest.java","117740","98717","216457","","432914"
"2017-06-05 20:30","BookieInitializationTest.java","113744","69638","183382","","366764"
"2017-05-15 19:52","BookieInitializationTest.java","112684","65027","177711","","355422"
"2017-08-16 03:41","TestRegionAwareEnsemblePlacementPolicy.java","10268","45759","56027","","112054"
"2017-05-25 14:23","LedgerFragmentReplicator.java","67649","95345","162994","","325988"
"2014-02-05 22:43","LedgerFragmentReplicator.java","11251","84832","96083","7","192166"
"2014-02-21 19:01","LedgerFragmentReplicator.java","11347","86091","97438","7","194876"
"2016-09-10 21:01","LedgerFragmentReplicator.java","66786","66933","133719","","267438"
"2012-10-05 16:24","LedgerFragmentReplicator.java","3399","10365","13764","2","27528"
"2016-11-18 00:18","LedgerCacheImpl.java","112786","30962","143748","","287496"
"2017-05-16 00:31","LedgerCacheImpl.java","114344","54385","168729","","337458"
"2017-06-01 23:58","LedgerCacheImpl.java","115213","58029","173242","","346484"
"2017-07-04 06:27","LedgerCacheImpl.java","116075","66126","182201","","364402"
"2017-01-31 04:01","LedgerCacheImpl.java","112860","44137","156997","","313994"
"2014-12-10 19:43","BookieInitializationTest.java","4587","25242","29829","","59658"
"2014-06-06 15:29","BookieInitializationTest.java","3044","14063","17107","7","34214"
"2015-07-10 22:48","BookieInitializationTest.java","4921","28216","33137","","66274"
"2014-01-21 17:26","BookieInitializationTest.java","1306","6065","7371","6","14742"
"2017-07-07 08:19","BookieInitializationTest.java","114509","84002","198511","","397022"
"2017-06-28 23:24","BookieInitializationTest.java","114231","77928","192159","","384318"
"2017-07-28 06:39","BookieInitializationTest.java","115207","86589","201796","","403592"
"2017-08-02 00:49","BookieInitializationTest.java","117767","103503","221270","","442540"
"2017-06-05 20:30","BookieInitializationTest.java","114060","74713","188773","","377546"
"2017-05-15 19:52","BookieInitializationTest.java","113068","70170","183238","","366476"
"2014-04-29 22:07","IOUtils.java","11339","87070","98409","7","196818"
"2014-12-10 19:43","IOUtils.java","12282","99886","112168","","224336"
"2017-05-02 23:04","HierarchicalLedgerManager.java","112180","64222","176402","","352804"
"2017-05-12 16:39","HierarchicalLedgerManager.java","112195","64917","177112","","354224"
"2016-07-14 23:02","FileSystemUpgrade.java","77841","52593","130434","","260868"
"2017-03-22 22:54","FileSystemUpgrade.java","79121","75152","154273","","308546"
"2013-02-08 19:08","FileSystemUpgrade.java","3007","41241","44248","4","88496"
"2014-09-18 06:57","FileSystemUpgrade.java","7942","74444","82386","","164772"
"2014-02-05 22:43","BookieClientTest.java","19260","144691","163951","7","327902"
"2013-10-12 05:42","BookieClientTest.java","18974","139136","158110","6","316220"
"2017-06-21 19:58","BookieClientTest.java","40780","123367","164147","","328294"
"2011-11-18 11:18","BookieClientTest.java","3477","6655","10132","","20264"
"2014-07-25 00:34","BookieClientTest.java","19607","156618","176225","","352450"
"2017-03-28 22:35","BookieClientTest.java","40493","114003","154496","","308992"
"2016-12-17 02:39","BookieClientTest.java","40495","102288","142783","","285566"
"2017-05-15 19:52","BookieClientTest.java","40654","117918","158572","","317144"
"2014-12-10 19:43","BookieClientTest.java","19633","160450","180083","","360166"
"2012-01-13 18:06","BookieClientTest.java","4306","11527","15833","1","31666"
"2011-11-16 17:05","BookieClientTest.java","2605","3852","6457","","12914"
"2015-10-06 10:05","BookieClientTest.java","19680","163763","183443","","366886"
"2014-07-24 01:41","BookieClientTest.java","19476","150665","170141","","340282"
"2016-11-30 00:02","CookieTest.java","111853","27383","139236","","278472"
"2017-05-15 19:52","LedgerHandle.java","67845","91371","159216","","318432"
"2017-05-02 22:07","LedgerHandle.java","67373","88545","155918","","311836"
"2017-03-23 15:55","LedgerHandle.java","67272","82818","150090","","300180"
"2012-12-28 12:32","LedgerHandle.java","6523","30442","36965","2","73930"
"2016-09-10 21:01","LedgerHandle.java","67034","65293","132327","","264654"
"2016-07-11 23:01","LedgerHandle.java","66055","60210","126265","","252530"
"2013-04-26 18:38","LedgerHandle.java","8778","67608","76386","5","152772"
"2013-10-14 18:32","LedgerHandle.java","10193","76710","86903","6","173806"
"2014-02-05 22:43","LedgerHandle.java","11112","82805","93917","7","187834"
"2014-02-21 19:01","LedgerHandle.java","11210","84066","95276","7","190552"
"2017-05-17 08:57","LedgerHandle.java","67920","91923","159843","","319686"
"2017-05-25 14:23","LedgerHandle.java","67952","93760","161712","","323424"
"2017-06-21 19:50","LedgerHandle.java","68593","97332","165925","","331850"
"2017-06-21 21:00","LedgerHandle.java","68596","98118","166714","","333428"
"2017-06-01 23:58","LedgerHandle.java","68544","95263","163807","","327614"
"2014-01-21 05:19","LedgerHandle.java","10484","81374","91858","6","183716"
"2014-09-18 06:47","LedgerHandle.java","11899","97811","109710","","219420"
"2014-12-09 19:57","LedgerHandle.java","12016","99021","111037","","222074"
"2017-07-04 06:27","LedgerHandle.java","68778","102732","171510","","343020"
"2017-06-30 00:12","LedgerHandle.java","68690","100683","169373","","338746"
"2014-05-30 14:01","LedgerHandle.java","11317","88107","99424","7","198848"
"2014-05-30 15:07","LedgerHandle.java","11337","88166","99503","7","199006"
"2014-01-17 18:13","LedgerHandle.java","10417","80411","90828","6","181656"
"2013-01-07 12:25","LedgerHandle.java","6921","32643","39564","2","79128"
"2012-09-14 11:53","LedgerHandle.java","227","462","689","2","1378"
"2016-02-09 08:32","LedgerHandle.java","12771","105207","117978","","235956"
"2016-03-16 05:03","LedgerHandle.java","65899","55596","121495","","242990"
"2015-10-22 09:22","LedgerHandle.java","12688","104089","116777","","233554"
"2015-10-06 10:05","LedgerHandle.java","12662","103007","115669","","231338"
"2017-01-31 04:01","LedgerHandle.java","67194","82374","149568","","299136"
"2015-04-21 09:39","LedgerHandle.java","12259","101433","113692","","227384"
"2015-10-06 11:12","LedgerHandle.java","12665","103250","115915","","231830"
"2014-12-05 14:10","LedgerHandle.java","11974","98530","110504","","221008"
"2017-07-07 05:11","LedgerUnderreplicationManager.java","61519","109499","171018","","342036"
"2013-01-04 11:32","LedgerUnderreplicationManager.java","7030","44886","51916","2","103832"
"2012-10-04 12:40","LedgerUnderreplicationManager.java","3879","20117","23996","2","47992"
"2014-06-03 12:35","LedgerUnderreplicationManager.java","11203","100983","112186","7","224372"
"2016-08-01 08:04","LedgerOpenOp.java","107933","29931","137864","","275728"
"2015-10-06 10:05","LedgerOpenOp.java","3721","21210","24931","","49862"
"2015-04-21 09:17","LedgerOpenOp.java","2903","19201","22104","","44208"
"2017-05-15 19:52","LedgerHandle.java","48739","101214","149953","","299906"
"2017-05-02 22:07","LedgerHandle.java","48297","98418","146715","","293430"
"2017-03-23 15:55","LedgerHandle.java","48237","92732","140969","","281938"
"2012-12-28 12:32","LedgerHandle.java","10052","62920","72972","2","145944"
"2016-09-10 21:01","LedgerHandle.java","48076","75284","123360","","246720"
"2016-07-11 23:01","LedgerHandle.java","48025","71129","119154","","238308"
"2013-04-26 18:38","LedgerHandle.java","12057","99836","111893","5","223786"
"2013-10-14 18:32","LedgerHandle.java","13348","108814","122162","6","244324"
"2014-02-05 22:43","LedgerHandle.java","14036","114678","128714","7","257428"
"2014-02-21 19:01","LedgerHandle.java","14125","115930","130055","7","260110"
"2017-05-17 08:57","LedgerHandle.java","48814","101766","150580","","301160"
"2017-05-25 14:23","LedgerHandle.java","48843","103600","152443","","304886"
"2017-06-21 19:50","LedgerHandle.java","49473","107161","156634","","313268"
"2017-06-21 21:00","LedgerHandle.java","49476","107947","157423","","314846"
"2017-06-01 23:58","LedgerHandle.java","49427","105095","154522","","309044"
"2012-06-29 18:43","LedgerHandle.java","1479","7014","8493","2","16986"
"2012-09-12 11:59","LedgerHandle.java","4963","33912","38875","2","77750"
"2014-01-21 05:19","LedgerHandle.java","13620","113459","127079","6","254158"
"2012-06-27 15:35","LedgerHandle.java","1465","6670","8135","2","16270"
"2014-09-18 06:47","LedgerHandle.java","14651","129512","144163","","288326"
"2014-12-09 19:57","LedgerHandle.java","14719","130673","145392","","290784"
"2017-07-04 06:27","LedgerHandle.java","49576","112479","162055","","324110"
"2017-06-30 00:12","LedgerHandle.java","49493","110435","159928","","319856"
"2014-05-30 14:01","LedgerHandle.java","14222","119961","134183","7","268366"
"2014-05-30 15:07","LedgerHandle.java","14240","120018","134258","7","268516"
"2014-01-17 18:13","LedgerHandle.java","13555","112498","126053","6","252106"
"2013-01-07 12:25","LedgerHandle.java","10334","65005","75339","2","150678"
"2012-08-28 10:51","LedgerHandle.java","4691","30056","34747","2","69494"
"2012-09-14 11:53","LedgerHandle.java","5056","34240","39296","2","78592"
"2016-02-09 08:32","LedgerHandle.java","15328","136713","152041","","304082"
"2016-03-16 05:03","LedgerHandle.java","47962","66608","114570","","229140"
"2015-10-22 09:22","LedgerHandle.java","15245","135595","150840","","301680"
"2015-10-06 10:05","LedgerHandle.java","15236","134530","149766","","299532"
"2017-01-31 04:01","LedgerHandle.java","48191","92320","140511","","281022"
"2015-04-21 09:39","LedgerHandle.java","14910","133033","147943","","295886"
"2015-10-06 11:12","LedgerHandle.java","15237","134771","150008","","300016"
"2014-12-05 14:10","LedgerHandle.java","14701","130206","144907","","289814"
"2012-12-24 05:50","LedgerCacheImpl.java","10970","68176","79146","2","158292"
"2016-11-18 00:18","LedgerCacheImpl.java","47561","82949","130510","","261020"
"2012-12-18 13:04","LedgerCacheImpl.java","10585","67683","78268","2","156536"
"2017-05-16 00:31","LedgerCacheImpl.java","48163","105416","153579","","307158"
"2013-10-11 08:36","LedgerCacheImpl.java","14246","113438","127684","6","255368"
"2017-06-01 23:58","LedgerCacheImpl.java","48789","108817","157606","","315212"
"2014-08-02 20:02","LedgerCacheImpl.java","15591","132803","148394","","296788"
"2017-07-04 06:27","LedgerCacheImpl.java","48920","116183","165103","","330206"
"2012-10-26 12:51","LedgerCacheImpl.java","9679","52757","62436","2","124872"
"2017-01-31 04:01","LedgerCacheImpl.java","47607","96096","143703","","287406"
"2017-06-05 20:30","LedgerDirsManager.java","114618","76004","190622","","381244"
"2017-01-30 23:25","LedgerDirsManager.java","112664","56014","168678","","337356"
"2017-03-28 22:35","LedgerDirsManager.java","112762","66843","179605","","359210"
"2013-12-02 18:45","LedgerDirsManager.java","1485","5088","6573","6","13146"
"2014-01-15 15:58","LedgerDirsManager.java","1574","5521","7095","6","14190"
"2017-06-28 23:24","LedgerDirsManager.java","114788","79218","194006","","388012"
"2017-07-07 08:19","LedgerDirsManager.java","115059","85285","200344","","400688"
"2014-01-21 17:26","LedgerDirsManager.java","2004","7496","9500","6","19000"
"2014-08-02 20:02","LedgerDirsManager.java","4338","22550","26888","","53776"
"2017-06-01 23:58","EntryLogger.java","114358","51719","166077","","332154"
"2017-11-08 12:27","EntryLogger.java","132817","103650","236467","","472934"
"2017-01-31 02:11","EntryLogger.java","111884","31625","143509","","287018"
"2017-03-23 00:48","EntryLogger.java","112020","38182","150202","","300404"
"2016-07-14 23:02","EntryLogger.java","106723","11554","118277","","236554"
"2016-02-24 00:44","EntryLogger.java","1394","5002","6396","","12792"
"2013-01-04 11:32","ServerConfiguration.java","1990","7689","9679","2","19358"
"2014-08-02 20:02","ServerConfiguration.java","7813","71905","79718","","159436"
"2014-05-06 12:30","ServerConfiguration.java","7186","62628","69814","7","139628"
"2014-05-15 00:41","ServerConfiguration.java","7203","63559","70762","7","141524"
"2014-09-18 06:47","ServerConfiguration.java","7882","73983","81865","","163730"
"2017-07-04 06:27","ServerConfiguration.java","81026","95169","176195","","352390"
"2014-03-07 13:14","ServerConfiguration.java","7076","60159","67235","7","134470"
"2014-04-29 22:07","ServerConfiguration.java","7186","62581","69767","7","139534"
"2016-04-14 00:51","ServerConfiguration.java","77817","50698","128515","","257030"
"2015-01-16 15:57","ServerConfiguration.java","8250","77323","85573","","171146"
"2013-02-08 19:08","ServerConfiguration.java","2904","40764","43668","4","87336"
"2016-03-08 06:49","ServerConfiguration.java","9052","82559","91611","","183222"
"2016-01-26 22:11","ServerConfiguration.java","8839","81332","90171","","180342"
"2014-01-21 05:05","ServerConfiguration.java","6131","56864","62995","6","125990"
"2014-03-12 21:26","ServerConfiguration.java","7146","62031","69177","7","138354"
"2016-04-05 18:47","ServerConfiguration.java","77797","50628","128425","","256850"
"2016-04-27 09:55","ServerConfiguration.java","77854","51247","129101","","258202"
"2015-04-21 09:55","ServerConfiguration.java","8296","77810","86106","","172212"
"2015-01-12 15:18","ServerConfiguration.java","8248","76383","84631","","169262"
"2015-04-21 10:02","ServerConfiguration.java","8292","77839","86131","","172262"
"2013-01-14 16:59","ServerConfiguration.java","2675","9822","12497","2","24994"
"2017-05-15 19:52","ServerConfiguration.java","79932","83647","163579","","327158"
"2017-03-22 22:54","ServerConfiguration.java","79323","74980","154303","","308606"
"2017-03-23 00:48","ServerConfiguration.java","79327","75036","154363","","308726"
"2017-01-31 02:11","ServerConfiguration.java","79237","68525","147762","","295524"
"2013-02-19 16:19","ServerConfiguration.java","3792","41605","45397","4","90794"
"2013-02-19 16:15","ServerConfiguration.java","3786","41580","45366","4","90732"
"2016-04-05 08:45","ServerConfiguration.java","77795","50384","128179","","256358"
"2016-11-09 03:02","ServerConfiguration.java","79204","61320","140524","","281048"
"2016-11-30 00:02","ServerConfiguration.java","79214","62012","141226","","282452"
"2017-06-05 20:30","ServerConfiguration.java","80782","88048","168830","","337660"
"2016-09-10 20:27","ServerConfiguration.java","79079","57406","136485","","272970"
"2017-08-02 00:49","ServerConfiguration.java","84023","116372","200395","","400790"
"2017-10-03 12:31","ServerConfiguration.java","89809","112315","202124","","404248"
"2017-08-16 03:37","ServerConfiguration.java","85082","124064","209146","","418292"
"2013-07-20 19:59","ServerConfiguration.java","4721","49198","53919","5","107838"
"2013-12-02 18:45","ServerConfiguration.java","6019","55502","61521","6","123042"
"2014-05-09 14:04","ServerConfiguration.java","7200","63236","70436","7","140872"
"2017-05-26 12:38","ServerConfiguration.java","80058","86089","166147","","332294"
"2013-06-15 19:05","ServerConfiguration.java","4640","48548","53188","5","106376"
"2014-01-15 15:58","ServerConfiguration.java","6099","55926","62025","6","124050"
"2013-10-22 07:44","ServerConfiguration.java","5902","52888","58790","6","117580"
"2017-07-07 08:19","ServerConfiguration.java","81016","97122","178138","","356276"
"2017-06-28 23:24","ServerConfiguration.java","80840","91150","171990","","343980"
"2017-11-08 12:27","ServerConfiguration.java","91113","131493","222606","","445212"
"2014-01-22 14:35","ServerConfiguration.java","6412","58160","64572","6","129144"
"2013-10-12 05:42","ServerConfiguration.java","5793","52406","58199","6","116398"
"2017-06-01 23:58","ReplicationWorker.java","81489","83513","165002","","330004"
"2017-04-11 20:14","ReplicationWorker.java","80092","75628","155720","","311440"
"2014-02-05 22:43","ReplicationWorker.java","5425","52423","57848","7","115696"
"2013-10-02 06:23","ReplicationWorker.java","3230","44036","47266","5","94532"
"2016-03-16 04:51","ReplicationWorker.java","78296","43095","121391","","242782"
"2016-09-10 21:01","ReplicationWorker.java","79748","53312","133060","","266120"
"2017-05-26 16:52","ReplicationWorker.java","80795","81962","162757","","325514"
"2015-04-21 09:17","ReplicationWorker.java","6889","71348","78237","","156474"
"2013-12-06 07:39","ReplicationWorker.java","4436","49187","53623","6","107246"
"2014-04-24 10:43","ReplicationWorker.java","5685","55818","61503","7","123006"
"2014-09-06 07:58","ReplicationWorker.java","6458","67672","74130","","148260"
"2017-10-17 09:32","BookKeeperAdmin.java","130777","94034","224811","","449622"
"2017-06-01 23:58","BookKeeperAdmin.java","114680","54485","169165","","338330"
"2017-04-11 20:19","BookKeeperAdmin.java","112643","45963","158606","","317212"
"2017-07-07 05:11","BookKeeperAdmin.java","115638","64358","179996","","359992"
"2016-11-09 03:05","BookKeeperAdmin.java","112148","27178","139326","","278652"
"2016-11-30 00:07","BookKeeperAdmin.java","112209","27903","140112","","280224"
"2016-09-10 21:01","BookKeeperAdmin.java","110521","21866","132387","","264774"
"2016-07-14 23:02","BookKeeperAdmin.java","107100","14375","121475","","242950"
"2016-10-13 09:27","BookKeeperAdmin.java","112114","26810","138924","","277848"
"2016-03-16 05:03","BookKeeperAdmin.java","106556","9339","115895","","231790"
"2016-03-08 07:18","BookKeeperAdmin.java","2122","9191","11313","","22626"
"2011-11-18 11:18","BookieFailureTest.java","7801","17066","24867","","49734"
"2012-02-13 15:46","BookieFailureTest.java","8709","26351","35060","1","70120"
"2012-12-20 06:48","BookieFailureTest.java","14587","98209","112796","2","225592"
"2011-10-27 18:26","BookieFailureTest.java","5805","11919","17724","","35448"
"2011-09-05 19:38","BookieFailureTest.java","4875","10511","15386","","30772"
"2012-08-13 11:38","BookieFailureTest.java","11774","57528","69302","2","138604"
"2014-07-24 01:41","BookieFailureTest.java","16459","153735","170194","","340388"
"2012-06-19 12:39","BookieFailureTest.java","10379","41255","51634","2","103268"
"2014-12-09 19:57","LedgerCloseTest.java","3689","23367","27056","","54112"
"2016-03-16 04:43","LedgerCloseTest.java","108461","30599","139060","","278120"
"2014-02-05 22:43","LedgerCloseTest.java","1712","6078","7790","7","15580"
"2017-05-16 00:31","LedgerCloseTest.java","112728","69345","182073","","364146"
"2017-07-28 06:39","BookieInitializationTest.java","1425","3314","4739","","9478"
"2017-08-02 00:49","BookieInitializationTest.java","5256","21499","26755","","53510"
"2017-07-07 08:19","BookieInitializationTest.java","803","6599","7402","","14804"
"2017-07-28 06:39","BookieInitializationTest.java","2162","9847","12009","","24018"
"2017-08-02 00:49","BookieInitializationTest.java","5929","27968","33897","","67794"
"2013-05-04 14:22","GarbageCollectorThread.java","9260","88416","97676","5","195352"
"2013-09-11 00:34","GarbageCollectorThread.java","9573","95029","104602","5","209204"
"2014-01-15 15:58","GarbageCollectorThread.java","10620","100224","110844","6","221688"
"2013-10-22 07:44","GarbageCollectorThread.java","10453","97216","107669","6","215338"
"2017-05-09 23:06","GarbageCollectorThread.java","54316","96344","150660","","301320"
"2014-01-21 17:26","GarbageCollectorThread.java","10758","101907","112665","6","225330"
"2013-10-02 06:23","GarbageCollectorThread.java","9574","95041","104615","5","209230"
"2017-11-08 12:27","GarbageCollectorThread.java","61690","141847","203537","","407074"
"2012-12-24 05:50","GarbageCollectorThread.java","6727","50590","57317","2","114634"
"2017-03-28 22:39","GarbageCollectorThread.java","54060","94032","148092","","296184"
"2017-01-30 23:25","GarbageCollectorThread.java","53950","82957","136907","","273814"
"2016-05-04 15:55","GarbageCollectorThread.java","53298","66491","119789","","239578"
"2016-03-08 06:49","GarbageCollectorThread.java","12672","125956","138628","","277256"
"2016-02-24 00:44","GarbageCollectorThread.java","12662","125594","138256","","276512"
"2015-04-21 09:55","GarbageCollectorThread.java","12112","121403","133515","","267030"
"2013-10-30 16:23","GarbageCollectorThread.java","10593","99329","109922","6","219844"
"2017-05-15 19:52","LedgerHandle.java","112723","65359","178082","","356164"
"2017-05-02 22:07","LedgerHandle.java","111952","62234","174186","","348372"
"2017-03-23 15:55","LedgerHandle.java","111806","56462","168268","","336536"
"2016-09-10 21:01","LedgerHandle.java","110154","37523","147677","","295354"
"2016-07-11 23:01","LedgerHandle.java","108860","32125","140985","","281970"
"2014-02-05 22:43","LedgerHandle.java","1184","1987","3171","7","6342"
"2014-02-21 19:01","LedgerHandle.java","1382","3348","4730","7","9460"
"2017-05-17 08:57","LedgerHandle.java","112864","65977","178841","","357682"
"2017-05-25 14:23","LedgerHandle.java","112897","67815","180712","","361424"
"2017-06-21 19:50","LedgerHandle.java","113935","71784","185719","","371438"
"2017-06-21 21:00","LedgerHandle.java","113945","72577","186522","","373044"
"2017-06-01 23:58","LedgerHandle.java","113669","69498","183167","","366334"
"2014-09-18 06:47","LedgerHandle.java","3476","18498","21974","","43948"
"2014-12-09 19:57","LedgerHandle.java","3627","19742","23369","","46738"
"2017-07-04 06:27","LedgerHandle.java","114273","77337","191610","","383220"
"2017-06-30 00:12","LedgerHandle.java","114143","75246","189389","","378778"
"2014-05-30 14:01","LedgerHandle.java","1870","7770","9640","7","19280"
"2014-05-30 15:07","LedgerHandle.java","1890","7829","9719","7","19438"
"2016-02-09 08:32","LedgerHandle.java","5001","26547","31548","","63096"
"2016-03-16 05:03","LedgerHandle.java","108515","27322","135837","","271674"
"2015-10-22 09:22","LedgerHandle.java","4870","25381","30251","","60502"
"2015-10-06 10:05","LedgerHandle.java","4836","24291","29127","","58254"
"2017-01-31 04:01","LedgerHandle.java","111696","55986","167682","","335364"
"2015-04-21 09:39","LedgerHandle.java","4063","22347","26410","","52820"
"2015-10-06 11:12","LedgerHandle.java","4842","24537","29379","","58758"
"2014-12-05 14:10","LedgerHandle.java","3574","19240","22814","","45628"
"2011-11-18 11:18","BookieFailureTest.java","3592","7221","10813","","21626"
"2012-02-13 15:46","BookieFailureTest.java","4625","16631","21256","1","42512"
"2012-12-20 06:48","BookieFailureTest.java","17363","95349","112712","2","225424"
"2011-10-27 18:26","BookieFailureTest.java","1168","1646","2814","","5628"
"2012-08-13 11:38","BookieFailureTest.java","14333","54451","68784","2","137568"
"2014-07-24 01:41","BookieFailureTest.java","19365","151005","170370","","340740"
"2012-06-19 12:39","BookieFailureTest.java","12679","37919","50598","2","101196"
"2017-05-10 22:47","SafeRunnable.java","40279","116597","156876","","313752"
"2017-06-05 20:30","LedgerDirsManager.java","115331","58505","173836","","347672"
"2017-01-30 23:25","LedgerDirsManager.java","112861","37999","150860","","301720"
"2017-03-28 22:35","LedgerDirsManager.java","112996","48865","161861","","323722"
"2017-06-28 23:24","LedgerDirsManager.java","115626","61844","177470","","354940"
"2017-07-07 08:19","LedgerDirsManager.java","116119","68133","184252","","368504"
"2016-10-13 07:50","RackawareEnsemblePlacementPolicy.java","110618","40549","151167","","302334"
"2017-08-16 03:41","RackawareEnsemblePlacementPolicy.java","118642","105966","224608","","449216"
"2016-11-18 00:44","RackawareEnsemblePlacementPolicy.java","110766","41295","152061","","304122"
"2017-03-28 22:35","RackawareEnsemblePlacementPolicy.java","110928","59007","169935","","339870"
"2017-07-28 20:12","RackawareEnsemblePlacementPolicy.java","114467","81322","195789","","391578"
"2017-07-28 20:12","AuthProviderFactoryFactory.java","5908","34745","40653","","81306"
"2017-03-28 22:35","EnsemblePlacementPolicy.java","1240","19388","20628","","41256"
"2017-07-28 20:12","EnsemblePlacementPolicy.java","6467","43391","49858","","99716"
"2016-11-18 00:44","EnsemblePlacementPolicy.java","327","925","1252","","2504"
"2014-02-05 22:43","TestWatchEnsembleChange.java","1505","3204","4709","7","9418"
"2014-07-24 01:41","TestWatchEnsembleChange.java","2600","10057","12657","","25314"
"2014-05-12 08:10","TestWatchEnsembleChange.java","2009","8180","10189","7","20378"
"2015-09-15 10:38","TestWatchEnsembleChange.java","4673","24700","29373","","58746"
"2017-08-01 08:34","BookKeeperClusterTestCase.java","4431","20052","24483","","48966"
"2017-11-08 12:27","BookKeeperClusterTestCase.java","34947","61184","96131","","192262"
"2012-12-08 11:18","ZkLedgerLayoutTest.java","11492","67626","79118","2","158236"
"2014-07-24 01:41","ZkLedgerLayoutTest.java","15357","129505","144862","","289724"
"2012-06-19 12:39","ZkLedgerLayoutTest.java","3496","11244","14740","2","29480"
"2013-03-25 06:27","ZkLedgerLayoutTest.java","13860","108681","122541","4","245082"
"2017-05-15 19:52","SlowBookieTest.java","67845","91371","159216","","318432"
"2013-10-29 05:14","SlowBookieTest.java","10352","77679","88031","6","176062"
"2014-02-05 22:43","SlowBookieTest.java","11112","82805","93917","7","187834"
"2014-01-03 18:12","SlowBookieTest.java","10371","79821","90192","6","180384"
"2014-01-21 05:05","SlowBookieTest.java","10418","80962","91380","6","182760"
"2017-08-02 00:49","BookkeeperInternalCallbacks.java","5975","28613","34588","","69176"
"2013-10-22 16:21","LedgerEntryPage.java","13959","112495","126454","6","252908"
"2017-07-04 06:27","LedgerEntryPage.java","49493","114792","164285","","328570"
"2017-05-15 19:52","LedgerHandle.java","51808","99078","150886","","301772"
"2017-05-02 22:07","LedgerHandle.java","51366","96282","147648","","295296"
"2017-03-23 15:55","LedgerHandle.java","51302","90592","141894","","283788"
"2012-12-28 12:32","LedgerHandle.java","8637","56300","64937","2","129874"
"2016-09-10 21:01","LedgerHandle.java","51137","73140","124277","","248554"
"2016-07-11 23:01","LedgerHandle.java","50734","68633","119367","","238734"
"2013-04-26 18:38","LedgerHandle.java","10629","93203","103832","5","207664"
"2013-10-14 18:32","LedgerHandle.java","11944","102205","114149","6","228298"
"2014-02-05 22:43","LedgerHandle.java","12640","108077","120717","7","241434"
"2014-02-21 19:01","LedgerHandle.java","12730","109330","122060","7","244120"
"2017-05-17 08:57","LedgerHandle.java","51883","99630","151513","","303026"
"2017-05-25 14:23","LedgerHandle.java","51912","101464","153376","","306752"
"2017-06-21 19:50","LedgerHandle.java","52540","105023","157563","","315126"
"2017-06-21 21:00","LedgerHandle.java","52543","105809","158352","","316704"
"2017-06-01 23:58","LedgerHandle.java","52494","102957","155451","","310902"
"2012-06-29 18:43","LedgerHandle.java","17","347","364","2","728"
"2012-09-12 11:59","LedgerHandle.java","3525","27269","30794","2","61588"
"2014-01-21 05:19","LedgerHandle.java","12216","106850","119066","6","238132"
"2014-09-18 06:47","LedgerHandle.java","13262","122918","136180","","272360"
"2014-12-09 19:57","LedgerHandle.java","13330","124079","137409","","274818"
"2017-07-04 06:27","LedgerHandle.java","52645","110343","162988","","325976"
"2017-06-30 00:12","LedgerHandle.java","52560","108297","160857","","321714"
"2014-05-30 14:01","LedgerHandle.java","12830","113364","126194","7","252388"
"2014-05-30 15:07","LedgerHandle.java","12850","113423","126273","7","252546"
"2014-01-17 18:13","LedgerHandle.java","12151","105889","118040","6","236080"
"2013-01-07 12:25","LedgerHandle.java","8897","58363","67260","2","134520"
"2012-08-28 10:51","LedgerHandle.java","3242","23402","26644","2","53288"
"2012-09-14 11:53","LedgerHandle.java","3618","27597","31215","2","62430"
"2016-02-09 08:32","LedgerHandle.java","13951","130131","144082","","288164"
"2016-03-16 05:03","LedgerHandle.java","50668","64109","114777","","229554"
"2015-10-22 09:22","LedgerHandle.java","13868","129013","142881","","285762"
"2015-10-06 10:05","LedgerHandle.java","13859","127948","141807","","283614"
"2017-01-31 04:01","LedgerHandle.java","51252","90176","141428","","282856"
"2015-04-21 09:39","LedgerHandle.java","13533","126451","139984","","279968"
"2015-10-06 11:12","LedgerHandle.java","13860","128189","142049","","284098"
"2014-12-05 14:10","LedgerHandle.java","13312","123612","136924","","273848"
"2017-05-25 14:23","ClientUtil.java","361","2643","3004","","6008"
"2017-05-15 19:52","LedgerHandle.java","113824","51438","165262","","330524"
"2017-05-02 22:07","LedgerHandle.java","112898","48158","161056","","322112"
"2017-03-23 15:55","LedgerHandle.java","112584","42218","154802","","309604"
"2016-09-10 21:01","LedgerHandle.java","110729","23076","133805","","267610"
"2016-07-11 23:01","LedgerHandle.java","107238","15481","122719","","245438"
"2017-05-17 08:57","LedgerHandle.java","114001","52092","166093","","332186"
"2017-05-25 14:23","LedgerHandle.java","114036","53932","167968","","335936"
"2017-06-21 19:50","LedgerHandle.java","115273","58100","173373","","346746"
"2017-06-21 21:00","LedgerHandle.java","115287","58897","174184","","348368"
"2017-06-01 23:58","LedgerHandle.java","114854","55661","170515","","341030"
"2014-12-09 19:57","LedgerHandle.java","295","1388","1683","","3366"
"2017-07-04 06:27","LedgerHandle.java","115763","63805","179568","","359136"
"2017-06-30 00:12","LedgerHandle.java","115603","61684","177287","","354574"
"2016-02-09 08:32","LedgerHandle.java","2041","8565","10606","","21212"
"2016-03-16 05:03","LedgerHandle.java","106806","10591","117397","","234794"
"2015-10-22 09:22","LedgerHandle.java","1884","7373","9257","","18514"
"2015-10-06 10:05","LedgerHandle.java","1849","6282","8131","","16262"
"2017-01-31 04:01","LedgerHandle.java","112459","41727","154186","","308372"
"2015-04-21 09:39","LedgerHandle.java","813","4075","4888","","9776"
"2015-10-06 11:12","LedgerHandle.java","1855","6528","8383","","16766"
"2014-12-05 14:10","LedgerHandle.java","236","880","1116","","2232"
"2017-07-07 05:11","LedgerUnderreplicationManager.java","114068","72268","186336","","372672"
"2017-05-15 19:52","DigestManager.java","48257","104382","152639","","305278"
"2012-07-18 17:00","DigestManager.java","4693","17258","21951","2","43902"
"2017-05-25 14:23","DigestManager.java","48363","106770","155133","","310266"
"2012-05-25 17:13","DigestManager.java","498","1752","2250","1","4500"
"2017-01-31 04:01","DigestManager.java","47763","95542","143305","","286610"
"2015-03-12 08:21","AuditorPeriodicCheckTest.java","1442","7093","8535","","17070"
"2017-05-16 00:31","AuditorPeriodicCheckTest.java","114331","55002","169333","","338666"
"2016-09-10 21:01","AuditorPeriodicCheckTest.java","111151","26137","137288","","274576"
"2016-10-13 07:50","RackawareEnsemblePlacementPolicy.java","112110","50442","162552","","325104"
"2014-02-05 22:43","RackawareEnsemblePlacementPolicy.java","3504","11905","15409","7","30818"
"2017-08-16 03:41","RackawareEnsemblePlacementPolicy.java","119164","114889","234053","","468106"
"2016-11-18 00:44","RackawareEnsemblePlacementPolicy.java","112234","51164","163398","","326796"
"2017-03-28 22:35","RackawareEnsemblePlacementPolicy.java","112368","68848","181216","","362432"
"2017-07-28 20:12","RackawareEnsemblePlacementPolicy.java","115204","90460","205664","","411328"
"2017-07-07 05:11","AuditorLedgerCheckerTest.java","4934","32221","37155","","74310"
"2017-10-17 09:32","AuditorLedgerCheckerTest.java","30045","71869","101914","","203828"
"2017-05-12 15:20","AuditorLedgerCheckerTest.java","1667","16041","17708","","35416"
"2016-08-01 08:04","LedgerOpenOp.java","40722","86136","126858","","253716"
"2015-10-06 10:05","LedgerOpenOp.java","19214","160119","179333","","358666"
"2015-04-21 09:17","LedgerOpenOp.java","19135","158849","177984","","355968"
"2014-01-21 05:19","LedgerOpenOp.java","18410","139860","158270","6","316540"
"2012-06-19 12:39","LedgerOpenOp.java","10733","32344","43077","2","86154"
"2014-02-21 19:01","LedgerOpenOp.java","18731","142147","160878","7","321756"
"2012-07-18 17:00","LedgerOpenOp.java","12283","42809","55092","2","110184"
"2014-04-29 22:07","IOUtils.java","15150","123665","138815","7","277630"
"2012-09-07 07:04","IOUtils.java","6524","39308","45832","2","91664"
"2014-12-10 19:43","IOUtils.java","15840","136228","152068","","304136"
"2016-07-14 23:02","IndexPersistenceMgr.java","107718","18004","125722","","251444"
"2016-11-18 00:18","IndexPersistenceMgr.java","112786","30962","143748","","287496"
"2017-05-16 00:31","IndexPersistenceMgr.java","114344","54385","168729","","337458"
"2017-10-03 12:31","IndexPersistenceMgr.java","130390","88804","219194","","438388"
"2017-07-04 06:27","IndexPersistenceMgr.java","116075","66126","182201","","364402"
"2016-03-08 06:49","IndexPersistenceMgr.java","2704","12119","14823","","29646"
"2017-01-31 04:01","IndexPersistenceMgr.java","112860","44137","156997","","313994"
"2017-05-15 19:52","LedgerHandle.java","113637","50158","163795","","327590"
"2017-05-02 22:07","LedgerHandle.java","112706","46873","159579","","319158"
"2017-03-23 15:55","LedgerHandle.java","112387","40928","153315","","306630"
"2016-09-10 21:01","LedgerHandle.java","110512","21766","132278","","264556"
"2016-07-11 23:01","LedgerHandle.java","107019","14169","121188","","242376"
"2017-05-17 08:57","LedgerHandle.java","113814","50812","164626","","329252"
"2017-05-25 14:23","LedgerHandle.java","113849","52652","166501","","333002"
"2017-06-21 19:50","LedgerHandle.java","115091","56825","171916","","343832"
"2017-06-21 21:00","LedgerHandle.java","115105","57622","172727","","345454"
"2017-06-01 23:58","LedgerHandle.java","114671","54385","169056","","338112"
"2017-07-04 06:27","LedgerHandle.java","115593","62542","178135","","356270"
"2017-06-30 00:12","LedgerHandle.java","115428","60416","175844","","351688"
"2016-02-09 08:32","LedgerHandle.java","1765","7196","8961","","17922"
"2016-03-16 05:03","LedgerHandle.java","106545","9237","115782","","231564"
"2015-10-22 09:22","LedgerHandle.java","1608","6004","7612","","15224"
"2015-10-06 10:05","LedgerHandle.java","1571","4911","6482","","12964"
"2017-01-31 04:01","LedgerHandle.java","112244","40419","152663","","305326"
"2015-04-21 09:39","LedgerHandle.java","532","2701","3233","","6466"
"2015-10-06 11:12","LedgerHandle.java","1577","5157","6734","","13468"
"2017-07-04 06:27","ServerConfiguration.java","4538","22972","27510","","55020"
"2017-05-15 19:52","ServerConfiguration.java","2089","10095","12184","","24368"
"2017-06-05 20:30","ServerConfiguration.java","3534","15091","18625","","37250"
"2017-08-02 00:49","ServerConfiguration.java","9191","45831","55022","","110044"
"2017-10-03 12:31","ServerConfiguration.java","32185","58982","91167","","182334"
"2017-08-16 03:37","ServerConfiguration.java","11625","54898","66523","","133046"
"2017-05-26 12:38","ServerConfiguration.java","2398","12720","15118","","30236"
"2017-07-07 08:19","ServerConfiguration.java","4602","24999","29601","","59202"
"2017-06-28 23:24","ServerConfiguration.java","3940","18541","22481","","44962"
"2017-11-08 12:27","ServerConfiguration.java","35665","80336","116001","","232002"
"2017-05-04 20:58","AbstractZkLedgerManager.java","111764","41560","153324","","306648"
"2017-06-01 23:58","AbstractZkLedgerManager.java","113425","47878","161303","","322606"
"2017-06-12 17:20","AbstractZkLedgerManager.java","113807","50037","163844","","327688"
"2017-03-28 22:40","AbstractZkLedgerManager.java","111181","39130","150311","","300622"
"2016-02-23 19:16","AbstractZkLedgerManager.java","38","376","414","","828"
"2014-03-07 13:30","NativeIO.java","2552","8988","11540","7","23080"
"2017-03-28 22:40","FlatLedgerManagerFactory.java","111394","41588","152982","","305964"
"2015-04-21 09:17","WriteEntryProcessorV3.java","1509","7390","8899","","17798"
"2014-08-02 20:02","WriteEntryProcessorV3.java","165","795","960","","1920"
"2017-05-16 00:31","WriteEntryProcessorV3.java","114331","55002","169333","","338666"
"2016-11-12 03:35","WriteEntryProcessorV3.java","112797","31474","144271","","288542"
"2017-05-15 19:52","WriteEntryProcessorV3.java","114182","54435","168617","","337234"
"2017-08-02 00:49","BookkeeperInternalCallbacks.java","6329","30615","36944","","73888"
"2017-06-21 21:00","BookkeeperInternalCallbacks.java","371","2019","2390","","4780"
"2017-10-03 12:31","IndexPersistenceMgrTest.java","31432","46672","78104","","156208"
"2017-07-07 08:19","IndexPersistenceMgrTest.java","1234","10074","11308","","22616"
"2017-07-04 06:27","ServerConfiguration.java","4886","29741","34627","","69254"
"2017-05-15 19:52","ServerConfiguration.java","2552","16979","19531","","39062"
"2017-03-22 22:54","ServerConfiguration.java","739","7108","7847","","15694"
"2017-03-23 00:48","ServerConfiguration.java","744","7165","7909","","15818"
"2017-06-05 20:30","ServerConfiguration.java","3921","21899","25820","","51640"
"2017-08-02 00:49","ServerConfiguration.java","9364","52425","61789","","123578"
"2017-10-03 12:31","ServerConfiguration.java","29097","62315","91412","","182824"
"2017-08-16 03:37","ServerConfiguration.java","11796","61490","73286","","146572"
"2017-05-26 12:38","ServerConfiguration.java","2823","19566","22389","","44778"
"2017-07-07 08:19","ServerConfiguration.java","4947","31765","36712","","73424"
"2017-06-28 23:24","ServerConfiguration.java","4313","25335","29648","","59296"
"2017-11-08 12:27","ServerConfiguration.java","32346","83438","115784","","231568"
"2017-08-02 00:49","BookieInitializationTest.java","3898","18252","22150","","44300"
"2014-12-10 19:43","UpgradeTest.java","10150","80502","90652","","181304"
"2017-05-15 19:52","UpgradeTest.java","79553","86352","165905","","331810"
"2013-10-11 08:36","UpgradeTest.java","7700","56856","64556","6","129112"
"2013-10-12 05:42","UpgradeTest.java","7828","57525","65353","6","130706"
"2017-05-04 20:58","AbstractZkLedgerManager.java","111961","44002","155963","","311926"
"2017-06-01 23:58","AbstractZkLedgerManager.java","113588","50286","163874","","327748"
"2017-06-12 17:20","AbstractZkLedgerManager.java","113969","52444","166413","","332826"
"2017-03-28 22:40","AbstractZkLedgerManager.java","111394","41588","152982","","305964"
"2016-02-09 08:23","AbstractZkLedgerManager.java","296","2541","2837","","5674"
"2016-02-23 19:16","AbstractZkLedgerManager.java","334","2917","3251","","6502"
"2017-01-31 04:01","BookieRequestProcessor.java","112868","44775","157643","","315286"
"2017-06-05 22:25","BookieRequestProcessor.java","115485","60380","175865","","351730"
"2017-07-04 06:27","BookieRequestProcessor.java","116034","66715","182749","","365498"
"2014-08-02 20:02","BookieRequestProcessor.java","165","795","960","","1920"
"2017-08-02 00:49","BookieRequestProcessor.java","119734","88621","208355","","416710"
"2017-03-28 22:35","BookieRequestProcessor.java","112996","49495","162491","","324982"
"2017-01-31 02:14","BookieRequestProcessor.java","112866","39304","152170","","304340"
"2017-05-15 19:52","BookieRequestProcessor.java","114182","54435","168617","","337234"
"2017-05-04 20:58","AbstractZkLedgerManager.java","79502","82127","161629","","323258"
"2013-07-29 12:30","AbstractZkLedgerManager.java","4865","50376","55241","5","110482"
"2017-06-01 23:58","AbstractZkLedgerManager.java","80523","87805","168328","","336656"
"2017-06-12 17:20","AbstractZkLedgerManager.java","80599","89658","170257","","340514"
"2012-12-24 05:50","AbstractZkLedgerManager.java","1287","5747","7034","2","14068"
"2013-03-25 06:27","AbstractZkLedgerManager.java","4145","42832","46977","4","93954"
"2017-03-28 22:40","AbstractZkLedgerManager.java","79199","79977","159176","","318352"
"2016-02-09 08:23","AbstractZkLedgerManager.java","8934","81763","90697","","181394"
"2015-09-15 10:38","AbstractZkLedgerManager.java","8805","79389","88194","","176388"
"2016-02-23 19:16","AbstractZkLedgerManager.java","8951","82118","91069","","182138"
"2014-05-12 08:10","AbstractZkLedgerManager.java","7222","63950","71172","7","142344"
"2014-01-17 18:13","AbstractZkLedgerManager.java","6217","56774","62991","6","125982"
"2013-04-04 11:21","InMemoryMetastoreCursor.java","5487","45075","50562","5","101124"
"2012-12-20 06:48","BookieFailureTest.java","5797","43665","49462","2","98924"
"2014-07-24 01:41","BookieFailureTest.java","11329","102851","114180","","228360"
"2017-06-01 23:58","MSLedgerManagerFactory.java","3184","9688","12872","","25744"
"2017-06-01 23:58","ReplicationWorker.java","68482","95007","163489","","326978"
"2017-04-11 20:14","ReplicationWorker.java","67300","87337","154637","","309274"
"2014-02-05 22:43","ReplicationWorker.java","11016","82515","93531","7","187062"
"2013-10-02 06:23","ReplicationWorker.java","9215","74522","83737","5","167474"
"2016-03-16 04:51","ReplicationWorker.java","65813","55113","120926","","241852"
"2016-09-10 21:01","ReplicationWorker.java","66955","65020","131975","","263950"
"2017-05-26 16:52","ReplicationWorker.java","67894","93562","161456","","322912"
"2012-12-18 12:00","ReplicationWorker.java","5425","28730","34155","2","68310"
"2015-04-21 09:17","ReplicationWorker.java","12180","101140","113320","","226640"
"2013-01-03 11:06","ReplicationWorker.java","6701","31202","37903","2","75806"
"2013-12-06 07:39","ReplicationWorker.java","10261","79513","89774","6","179548"
"2014-04-24 10:43","ReplicationWorker.java","11136","85770","96906","7","193812"
"2014-09-06 07:58","ReplicationWorker.java","11801","97516","109317","","218634"
"2012-10-04 18:31","ReplicationWorker.java","2901","7552","10453","2","20906"
"2017-07-07 05:11","BookKeeperConstants.java","391","4032","4423","","8846"
"2012-11-23 11:49","TestBenchmark.java","9763","59156","68919","2","137838"
"2014-02-05 22:43","TestBenchmark.java","14805","119164","133969","7","267938"
"2012-06-12 17:37","TestBenchmark.java","712","2544","3256","1","6512"
"2016-02-09 08:12","TestBenchmark.java","15980","140909","156889","","313778"
"2017-08-16 03:37","BookieServer.java","119164","108511","227675","","455350"
"2017-08-02 00:49","BookieServer.java","117608","100322","217930","","435860"
"2014-02-05 22:43","BookieServer.java","1608","3855","5463","7","10926"
"2017-06-28 23:24","BookieServer.java","113836","74511","188347","","376694"
"2017-06-01 23:58","BookieServer.java","113548","70821","184369","","368738"
"2017-10-17 09:32","BookieServer.java","125597","106322","231919","","463838"
"2014-08-02 20:02","BookieServer.java","3047","17504","20551","","41102"
"2014-01-21 05:05","BookieServer.java","356","1454","1810","6","3620"
"2017-07-28 20:12","MacDigestManager.java","4229","19251","23480","","46960"
"2017-05-17 08:57","MacDigestManager.java","291","768","1059","","2118"
"2017-05-15 19:52","PerChannelBookieClientPool.java","114182","54435","168617","","337234"
"2012-03-31 09:13","AbstractZkLedgerManager.java","9292","22117","31409","1","62818"
"2017-05-04 20:58","AbstractZkLedgerManager.java","42379","112257","154636","","309272"
"2013-07-29 12:30","AbstractZkLedgerManager.java","18930","131694","150624","5","301248"
"2017-06-01 23:58","AbstractZkLedgerManager.java","42667","117202","159869","","319738"
"2017-06-12 17:20","AbstractZkLedgerManager.java","42687","118999","161686","","323372"
"2012-12-24 05:50","AbstractZkLedgerManager.java","17146","88859","106005","2","212010"
"2013-03-25 06:27","AbstractZkLedgerManager.java","18652","124592","143244","4","286488"
"2012-08-28 14:25","AbstractZkLedgerManager.java","13486","57713","71199","2","142398"
"2017-03-28 22:40","AbstractZkLedgerManager.java","42181","110212","152393","","304786"
"2016-02-09 08:23","AbstractZkLedgerManager.java","20194","160276","180470","","360940"
"2015-09-15 10:38","AbstractZkLedgerManager.java","20183","158020","178203","","356406"
"2012-12-08 11:18","AbstractZkLedgerManager.java","16734","83987","100721","2","201442"
"2016-02-23 19:16","AbstractZkLedgerManager.java","20197","160617","180814","","361628"
"2012-06-19 12:39","AbstractZkLedgerManager.java","10996","29863","40859","2","81718"
"2014-05-12 08:10","AbstractZkLedgerManager.java","19566","143547","163113","7","326226"
"2014-01-17 18:13","AbstractZkLedgerManager.java","19187","136997","156184","6","312368"
"2017-05-26 16:52","Journal.java","2978","26865","29843","","59686"
"2017-03-22 22:54","Journal.java","917","14410","15327","","30654"
"2017-06-01 23:58","Journal.java","3874","28618","32492","","64984"
"2017-05-09 22:24","Journal.java","1794","21883","23677","","47354"
"2017-05-16 00:31","Journal.java","2882","24851","27733","","55466"
"2014-07-24 01:41","TestLedgerFragmentReplication.java","1183","6941","8124","","16248"
"2017-06-30 00:12","PerChannelBookieClient.java","10126","49719","59845","","119690"
"2017-07-04 06:27","PerChannelBookieClient.java","10322","51876","62198","","124396"
"2017-01-31 04:01","PerChannelBookieClient.java","6632","29412","36044","","72088"
"2017-04-15 13:58","PerChannelBookieClient.java","7037","35509","42546","","85092"
"2017-05-15 19:52","PerChannelBookieClient.java","8150","39276","47426","","94852"
"2017-07-28 20:12","PerChannelBookieClient.java","11588","57736","69324","","138648"
"2017-01-31 02:14","PerChannelBookieClient.java","6577","23888","30465","","60930"
"2017-03-28 22:35","PerChannelBookieClient.java","6827","34199","41026","","82052"
"2017-03-23 00:48","PerChannelBookieClient.java","6772","29892","36664","","73328"
"2017-08-02 00:49","PerChannelBookieClient.java","14572","74332","88904","","177808"
"2017-06-21 19:58","PerChannelBookieClient.java","9782","46231","56013","","112026"
"2017-06-01 23:58","PerChannelBookieClient.java","9287","43606","52893","","105786"
"2017-04-20 19:55","PerChannelBookieClient.java","7048","35541","42589","","85178"
"2017-07-07 05:11","Auditor.java","114218","55869","170087","","340174"
"2017-05-26 16:52","Auditor.java","112298","44177","156475","","312950"
"2016-09-10 21:01","Auditor.java","108809","13085","121894","","243788"
"2016-11-09 03:02","Auditor.java","110483","18427","128910","","257820"
"2017-07-04 06:27","LedgerCache.java","2419","12429","14848","","29696"
"2017-07-07 08:19","LedgerDirsManagerTest.java","115313","64151","179464","","358928"
"2017-01-30 23:25","LedgerDirsManagerTest.java","111902","33864","145766","","291532"
"2017-06-05 20:30","LedgerDirsManagerTest.java","114457","54455","168912","","337824"
"2014-08-02 20:02","ServerConfiguration.java","5212","31491","36703","","73406"
"2014-05-06 12:30","ServerConfiguration.java","4506","22135","26641","7","53282"
"2014-05-15 00:41","ServerConfiguration.java","4526","23069","27595","7","55190"
"2014-09-18 06:47","ServerConfiguration.java","5285","33573","38858","","77716"
"2017-07-04 06:27","ServerConfiguration.java","112958","89288","202246","","404492"
"2014-03-07 13:14","ServerConfiguration.java","4333","19603","23936","7","47872"
"2014-04-29 22:07","ServerConfiguration.java","4503","22085","26588","7","53176"
"2016-04-14 00:51","ServerConfiguration.java","109204","44272","153476","","306952"
"2015-01-16 15:57","ServerConfiguration.java","5685","36945","42630","","85260"
"2016-03-08 06:49","ServerConfiguration.java","6683","42377","49060","","98120"
"2016-01-26 22:11","ServerConfiguration.java","6429","41109","47538","","95076"
"2014-01-21 05:05","ServerConfiguration.java","3213","16133","19346","6","38692"
"2014-03-12 21:26","ServerConfiguration.java","4409","21481","25890","7","51780"
"2016-04-05 18:47","ServerConfiguration.java","109180","44198","153378","","306756"
"2016-04-27 09:55","ServerConfiguration.java","109252","44832","154084","","308168"
"2015-04-21 09:55","ServerConfiguration.java","5737","37438","43175","","86350"
"2015-01-12 15:18","ServerConfiguration.java","5682","36004","41686","","83372"
"2015-04-21 10:02","ServerConfiguration.java","5733","37467","43200","","86400"
"2017-05-15 19:52","ServerConfiguration.java","111636","77538","189174","","378348"
"2017-03-22 22:54","ServerConfiguration.java","110900","68744","179644","","359288"
"2017-03-23 00:48","ServerConfiguration.java","110905","68801","179706","","359412"
"2017-01-31 02:11","ServerConfiguration.java","110813","62288","173101","","346202"
"2016-04-05 08:45","ServerConfiguration.java","109178","43954","153132","","306264"
"2016-11-09 03:02","ServerConfiguration.java","110780","55083","165863","","331726"
"2016-11-30 00:02","ServerConfiguration.java","110790","55775","166565","","333130"
"2017-06-05 20:30","ServerConfiguration.java","112540","81993","194533","","389066"
"2016-09-10 20:27","ServerConfiguration.java","110651","51165","161816","","323632"
"2017-08-02 00:49","ServerConfiguration.java","116026","110562","226588","","453176"
"2017-10-03 12:31","ServerConfiguration.java","122752","107445","230197","","460394"
"2017-08-16 03:37","ServerConfiguration.java","117274","118443","235717","","471434"
"2013-07-20 19:59","ServerConfiguration.java","1259","7923","9182","5","18364"
"2013-12-02 18:45","ServerConfiguration.java","2871","14541","17412","6","34824"
"2014-05-09 14:04","ServerConfiguration.java","4521","22744","27265","7","54530"
"2017-05-26 12:38","ServerConfiguration.java","111778","79996","191774","","383548"
"2013-06-15 19:05","ServerConfiguration.java","1169","7264","8433","5","16866"
"2014-01-15 15:58","ServerConfiguration.java","2951","14965","17916","6","35832"
"2013-10-22 07:44","ServerConfiguration.java","2742","11915","14657","6","29314"
"2017-07-07 08:19","ServerConfiguration.java","112947","91240","204187","","408374"
"2017-06-28 23:24","ServerConfiguration.java","112692","85189","197881","","395762"
"2017-11-08 12:27","ServerConfiguration.java","124133","126700","250833","","501666"
"2014-01-22 14:35","ServerConfiguration.java","3499","17434","20933","6","41866"
"2013-10-12 05:42","ServerConfiguration.java","2534","11334","13868","6","27736"
"2014-02-05 22:43","EnsemblePlacementPolicy.java","3504","11905","15409","7","30818"
"2016-10-13 07:50","EnsemblePlacementPolicy.java","112110","50442","162552","","325104"
"2017-03-28 22:35","EnsemblePlacementPolicy.java","112368","68848","181216","","362432"
"2017-07-28 20:12","EnsemblePlacementPolicy.java","115204","90460","205664","","411328"
"2016-11-18 00:44","EnsemblePlacementPolicy.java","112234","51164","163398","","326796"
"2017-05-15 19:52","BookKeeperClusterTestCase.java","112131","58206","170337","","340674"
"2016-04-05 08:45","BookKeeperClusterTestCase.java","107629","22578","130207","","260414"
"2017-08-01 08:34","BookKeeperClusterTestCase.java","116956","89080","206036","","412072"
"2017-11-08 12:27","BookKeeperClusterTestCase.java","127172","109912","237084","","474168"
"2017-07-04 06:27","BookKeeperClusterTestCase.java","113825","70328","184153","","368306"
"2017-06-30 00:12","BookKeeperClusterTestCase.java","113672","68214","181886","","363772"
"2016-04-27 09:55","BookKeeperClusterTestCase.java","107727","23480","131207","","262414"
"2015-10-06 10:48","BookKeeperClusterTestCase.java","2954","16074","19028","","38056"
"2014-12-10 19:43","BookKeeperClusterTestCase.java","1949","11577","13526","","27052"
"2017-08-01 08:34","BookKeeperDiskSpaceWeightedLedgerPlacementTest.java","8602","38405","47007","","94014"
"2014-08-02 20:02","ServerConfiguration.java","5218","31516","36734","","73468"
"2014-05-06 12:30","ServerConfiguration.java","4512","22160","26672","7","53344"
"2014-05-15 00:41","ServerConfiguration.java","4532","23094","27626","7","55252"
"2014-09-18 06:47","ServerConfiguration.java","5291","33598","38889","","77778"
"2017-07-04 06:27","ServerConfiguration.java","112963","89312","202275","","404550"
"2014-03-07 13:14","ServerConfiguration.java","4339","19628","23967","7","47934"
"2014-04-29 22:07","ServerConfiguration.java","4509","22110","26619","7","53238"
"2016-04-14 00:51","ServerConfiguration.java","109209","44296","153505","","307010"
"2015-01-16 15:57","ServerConfiguration.java","5691","36970","42661","","85322"
"2016-03-08 06:49","ServerConfiguration.java","6689","42402","49091","","98182"
"2016-01-26 22:11","ServerConfiguration.java","6435","41134","47569","","95138"
"2014-01-21 05:05","ServerConfiguration.java","3219","16158","19377","6","38754"
"2014-03-12 21:26","ServerConfiguration.java","4415","21506","25921","7","51842"
"2016-04-05 18:47","ServerConfiguration.java","109186","44223","153409","","306818"
"2016-04-27 09:55","ServerConfiguration.java","109257","44856","154113","","308226"
"2015-04-21 09:55","ServerConfiguration.java","5743","37463","43206","","86412"
"2015-01-12 15:18","ServerConfiguration.java","5688","36029","41717","","83434"
"2015-04-21 10:02","ServerConfiguration.java","5739","37492","43231","","86462"
"2017-05-15 19:52","ServerConfiguration.java","111641","77562","189203","","378406"
"2017-03-22 22:54","ServerConfiguration.java","110905","68768","179673","","359346"
"2017-03-23 00:48","ServerConfiguration.java","110910","68825","179735","","359470"
"2017-01-31 02:11","ServerConfiguration.java","110818","62312","173130","","346260"
"2016-04-05 08:45","ServerConfiguration.java","109184","43979","153163","","306326"
"2016-11-09 03:02","ServerConfiguration.java","110785","55107","165892","","331784"
"2016-11-30 00:02","ServerConfiguration.java","110795","55799","166594","","333188"
"2017-06-05 20:30","ServerConfiguration.java","112545","82017","194562","","389124"
"2016-09-10 20:27","ServerConfiguration.java","110656","51189","161845","","323690"
"2017-08-02 00:49","ServerConfiguration.java","116031","110586","226617","","453234"
"2017-10-03 12:31","ServerConfiguration.java","122737","107449","230186","","460372"
"2017-08-16 03:37","ServerConfiguration.java","117261","118449","235710","","471420"
"2013-07-20 19:59","ServerConfiguration.java","1265","7948","9213","5","18426"
"2013-12-02 18:45","ServerConfiguration.java","2877","14566","17443","6","34886"
"2014-05-09 14:04","ServerConfiguration.java","4527","22769","27296","7","54592"
"2017-05-26 12:38","ServerConfiguration.java","111783","80020","191803","","383606"
"2013-06-15 19:05","ServerConfiguration.java","1175","7289","8464","5","16928"
"2014-01-15 15:58","ServerConfiguration.java","2957","14990","17947","6","35894"
"2013-10-22 07:44","ServerConfiguration.java","2748","11940","14688","6","29376"
"2017-07-07 08:19","ServerConfiguration.java","112952","91264","204216","","408432"
"2017-06-28 23:24","ServerConfiguration.java","112697","85213","197910","","395820"
"2017-11-08 12:27","ServerConfiguration.java","124118","126704","250822","","501644"
"2014-01-22 14:35","ServerConfiguration.java","3505","17459","20964","6","41928"
"2013-10-12 05:42","ServerConfiguration.java","2540","11359","13899","6","27798"
"2014-06-06 15:29","AuditorPeriodicBookieCheckTest.java","402","2425","2827","7","5654"
"2017-05-16 00:31","BookieProtocol.java","73492","89193","162685","","325370"
"2017-06-01 21:20","BookieProtocol.java","74145","92173","166318","","332636"
"2013-03-18 00:31","BookieProtocol.java","5659","55173","60832","4","121664"
"2016-04-05 08:45","BookieProtocol.java","71301","55458","126759","","253518"
"2013-02-12 11:16","BookieProtocol.java","5528","54829","60357","4","120714"
"2017-05-15 19:52","BookieProtocol.java","73420","88703","162123","","324246"
"2017-06-05 22:25","BookieProtocol.java","74247","94172","168419","","336838"
"2017-08-02 00:49","PerChannelBookieClient.java","3657","17269","20926","","41852"
"2014-08-02 20:02","DiskChecker.java","2987","17252","20239","","40478"
"2017-07-07 08:19","DiskChecker.java","114117","80396","194513","","389026"
"2017-06-05 20:30","DiskChecker.java","113614","71053","184667","","369334"
"2016-07-14 23:02","TestClient.java","40466","86503","126969","","253938"
"2012-09-11 10:30","TestClient.java","13531","64890","78421","2","156842"
"2013-02-08 19:08","TestClient.java","17094","126613","143707","4","287414"
"2012-05-04 20:11","TestClient.java","10405","28860","39265","1","78530"
"2012-05-09 13:20","TestClient.java","10596","29778","40374","1","80748"
"2016-07-14 23:02","FileSystemUpgrade.java","66150","60829","126979","","253958"
"2017-03-22 22:54","FileSystemUpgrade.java","67290","83248","150538","","301076"
"2013-02-08 19:08","FileSystemUpgrade.java","7693","65854","73547","4","147094"
"2012-12-08 11:18","FileSystemUpgrade.java","5133","25060","30193","2","60386"
"2014-09-18 06:57","FileSystemUpgrade.java","12026","98455","110481","","220962"
"2017-10-17 09:32","AuditorElector.java","35213","65169","100382","","200764"
"2014-02-05 22:43","BookieWatcher.java","3504","11905","15409","7","30818"
"2016-11-18 00:44","BookieWatcher.java","112234","51164","163398","","326796"
"2017-01-31 04:01","LedgerDescriptor.java","47489","96718","144207","","288414"
"2017-05-16 00:31","LedgerDescriptor.java","48024","106017","154041","","308082"
"2012-12-18 13:04","LedgerDescriptor.java","10762","68600","79362","2","158724"
"2016-11-18 00:18","LedgerDescriptor.java","47444","83572","131016","","262032"
"2016-12-21 01:48","LedgerCacheTest.java","48415","87883","136298","","272596"
"2013-02-12 06:00","LedgerCacheTest.java","11455","99938","111393","4","222786"
"2013-01-07 03:48","LedgerCacheTest.java","10803","67194","77997","2","155994"
"2012-12-24 05:50","LedgerCacheTest.java","10209","64958","75167","2","150334"
"2012-12-24 06:23","LedgerCacheTest.java","10265","65236","75501","2","151002"
"2019-02-20 11:43","LedgerCacheTest.java","56326","434471","490797","","981594"
"2013-08-12 19:01","LedgerCacheTest.java","12927","108806","121733","5","243466"
"2013-10-12 05:42","LedgerCacheTest.java","13735","111011","124746","6","249492"
"2017-05-16 00:31","LedgerCacheTest.java","48991","103787","152778","","305556"
"2013-12-02 18:45","LedgerCacheTest.java","13955","114101","128056","6","256112"
"2014-07-24 01:41","LedgerCacheTest.java","14878","123181","138059","","276118"
"2014-12-10 19:43","LedgerCacheTest.java","15295","133226","148521","","297042"
"2016-03-08 06:49","LedgerCacheTest.java","15815","139985","155800","","311600"
"2014-03-12 21:26","LedgerCacheTest.java","14556","120104","134660","7","269320"
"2012-12-08 11:18","LedgerCacheTest.java","9489","59778","69267","2","138534"
"2012-10-26 12:51","LedgerCacheTest.java","8883","49504","58387","2","116774"
"2012-12-08 11:18","Bookie.java","10591","65416","76007","2","152014"
"2012-09-14 15:42","Bookie.java","7324","42848","50172","2","100344"
"2012-10-25 15:35","Bookie.java","9984","54752","64736","2","129472"
"2012-10-26 16:25","Bookie.java","10176","55893","66069","2","132138"
"2017-01-31 04:01","Bookie.java","47150","97718","144868","","289736"
"2017-03-28 22:37","Bookie.java","47176","102551","149727","","299454"
"2016-01-26 22:11","Bookie.java","15849","143541","159390","","318780"
"2015-03-18 07:38","Bookie.java","15595","140035","155630","","311260"
"2015-04-21 09:17","Bookie.java","15594","140136","155730","","311460"
"2012-10-18 16:40","Bookie.java","9876","53507","63383","2","126766"
"2012-12-03 17:59","Bookie.java","10453","65233","75686","2","151372"
"2012-07-04 16:17","Bookie.java","3969","15995","19964","2","39928"
"2012-07-23 23:39","Bookie.java","5619","21041","26660","2","53320"
"2013-06-21 19:26","Bookie.java","13385","112619","126004","5","252008"
"2012-09-07 07:04","Bookie.java","6948","41811","48759","2","97518"
"2014-09-23 17:53","Bookie.java","15398","136781","152179","","304358"
"2017-07-04 06:27","Bookie.java","48415","117757","166172","","332344"
"2017-06-05 22:25","Bookie.java","48310","111866","160176","","320352"
"2014-02-06 09:25","Bookie.java","14815","121904","136719","7","273438"
"2014-04-29 22:07","Bookie.java","14912","125506","140418","7","280836"
"2013-12-06 07:39","Bookie.java","14361","119195","133556","6","267112"
"2012-07-05 14:45","Bookie.java","3986","16494","20480","2","40960"
"2012-05-10 14:47","Bookie.java","1204","3993","5197","1","10394"
"2014-08-02 20:02","Bookie.java","15335","134626","149961","","299922"
"2012-04-17 13:16","Bookie.java","728","2290","3018","1","6036"
"2012-04-16 16:11","Bookie.java","220","1370","1590","1","3180"
"2013-10-02 07:01","Bookie.java","13517","114596","128113","5","256226"
"2012-06-19 12:39","Bookie.java","2508","8947","11455","2","22910"
"2017-06-28 23:24","Bookie.java","48347","113856","162203","","324406"
"2017-07-07 08:19","Bookie.java","48412","119717","168129","","336258"
"2013-09-11 00:34","Bookie.java","13492","114370","127862","5","255724"
"2014-01-21 17:26","Bookie.java","14462","121033","135495","6","270990"
"2013-10-12 05:42","Bookie.java","14164","115976","130140","6","260280"
"2013-10-22 16:21","Bookie.java","14337","116916","131253","6","262506"
"2017-05-16 00:31","Bookie.java","47675","107007","154682","","309364"
"2013-07-24 16:55","Bookie.java","13431","113723","127154","5","254308"
"2014-02-05 22:43","Bookie.java","14813","121894","136707","7","273414"
"2014-08-18 23:03","Bookie.java","15348","136107","151455","","302910"
"2014-05-09 14:04","Bookie.java","14915","126150","141065","7","282130"
"2013-06-15 19:05","Bookie.java","13381","112488","125869","5","251738"
"2017-06-01 23:58","Bookie.java","48286","110393","158679","","317358"
"2012-04-17 12:18","Bookie.java","347","1686","2033","1","4066"
"2012-04-02 12:38","Bookie.java","188","1164","1352","1","2704"
"2017-08-02 00:49","Bookie.java","49234","136782","186016","","372032"
"2013-12-02 18:45","Bookie.java","14357","119039","133396","6","266792"
"2013-05-04 14:22","Bookie.java","13206","107784","120990","5","241980"
"2012-12-18 13:04","Bookie.java","10879","70056","80935","2","161870"
"2016-11-18 00:18","Bookie.java","47108","84575","131683","","263366"
"2017-03-28 22:35","Bookie.java","47158","102318","149476","","298952"
"2016-07-14 23:02","Bookie.java","47033","76610","123643","","247286"
"2017-06-05 20:30","Bookie.java","48286","110751","159037","","318074"
"2016-11-30 00:02","Bookie.java","47115","85112","132227","","264454"
"2012-12-24 05:50","Bookie.java","11090","70375","81465","2","162930"
"2017-03-22 22:54","Bookie.java","47159","98015","145174","","290348"
"2012-12-24 06:23","Bookie.java","11141","70648","81789","2","163578"
"2017-07-04 06:27","LedgerHandle.java","343","2304","2647","","5294"
"2017-05-15 19:52","LedgerHandle.java","112424","59160","171584","","343168"
"2017-05-02 22:07","LedgerHandle.java","111607","55989","167596","","335192"
"2017-03-23 15:55","LedgerHandle.java","111403","50159","161562","","323124"
"2016-09-10 21:01","LedgerHandle.java","109615","31084","140699","","281398"
"2016-07-11 23:01","LedgerHandle.java","108310","25675","133985","","267970"
"2017-05-17 08:57","LedgerHandle.java","112582","59795","172377","","344754"
"2017-05-25 14:23","LedgerHandle.java","112616","61634","174250","","348500"
"2017-06-21 19:50","LedgerHandle.java","113681","65630","179311","","358622"
"2017-06-21 21:00","LedgerHandle.java","113691","66423","180114","","360228"
"2017-06-01 23:58","LedgerHandle.java","113406","63335","176741","","353482"
"2014-09-18 06:47","LedgerHandle.java","1817","10939","12756","","25512"
"2014-12-09 19:57","LedgerHandle.java","2101","12316","14417","","28834"
"2017-07-04 06:27","LedgerHandle.java","114111","71275","185386","","370772"
"2017-06-30 00:12","LedgerHandle.java","113958","69161","183119","","366238"
"2016-02-09 08:32","LedgerHandle.java","3617","19263","22880","","45760"
"2016-03-16 05:03","LedgerHandle.java","107951","20858","128809","","257618"
"2015-10-22 09:22","LedgerHandle.java","3464","18075","21539","","43078"
"2015-10-06 10:05","LedgerHandle.java","3430","16985","20415","","40830"
"2017-01-31 04:01","LedgerHandle.java","111287","49677","160964","","321928"
"2015-04-21 09:39","LedgerHandle.java","2581","14965","17546","","35092"
"2015-10-06 11:12","LedgerHandle.java","3436","17231","20667","","41334"
"2014-12-05 14:10","LedgerHandle.java","2047","11813","13860","","27720"
"2017-07-28 20:12","BKException.java","81854","99812","181666","","363332"
"2016-07-11 22:53","BKException.java","78181","50839","129020","","258040"
"2017-05-02 23:04","BKException.java","79923","81369","161292","","322584"
"2013-09-10 15:14","BKException.java","5031","49892","54923","5","109846"
"2014-02-21 19:01","BKException.java","7216","59482","66698","7","133396"
"2017-08-02 00:49","BKException.java","84247","115817","200064","","400128"
"2015-09-15 10:38","BKException.java","9012","78443","87455","","174910"
"2017-01-31 04:01","BKException.java","79470","74060","153530","","307060"
"2015-10-06 10:48","BKException.java","9018","78999","88017","","176034"
"2015-10-22 09:22","BKException.java","9041","79852","88893","","177786"
"2017-01-31 04:01","BookkeeperInternalCallbacks.java","110826","54313","165139","","330278"
"2017-06-05 22:25","BookkeeperInternalCallbacks.java","113037","69512","182549","","365098"
"2017-08-02 00:49","BookkeeperInternalCallbacks.java","117040","97507","214547","","429094"
"2017-06-21 21:00","BookkeeperInternalCallbacks.java","113111","70940","184051","","368102"
"2017-06-05 22:13","BookkeeperInternalCallbacks.java","112951","69132","182083","","364166"
"2017-05-15 19:52","BookkeeperInternalCallbacks.java","111874","63707","175581","","351162"
"2017-03-28 22:35","BookkeeperInternalCallbacks.java","110928","59007","169935","","339870"
"2017-07-28 20:12","BKException.java","50081","117578","167659","","335318"
"2016-07-11 22:53","BKException.java","48022","70219","118241","","236482"
"2017-05-02 23:04","BKException.java","48536","99521","148057","","296114"
"2013-09-10 15:14","BKException.java","12510","106910","119420","5","238840"
"2014-02-21 19:01","BKException.java","14125","115930","130055","7","260110"
"2017-08-02 00:49","BKException.java","50686","131795","182481","","364962"
"2012-12-12 11:20","BKException.java","8861","58400","67261","2","134522"
"2015-09-15 10:38","BKException.java","15234","134204","149438","","298876"
"2017-01-31 04:01","BKException.java","48191","92320","140511","","281022"
"2015-10-06 10:48","BKException.java","15237","134757","149994","","299988"
"2015-10-22 09:22","BKException.java","15245","135595","150840","","301680"
"2012-09-04 10:39","BKException.java","4724","31785","36509","2","73018"
"2012-12-03 17:59","BKException.java","8635","56976","65611","2","131222"
"2017-05-15 19:52","LedgerHandle.java","112404","59101","171505","","343010"
"2017-05-02 22:07","LedgerHandle.java","111587","55930","167517","","335034"
"2017-03-23 15:55","LedgerHandle.java","111383","50100","161483","","322966"
"2016-09-10 21:01","LedgerHandle.java","109595","31025","140620","","281240"
"2016-07-11 23:01","LedgerHandle.java","108290","25616","133906","","267812"
"2017-05-17 08:57","LedgerHandle.java","112562","59736","172298","","344596"
"2017-05-25 14:23","LedgerHandle.java","112597","61576","174173","","348346"
"2017-06-21 19:50","LedgerHandle.java","113663","65573","179236","","358472"
"2017-06-21 21:00","LedgerHandle.java","113677","66370","180047","","360094"
"2017-06-01 23:58","LedgerHandle.java","113388","63278","176666","","353332"
"2014-09-18 06:47","LedgerHandle.java","1794","10877","12671","","25342"
"2014-12-09 19:57","LedgerHandle.java","2081","12257","14338","","28676"
"2017-07-04 06:27","LedgerHandle.java","114097","71222","185319","","370638"
"2017-06-30 00:12","LedgerHandle.java","113944","69108","183052","","366104"
"2016-02-09 08:32","LedgerHandle.java","3597","19204","22801","","45602"
"2016-03-16 05:03","LedgerHandle.java","107931","20799","128730","","257460"
"2015-10-22 09:22","LedgerHandle.java","3444","18016","21460","","42920"
"2015-10-06 10:05","LedgerHandle.java","3410","16926","20336","","40672"
"2017-01-31 04:01","LedgerHandle.java","111267","49618","160885","","321770"
"2015-04-21 09:39","LedgerHandle.java","2561","14906","17467","","34934"
"2015-10-06 11:12","LedgerHandle.java","3416","17172","20588","","41176"
"2014-12-05 14:10","LedgerHandle.java","2024","11751","13775","","27550"
"2012-12-08 11:18","Bookie.java","10452","63938","74390","2","148780"
"2012-09-14 15:42","Bookie.java","7175","41360","48535","2","97070"
"2012-10-25 15:35","Bookie.java","9841","53270","63111","2","126222"
"2012-10-26 16:25","Bookie.java","10033","54411","64444","2","128888"
"2017-01-31 04:01","Bookie.java","47489","96718","144207","","288414"
"2017-03-28 22:37","Bookie.java","47523","101559","149082","","298164"
"2016-01-26 22:11","Bookie.java","16165","142518","158683","","317366"
"2015-03-18 07:38","Bookie.java","15901","139002","154903","","309806"
"2015-04-21 09:17","Bookie.java","15900","139103","155003","","310006"
"2012-10-18 16:40","Bookie.java","9733","52025","61758","2","123516"
"2012-12-03 17:59","Bookie.java","10313","63754","74067","2","148134"
"2012-07-04 16:17","Bookie.java","3751","14438","18189","2","36378"
"2012-07-23 23:39","Bookie.java","5409","19492","24901","2","49802"
"2013-06-21 19:26","Bookie.java","13596","111491","125087","5","250174"
"2012-09-07 07:04","Bookie.java","6793","40317","47110","2","94220"
"2014-09-23 17:53","Bookie.java","15700","135744","151444","","302888"
"2017-07-04 06:27","Bookie.java","48796","116799","165595","","331190"
"2017-06-05 22:25","Bookie.java","48680","110897","159577","","319154"
"2014-02-06 09:25","Bookie.java","15092","120842","135934","7","271868"
"2014-04-29 22:07","Bookie.java","15197","124452","139649","7","279298"
"2013-12-06 07:39","Bookie.java","14611","118106","132717","6","265434"
"2012-07-05 14:45","Bookie.java","3768","14937","18705","2","37410"
"2012-05-10 14:47","Bookie.java","879","2329","3208","1","6416"
"2014-08-02 20:02","Bookie.java","15637","133589","149226","","298452"
"2013-10-02 07:01","Bookie.java","13728","113468","127196","5","254392"
"2012-06-19 12:39","Bookie.java","2275","7375","9650","2","19300"
"2017-06-28 23:24","Bookie.java","48721","112891","161612","","323224"
"2017-07-07 08:19","Bookie.java","48792","118758","167550","","335100"
"2013-09-11 00:34","Bookie.java","13703","113242","126945","5","253890"
"2014-01-21 17:26","Bookie.java","14718","119950","134668","6","269336"
"2013-10-12 05:42","Bookie.java","14412","114885","129297","6","258594"
"2013-10-22 16:21","Bookie.java","14587","115827","130414","6","260828"
"2017-05-16 00:31","Bookie.java","48024","106017","154041","","308082"
"2013-07-24 16:55","Bookie.java","13642","112595","126237","5","252474"
"2014-02-05 22:43","Bookie.java","15089","120831","135920","7","271840"
"2014-08-18 23:03","Bookie.java","15650","135070","150720","","301440"
"2014-05-09 14:04","Bookie.java","15205","125101","140306","7","280612"
"2013-06-15 19:05","Bookie.java","13596","111364","124960","5","249920"
"2017-06-01 23:58","Bookie.java","48661","109429","158090","","316180"
"2017-08-02 00:49","Bookie.java","49635","135844","185479","","370958"
"2013-12-02 18:45","Bookie.java","14607","117950","132557","6","265114"
"2013-05-04 14:22","Bookie.java","13424","106663","120087","5","240174"
"2012-12-18 13:04","Bookie.java","10762","68600","79362","2","158724"
"2016-11-18 00:18","Bookie.java","47444","83572","131016","","262032"
"2017-03-28 22:35","Bookie.java","47505","101326","148831","","297662"
"2016-07-14 23:02","Bookie.java","47372","75610","122982","","245964"
"2017-06-05 20:30","Bookie.java","48661","109787","158448","","316896"
"2016-11-30 00:02","Bookie.java","47455","84113","131568","","263136"
"2012-12-24 05:50","Bookie.java","11147","69093","80240","2","160480"
"2017-03-22 22:54","Bookie.java","47507","97024","144531","","289062"
"2012-12-24 06:23","Bookie.java","11199","69367","80566","2","161132"
"2017-06-01 23:58","ExplicitLacFlushPolicy.java","3520","15059","18579","","37158"
"2017-05-15 19:52","ExplicitLacFlushPolicy.java","2252","10598","12850","","25700"
"2017-03-23 00:59","ExplicitLacFlushPolicy.java","190","542","732","","1464"
"2017-07-04 06:27","LedgerStorage.java","4948","36823","41771","","83542"
"2017-03-28 22:37","LedgerStorage.java","1057","18965","20022","","40044"
"2017-01-31 04:01","LedgerStorage.java","779","13880","14659","","29318"
"2017-05-16 00:31","LedgerStorage.java","2889","24754","27643","","55286"
"2016-03-16 04:51","AutoRecoveryMain.java","73035","52200","125235","","250470"
"2013-10-02 06:23","AutoRecoveryMain.java","6373","61545","67918","5","135836"
"2013-01-14 16:59","AutoRecoveryMain.java","4230","20859","25089","2","50178"
"2012-12-18 12:00","AutoRecoveryMain.java","2238","15408","17646","2","35292"
"2014-03-10 03:14","AutoRecoveryMain.java","8488","71739","80227","7","160454"
"2014-04-24 10:43","AutoRecoveryMain.java","8497","72996","81493","7","162986"
"2014-09-06 07:58","AutoRecoveryMain.java","9180","84760","93940","","187880"
"2013-12-06 07:39","AutoRecoveryMain.java","7496","66613","74109","6","148218"
"2017-05-15 19:52","BookKeeperClusterTestCase.java","112528","59877","172405","","344810"
"2016-04-05 08:45","BookKeeperClusterTestCase.java","108094","24317","132411","","264822"
"2017-08-01 08:34","BookKeeperClusterTestCase.java","117310","90708","208018","","416036"
"2017-11-08 12:27","BookKeeperClusterTestCase.java","127458","111472","238930","","477860"
"2017-07-04 06:27","BookKeeperClusterTestCase.java","114204","71981","186185","","372370"
"2014-07-24 01:41","BookKeeperClusterTestCase.java","710","1984","2694","","5388"
"2017-06-30 00:12","BookKeeperClusterTestCase.java","114065","69881","183946","","367892"
"2016-04-27 09:55","BookKeeperClusterTestCase.java","108183","25210","133393","","266786"
"2015-10-06 10:48","BookKeeperClusterTestCase.java","3576","17970","21546","","43092"
"2014-12-10 19:43","BookKeeperClusterTestCase.java","2598","13500","16098","","32196"
"2017-05-09 23:06","GarbageCollectorThread.java","111536","40280","151816","","303632"
"2017-11-08 12:27","GarbageCollectorThread.java","132573","99446","232019","","464038"
"2017-03-28 22:39","GarbageCollectorThread.java","110910","37598","148508","","297016"
"2017-01-30 23:25","GarbageCollectorThread.java","110683","26406","137089","","274178"
"2016-05-04 15:55","GarbageCollectorThread.java","105047","4956","110003","","220006"
"2017-05-15 19:52","TestRackawareEnsemblePlacementPolicy.java","2005","5759","7764","","15528"
"2017-08-16 03:41","TestRackawareEnsemblePlacementPolicy.java","11924","51169","63093","","126186"
"2012-12-08 11:18","Bookie.java","16634","76360","92994","2","185988"
"2012-09-14 15:42","Bookie.java","13584","54009","67593","2","135186"
"2012-10-25 15:35","Bookie.java","16203","65872","82075","2","164150"
"2012-10-26 16:25","Bookie.java","16333","66951","83284","2","166568"
"2017-01-31 04:01","Bookie.java","45800","101269","147069","","294138"
"2017-03-28 22:37","Bookie.java","45816","106092","151908","","303816"
"2016-01-26 22:11","Bookie.java","20819","153412","174231","","348462"
"2015-03-18 07:38","Bookie.java","20593","149934","170527","","341054"
"2015-04-21 09:17","Bookie.java","20592","150035","170627","","341254"
"2012-10-18 16:40","Bookie.java","16107","64639","80746","2","161492"
"2012-12-03 17:59","Bookie.java","16512","76193","92705","2","185410"
"2012-07-04 16:17","Bookie.java","10570","27497","38067","2","76134"
"2012-07-23 23:39","Bookie.java","12141","32464","44605","2","89210"
"2013-06-21 19:26","Bookie.java","19160","123295","142455","5","284910"
"2012-09-07 07:04","Bookie.java","13227","52991","66218","2","132436"
"2014-09-23 17:53","Bookie.java","20471","146755","167226","","334452"
"2017-07-04 06:27","Bookie.java","46960","121203","168163","","336326"
"2017-06-05 22:25","Bookie.java","46868","115325","162193","","324386"
"2014-02-06 09:25","Bookie.java","19959","131949","151908","7","303816"
"2014-04-29 22:07","Bookie.java","20049","135544","155593","7","311186"
"2013-12-06 07:39","Bookie.java","19534","129269","148803","6","297606"
"2012-07-05 14:45","Bookie.java","10586","27995","38581","2","77162"
"2012-05-10 14:47","Bookie.java","9118","16808","25926","1","51852"
"2014-08-02 20:02","Bookie.java","20460","144652","165112","","330224"
"2012-04-17 13:16","Bookie.java","8765","15228","23993","1","47986"
"2012-04-16 16:11","Bookie.java","8321","14372","22693","1","45386"
"2013-10-02 07:01","Bookie.java","19280","125260","144540","5","289080"
"2012-06-19 12:39","Bookie.java","10366","21706","32072","2","64144"
"2017-06-28 23:24","Bookie.java","46903","117313","164216","","328432"
"2017-07-07 08:19","Bookie.java","46954","123160","170114","","340228"
"2013-09-11 00:34","Bookie.java","19256","125035","144291","5","288582"
"2014-01-21 17:26","Bookie.java","19635","131107","150742","6","301484"
"2013-10-12 05:42","Bookie.java","19368","126081","145449","6","290898"
"2013-10-22 16:21","Bookie.java","19510","126990","146500","6","293000"
"2017-05-16 00:31","Bookie.java","46287","110520","156807","","313614"
"2013-07-24 16:55","Bookie.java","19201","124394","143595","5","287190"
"2014-02-05 22:43","Bookie.java","19957","131939","151896","7","303792"
"2014-08-18 23:03","Bookie.java","20460","146120","166580","","333160"
"2014-05-09 14:04","Bookie.java","20049","136185","156234","7","312468"
"2013-06-15 19:05","Bookie.java","19155","123163","142318","5","284636"
"2017-06-01 23:58","Bookie.java","46856","113864","160720","","321440"
"2012-03-29 15:18","Bookie.java","8153","13054","21207","1","42414"
"2012-04-17 12:18","Bookie.java","8385","14625","23010","1","46020"
"2012-03-20 14:09","Bookie.java","7873","12059","19932","1","39864"
"2012-03-13 07:31","Bookie.java","518","2775","3293","1","6586"
"2012-04-02 12:38","Bookie.java","8313","14190","22503","1","45006"
"2017-08-02 00:49","Bookie.java","47710","140159","187869","","375738"
"2013-12-02 18:45","Bookie.java","19529","129112","148641","6","297282"
"2013-05-04 14:22","Bookie.java","18973","118452","137425","5","274850"
"2012-12-18 13:04","Bookie.java","16912","80990","97902","2","195804"
"2016-11-18 00:18","Bookie.java","45770","88138","133908","","267816"
"2017-03-28 22:35","Bookie.java","45808","105869","151677","","303354"
"2016-07-14 23:02","Bookie.java","45691","80169","125860","","251720"
"2017-06-05 20:30","Bookie.java","46856","114222","161078","","322156"
"2016-11-30 00:02","Bookie.java","45766","88664","134430","","268860"
"2012-12-24 05:50","Bookie.java","17116","81302","98418","2","196836"
"2017-03-22 22:54","Bookie.java","45809","101566","147375","","294750"
"2012-12-24 06:23","Bookie.java","17165","81573","98738","2","197476"
"2017-05-04 20:58","AbstractZkLedgerManager.java","111768","41226","152994","","305988"
"2017-06-01 23:58","AbstractZkLedgerManager.java","113440","47555","160995","","321990"
"2017-06-12 17:20","AbstractZkLedgerManager.java","113824","49716","163540","","327080"
"2017-03-28 22:40","AbstractZkLedgerManager.java","111185","38796","149981","","299962"
"2017-08-01 08:34","BookKeeperClusterTestCase.java","4709","22291","27000","","54000"
"2017-11-08 12:27","BookKeeperClusterTestCase.java","35192","63390","98582","","197164"
"2017-07-04 06:27","BookKeeperClusterTestCase.java","343","2304","2647","","5294"
"2017-05-02 23:04","HierarchicalLedgerManagerFactory.java","48536","99521","148057","","296114"
"2012-09-07 07:04","HierarchicalLedgerManagerFactory.java","4844","33268","38112","2","76224"
"2015-09-15 10:38","HierarchicalLedgerManagerFactory.java","15234","134204","149438","","298876"
"2017-03-28 22:40","HierarchicalLedgerManagerFactory.java","48290","97454","145744","","291488"
"2014-12-06 07:38","CleanupLedgerManager.java","2460","16295","18755","","37510"
"2017-06-21 21:00","CleanupLedgerManager.java","113169","69835","183004","","366008"
"2015-09-15 10:38","BookKeeper.java","20699","151980","172679","","345358"
"2015-10-22 09:22","BookKeeper.java","20714","153375","174089","","348178"
"2017-01-31 04:01","BookKeeper.java","45674","102114","147788","","295576"
"2012-07-23 23:39","BookKeeper.java","12199","33493","45692","2","91384"
"2012-12-13 13:07","BookKeeper.java","16878","79499","96377","2","192754"
"2015-07-10 22:48","BookKeeper.java","20544","151523","172067","","344134"
"2017-06-30 00:12","BookKeeper.java","46738","119991","166729","","333458"
"2014-02-06 09:21","BookKeeper.java","19872","132829","152701","7","305402"
"2012-06-05 08:00","BookKeeper.java","9723","20053","29776","1","59552"
"2012-06-19 12:39","BookKeeper.java","10436","22747","33183","2","66366"
"2012-09-12 11:59","BookKeeper.java","13364","54624","67988","2","135976"
"2014-01-21 05:19","BookKeeper.java","19566","131716","151282","6","302564"
"2013-10-02 06:40","BookKeeper.java","19249","126094","145343","5","290686"
"2014-02-21 19:01","BookKeeper.java","19926","134042","153968","7","307936"
"2016-10-13 07:50","BookKeeper.java","45561","88445","134006","","268012"
"2017-06-21 21:00","BookKeeper.java","46726","117508","164234","","328468"
"2013-06-12 18:41","BookKeeper.java","19127","123679","142806","5","285612"
"2013-05-06 19:32","BookKeeper.java","18961","119511","138472","5","276944"
"2013-01-10 19:13","BookKeeper.java","17765","85357","103122","2","206244"
"2017-03-28 22:35","BookKeeper.java","45668","106700","152368","","304736"
"2016-07-11 23:01","BookKeeper.java","45553","80968","126521","","253042"
"2016-10-13 09:27","BookKeeper.java","45637","88507","134144","","268288"
"2017-07-28 20:12","BookKeeper.java","47097","126905","174002","","348004"
"2017-05-15 19:52","BookKeeper.java","46069","110855","156924","","313848"
"2013-09-10 15:14","BookKeeper.java","19219","125930","145149","5","290298"
"2017-07-28 22:34","LedgerMetadataCreationTest.java","2506","25034","27540","","55080"
"2017-06-30 00:12","PerChannelBookieClient.java","4161","26443","30604","","61208"
"2017-07-04 06:27","PerChannelBookieClient.java","4425","28668","33093","","66186"
"2017-04-15 13:58","PerChannelBookieClient.java","680","11841","12521","","25042"
"2017-05-15 19:52","PerChannelBookieClient.java","2090","15905","17995","","35990"
"2017-07-28 20:12","PerChannelBookieClient.java","5908","34745","40653","","81306"
"2017-03-28 22:35","PerChannelBookieClient.java","345","10406","10751","","21502"
"2017-03-23 00:48","PerChannelBookieClient.java","250","6059","6309","","12618"
"2017-08-02 00:49","PerChannelBookieClient.java","9032","51481","60513","","121026"
"2017-06-21 19:58","PerChannelBookieClient.java","3791","22929","26720","","53440"
"2017-06-01 23:58","PerChannelBookieClient.java","3292","20300","23592","","47184"
"2017-04-20 19:55","PerChannelBookieClient.java","692","11874","12566","","25132"
"2014-12-05 17:51","RoundRobinDistributionScheduleTest.java","4184","24351","28535","","57070"
"2017-06-30 00:12","RoundRobinDistributionScheduleTest.java","114332","79867","194199","","388398"
"2017-06-30 00:12","PerChannelBookieClient.java","4207","16428","20635","","41270"
"2017-07-04 06:27","PerChannelBookieClient.java","4491","18673","23164","","46328"
"2017-04-15 13:58","PerChannelBookieClient.java","433","1533","1966","","3932"
"2017-05-15 19:52","PerChannelBookieClient.java","2005","5759","7764","","15528"
"2017-07-28 20:12","PerChannelBookieClient.java","6033","24809","30842","","61684"
"2017-08-02 00:49","PerChannelBookieClient.java","9396","41784","51180","","102360"
"2017-06-21 19:58","PerChannelBookieClient.java","3810","12887","16697","","33394"
"2017-06-01 23:58","PerChannelBookieClient.java","3302","10249","13551","","27102"
"2017-04-20 19:55","PerChannelBookieClient.java","450","1571","2021","","4042"
"2017-01-31 04:01","LedgerDescriptor.java","46615","97898","144513","","289026"
"2017-05-16 00:31","LedgerDescriptor.java","47134","107181","154315","","308630"
"2012-04-17 12:18","LedgerDescriptor.java","646","2700","3346","1","6692"
"2012-12-18 13:04","LedgerDescriptor.java","11114","71006","82120","2","164240"
"2016-11-18 00:18","LedgerDescriptor.java","46573","84755","131328","","262656"
"2014-12-09 19:57","LedgerCloseTest.java","5062","33237","38299","","76598"
"2016-03-16 04:43","LedgerCloseTest.java","109350","39985","149335","","298670"
"2013-10-14 18:32","LedgerCloseTest.java","2134","9821","11955","6","23910"
"2014-02-05 22:43","LedgerCloseTest.java","3706","16569","20275","7","40550"
"2017-05-16 00:31","LedgerCloseTest.java","112044","77158","189202","","378404"
"2013-06-26 03:27","LedgerCloseTest.java","655","5711","6366","5","12732"
"2013-10-29 05:14","LedgerCloseTest.java","2363","10860","13223","6","26446"
"2017-05-15 19:52","BookKeeperClusterTestCase.java","112477","61175","173652","","347304"
"2016-04-05 08:45","BookKeeperClusterTestCase.java","108069","25641","133710","","267420"
"2017-08-01 08:34","BookKeeperClusterTestCase.java","117245","91992","209237","","418474"
"2017-11-08 12:27","BookKeeperClusterTestCase.java","127278","112641","239919","","479838"
"2014-05-09 14:04","BookKeeperClusterTestCase.java","90","1109","1199","7","2398"
"2017-07-04 06:27","BookKeeperClusterTestCase.java","114145","73271","187416","","374832"
"2014-07-24 01:41","BookKeeperClusterTestCase.java","797","3420","4217","","8434"
"2014-05-23 18:46","BookKeeperClusterTestCase.java","111","1460","1571","7","3142"
"2017-06-30 00:12","BookKeeperClusterTestCase.java","114007","71172","185179","","370358"
"2016-04-27 09:55","BookKeeperClusterTestCase.java","108158","26534","134692","","269384"
"2015-10-06 10:48","BookKeeperClusterTestCase.java","3552","19295","22847","","45694"
"2014-12-10 19:43","BookKeeperClusterTestCase.java","2616","14867","17483","","34966"
"2012-12-14 20:26","BookieShell.java","9762","62469","72231","2","144462"
"2016-02-09 08:28","BookieShell.java","15733","137878","153611","","307222"
"2016-03-16 05:03","BookieShell.java","48366","67778","116144","","232288"
"2014-12-06 07:47","BookieShell.java","15160","131585","146745","","293490"
"2014-12-06 08:03","BookieShell.java","15160","131789","146949","","293898"
"2012-09-07 07:04","BookieShell.java","5566","34756","40322","2","80644"
"2014-09-29 16:29","BookieShell.java","15133","131205","146338","","292676"
"2014-06-03 12:35","BookieShell.java","14686","121835","136521","7","273042"
"2014-02-05 22:43","BookieShell.java","14481","115889","130370","7","260740"
"2013-10-02 06:54","BookieShell.java","13004","108328","121332","5","242664"
"2015-01-13 13:06","BookieShell.java","15326","133800","149126","","298252"
"2017-06-01 23:58","BookieShell.java","49781","106215","155996","","311992"
"2017-07-07 05:11","BookieShell.java","49924","115273","165197","","330394"
"2013-02-26 04:12","BookieShell.java","12237","99651","111888","4","223776"
"2017-01-11 07:37","BookieShell.java","48583","87164","135747","","271494"
"2016-12-21 01:42","BookieShell.java","48581","86804","135385","","270770"
"2017-01-11 07:34","BookieShell.java","48583","87040","135623","","271246"
"2016-11-30 00:02","BookieShell.java","48561","80885","129446","","258892"
"2017-01-30 23:25","BookieShell.java","48584","87340","135924","","271848"
"2017-03-28 22:35","BookieShell.java","48629","98116","146745","","293490"
"2017-01-30 21:31","BookieShell.java","48583","87231","135814","","271628"
"2017-03-22 22:54","BookieShell.java","48631","93814","142445","","284890"
"2017-05-09 23:06","GarbageCollectorThread.java","111662","40758","152420","","304840"
"2017-11-08 12:27","GarbageCollectorThread.java","132644","99869","232513","","465026"
"2017-03-28 22:39","GarbageCollectorThread.java","111036","38076","149112","","298224"
"2017-01-30 23:25","GarbageCollectorThread.java","110714","26789","137503","","275006"
"2016-05-04 15:55","GarbageCollectorThread.java","105079","5340","110419","","220838"
"2016-03-08 06:49","GarbageCollectorThread.java","149","501","650","","1300"
"2015-09-15 10:38","AbstractConfiguration.java","19212","159793","179005","","358010"
"2011-11-28 19:25","AbstractConfiguration.java","482","3226","3708","","7416"
"2017-03-28 22:40","AbstractConfiguration.java","40848","111623","152471","","304942"
"2012-10-05 16:24","AbstractConfiguration.java","15235","70873","86108","2","172216"
"2012-05-24 07:12","AbstractConfiguration.java","10483","29518","40001","1","80002"
"2012-06-19 12:39","AbstractConfiguration.java","10733","32344","43077","2","86154"
"2012-12-12 11:20","AbstractConfiguration.java","16209","87359","103568","2","207136"
"2017-08-02 00:49","AbstractConfiguration.java","41852","144572","186424","","372848"
"2013-06-12 18:41","AbstractConfiguration.java","18119","131971","150090","5","300180"
"2012-06-13 16:57","AbstractConfiguration.java","10563","31408","41971","","83942"
"2016-07-31 07:53","AbstractConfiguration.java","40719","85568","126287","","252574"
"2017-01-31 02:14","AbstractConfiguration.java","40843","101114","141957","","283914"
"2016-07-31 07:56","AbstractConfiguration.java","40719","85902","126621","","253242"
"2017-05-02 23:04","AbstractConfiguration.java","40855","113451","154306","","308612"
"2017-03-23 00:48","AbstractConfiguration.java","40851","106931","147782","","295564"
"2012-11-30 04:54","AbstractConfiguration.java","16039","85454","101493","2","202986"
"2012-12-08 11:18","Bookie.java","16586","78194","94780","2","189560"
"2012-09-14 15:42","Bookie.java","13586","55893","69479","2","138958"
"2012-10-25 15:35","Bookie.java","16192","67743","83935","2","167870"
"2012-10-26 16:25","Bookie.java","16322","68822","85144","2","170288"
"2017-01-31 04:01","Bookie.java","45308","102659","147967","","295934"
"2017-03-28 22:37","Bookie.java","45319","107477","152796","","305592"
"2016-01-26 22:11","Bookie.java","20415","154890","175305","","350610"
"2015-03-18 07:38","Bookie.java","20208","151431","171639","","343278"
"2015-04-21 09:17","Bookie.java","20207","151532","171739","","343478"
"2012-10-18 16:40","Bookie.java","16104","66518","82622","2","165244"
"2012-12-03 17:59","Bookie.java","16469","78032","94501","2","189002"
"2012-07-04 16:17","Bookie.java","10617","29426","40043","2","80086"
"2012-07-23 23:39","Bookie.java","12171","34376","46547","2","93094"
"2013-06-21 19:26","Bookie.java","18900","124917","143817","5","287634"
"2012-09-07 07:04","Bookie.java","13237","54883","68120","2","136240"
"2014-09-23 17:53","Bookie.java","20110","148276","168386","","336772"
"2017-07-04 06:27","Bookie.java","46411","122536","168947","","337894"
"2017-06-05 22:25","Bookie.java","46330","116669","162999","","325998"
"2014-02-06 09:25","Bookie.java","19626","133498","153124","7","306248"
"2014-04-29 22:07","Bookie.java","19702","137079","156781","7","313562"
"2013-12-06 07:39","Bookie.java","19237","130854","150091","6","300182"
"2012-07-05 14:45","Bookie.java","10631","29922","40553","2","81106"
"2012-05-10 14:47","Bookie.java","9238","18810","28048","1","56096"
"2014-08-02 20:02","Bookie.java","20099","146173","166272","","332544"
"2012-04-17 13:16","Bookie.java","8902","17247","26149","1","52298"
"2012-04-16 16:11","Bookie.java","8528","16461","24989","1","49978"
"2013-10-02 07:01","Bookie.java","19017","126879","145896","5","291792"
"2012-06-19 12:39","Bookie.java","10413","23635","34048","2","68096"
"2017-06-28 23:24","Bookie.java","46367","118659","165026","","330052"
"2017-07-07 08:19","Bookie.java","46404","124492","170896","","341792"
"2013-09-11 00:34","Bookie.java","18995","126656","145651","5","291302"
"2014-01-21 17:26","Bookie.java","19327","132681","152008","6","304016"
"2013-10-12 05:42","Bookie.java","19095","127690","146785","6","293570"
"2013-10-22 16:21","Bookie.java","19214","128576","147790","6","295580"
"2017-05-16 00:31","Bookie.java","45746","111861","157607","","315214"
"2013-07-24 16:55","Bookie.java","18940","126015","144955","5","289910"
"2014-02-05 22:43","Bookie.java","19626","133490","153116","7","306232"
"2014-08-18 23:03","Bookie.java","20099","147641","167740","","335480"
"2014-05-09 14:04","Bookie.java","19702","137720","157422","7","314844"
"2013-06-15 19:05","Bookie.java","18903","124793","143696","5","287392"
"2017-06-01 23:58","Bookie.java","46313","115203","161516","","323032"
"2012-03-29 15:18","Bookie.java","8379","15162","23541","1","47082"
"2012-04-17 12:18","Bookie.java","8561","16683","25244","1","50488"
"2012-03-08 19:24","Bookie.java","529","2411","2940","1","5880"
"2012-02-17 12:50","Bookie.java","36","277","313","1","626"
"2012-03-20 14:09","Bookie.java","8227","14295","22522","1","45044"
"2012-03-08 12:13","Bookie.java","453","2291","2744","1","5488"
"2012-03-13 07:31","Bookie.java","1011","5150","6161","1","12322"
"2012-04-02 12:38","Bookie.java","8521","16280","24801","1","49602"
"2017-08-02 00:49","Bookie.java","47122","141453","188575","","377150"
"2013-12-02 18:45","Bookie.java","19234","130699","149933","6","299866"
"2013-05-04 14:22","Bookie.java","18727","120088","138815","5","277630"
"2012-12-18 13:04","Bookie.java","16863","82823","99686","2","199372"
"2016-11-18 00:18","Bookie.java","45273","89523","134796","","269592"
"2017-03-28 22:35","Bookie.java","45311","107254","152565","","305130"
"2016-07-14 23:02","Bookie.java","45193","81553","126746","","253492"
"2017-06-05 20:30","Bookie.java","46313","115561","161874","","323748"
"2016-11-30 00:02","Bookie.java","45274","90054","135328","","270656"
"2012-12-24 05:50","Bookie.java","17054","83122","100176","2","200352"
"2017-03-22 22:54","Bookie.java","45313","102952","148265","","296530"
"2012-12-24 06:23","Bookie.java","17102","83392","100494","2","200988"
"2017-05-15 19:52","DigestManager.java","48676","103547","152223","","304446"
"2012-07-18 17:00","DigestManager.java","4210","15521","19731","2","39462"
"2017-05-25 14:23","DigestManager.java","48782","105935","154717","","309434"
"2017-01-31 04:01","DigestManager.java","48182","94707","142889","","285778"
"2012-12-08 11:18","Bookie.java","16570","77937","94507","2","189014"
"2012-09-14 15:42","Bookie.java","13570","55636","69206","2","138412"
"2012-10-25 15:35","Bookie.java","16176","67486","83662","2","167324"
"2012-10-26 16:25","Bookie.java","16306","68565","84871","2","169742"
"2017-01-31 04:01","Bookie.java","45319","102429","147748","","295496"
"2017-03-28 22:37","Bookie.java","45330","107247","152577","","305154"
"2016-01-26 22:11","Bookie.java","20426","154660","175086","","350172"
"2015-03-18 07:38","Bookie.java","20219","151201","171420","","342840"
"2015-04-21 09:17","Bookie.java","20218","151302","171520","","343040"
"2012-10-18 16:40","Bookie.java","16088","66261","82349","2","164698"
"2012-12-03 17:59","Bookie.java","16453","77775","94228","2","188456"
"2012-07-04 16:17","Bookie.java","10599","29167","39766","2","79532"
"2012-07-23 23:39","Bookie.java","12155","34119","46274","2","92548"
"2013-06-21 19:26","Bookie.java","18889","124665","143554","5","287108"
"2012-09-07 07:04","Bookie.java","13221","54626","67847","2","135694"
"2014-09-23 17:53","Bookie.java","20109","148034","168143","","336286"
"2017-07-04 06:27","Bookie.java","46428","122312","168740","","337480"
"2017-06-05 22:25","Bookie.java","46347","116445","162792","","325584"
"2014-02-06 09:25","Bookie.java","19619","133250","152869","7","305738"
"2014-04-29 22:07","Bookie.java","19696","136832","156528","7","313056"
"2013-12-06 07:39","Bookie.java","19230","130606","149836","6","299672"
"2012-07-05 14:45","Bookie.java","10615","29665","40280","2","80560"
"2012-05-10 14:47","Bookie.java","9219","18550","27769","1","55538"
"2014-08-02 20:02","Bookie.java","20098","145931","166029","","332058"
"2012-04-17 13:16","Bookie.java","8883","16987","25870","1","51740"
"2012-04-16 16:11","Bookie.java","8511","16203","24714","1","49428"
"2013-10-02 07:01","Bookie.java","19006","126627","145633","5","291266"
"2012-06-19 12:39","Bookie.java","10395","23376","33771","2","67542"
"2017-06-28 23:24","Bookie.java","46384","118435","164819","","329638"
"2017-07-07 08:19","Bookie.java","46421","124268","170689","","341378"
"2013-09-11 00:34","Bookie.java","18984","126404","145388","5","290776"
"2014-01-21 17:26","Bookie.java","19320","132433","151753","6","303506"
"2013-10-12 05:42","Bookie.java","19088","127442","146530","6","293060"
"2013-10-22 16:21","Bookie.java","19207","128328","147535","6","295070"
"2017-05-16 00:31","Bookie.java","45761","111635","157396","","314792"
"2013-07-24 16:55","Bookie.java","18929","125763","144692","5","289384"
"2014-02-05 22:43","Bookie.java","19619","133242","152861","7","305722"
"2014-08-18 23:03","Bookie.java","20098","147399","167497","","334994"
"2014-05-09 14:04","Bookie.java","19696","137473","157169","7","314338"
"2013-06-15 19:05","Bookie.java","18892","124541","143433","5","286866"
"2017-06-01 23:58","Bookie.java","46330","114979","161309","","322618"
"2012-03-29 15:18","Bookie.java","8362","14904","23266","1","46532"
"2012-04-17 12:18","Bookie.java","8544","16425","24969","1","49938"
"2012-03-08 19:24","Bookie.java","493","2134","2627","1","5254"
"2012-03-20 14:09","Bookie.java","8209","14036","22245","1","44490"
"2012-03-08 12:13","Bookie.java","417","2014","2431","1","4862"
"2012-03-13 07:31","Bookie.java","980","4878","5858","1","11716"
"2012-04-02 12:38","Bookie.java","8504","16022","24526","1","49052"
"2017-08-02 00:49","Bookie.java","47143","141233","188376","","376752"
"2013-12-02 18:45","Bookie.java","19227","130451","149678","6","299356"
"2013-05-04 14:22","Bookie.java","18716","119836","138552","5","277104"
"2012-12-18 13:04","Bookie.java","16847","82566","99413","2","198826"
"2016-11-18 00:18","Bookie.java","45284","89293","134577","","269154"
"2017-03-28 22:35","Bookie.java","45322","107024","152346","","304692"
"2016-07-14 23:02","Bookie.java","45204","81323","126527","","253054"
"2017-06-05 20:30","Bookie.java","46330","115337","161667","","323334"
"2016-11-30 00:02","Bookie.java","45285","89824","135109","","270218"
"2012-12-24 05:50","Bookie.java","17038","82865","99903","2","199806"
"2017-03-22 22:54","Bookie.java","45324","102722","148046","","296092"
"2012-12-24 06:23","Bookie.java","17086","83135","100221","2","200442"
"2012-12-08 11:18","Bookie.java","10826","66366","77192","2","154384"
"2012-09-14 15:42","Bookie.java","7577","43816","51393","2","102786"
"2012-10-25 15:35","Bookie.java","10225","55708","65933","2","131866"
"2012-10-26 16:25","Bookie.java","10415","56847","67262","2","134524"
"2017-01-31 04:01","Bookie.java","46615","97898","144513","","289026"
"2017-03-28 22:37","Bookie.java","46641","102731","149372","","298744"
"2016-01-26 22:11","Bookie.java","16019","144426","160445","","320890"
"2015-03-18 07:38","Bookie.java","15766","140921","156687","","313374"
"2015-04-21 09:17","Bookie.java","15765","141022","156787","","313574"
"2012-10-18 16:40","Bookie.java","10128","54474","64602","2","129204"
"2012-12-03 17:59","Bookie.java","10692","66187","76879","2","153758"
"2012-07-04 16:17","Bookie.java","4232","16973","21205","2","42410"
"2012-07-23 23:39","Bookie.java","5882","22019","27901","2","55802"
"2013-06-21 19:26","Bookie.java","13611","113560","127171","5","254342"
"2012-09-07 07:04","Bookie.java","7201","42779","49980","2","99960"
"2014-09-23 17:53","Bookie.java","15575","137673","153248","","306496"
"2017-07-04 06:27","Bookie.java","47872","117929","165801","","331602"
"2017-06-05 22:25","Bookie.java","47770","112041","159811","","319622"
"2014-02-06 09:25","Bookie.java","14994","122798","137792","7","275584"
"2014-04-29 22:07","Bookie.java","15091","126400","141491","7","282982"
"2013-12-06 07:39","Bookie.java","14539","120088","134627","6","269254"
"2012-07-05 14:45","Bookie.java","4249","17472","21721","2","43442"
"2012-05-10 14:47","Bookie.java","1483","4987","6470","1","12940"
"2014-08-02 20:02","Bookie.java","15512","135518","151030","","302060"
"2012-04-17 13:16","Bookie.java","1027","3304","4331","1","8662"
"2012-04-16 16:11","Bookie.java","519","2384","2903","1","5806"
"2013-10-02 07:01","Bookie.java","13738","115532","129270","5","258540"
"2012-06-19 12:39","Bookie.java","2776","9930","12706","2","25412"
"2017-06-28 23:24","Bookie.java","47807","114031","161838","","323676"
"2017-07-07 08:19","Bookie.java","47869","119889","167758","","335516"
"2013-09-11 00:34","Bookie.java","13713","115306","129019","5","258038"
"2014-01-21 17:26","Bookie.java","14640","121926","136566","6","273132"
"2013-10-12 05:42","Bookie.java","14343","116870","131213","6","262426"
"2013-10-22 16:21","Bookie.java","14515","117809","132324","6","264648"
"2017-05-16 00:31","Bookie.java","47134","107181","154315","","308630"
"2013-07-24 16:55","Bookie.java","13653","114660","128313","5","256626"
"2014-02-05 22:43","Bookie.java","14992","122788","137780","7","275560"
"2014-08-18 23:03","Bookie.java","15525","136999","152524","","305048"
"2014-05-09 14:04","Bookie.java","15094","127044","142138","7","284276"
"2013-06-15 19:05","Bookie.java","13607","113429","127036","5","254072"
"2017-06-01 23:58","Bookie.java","47746","110568","158314","","316628"
"2012-03-29 15:18","Bookie.java","300","1015","1315","1","2630"
"2012-04-17 12:18","Bookie.java","646","2700","3346","1","6692"
"2012-04-02 12:38","Bookie.java","488","2179","2667","1","5334"
"2017-08-02 00:49","Bookie.java","48692","136955","185647","","371294"
"2013-12-02 18:45","Bookie.java","14535","119932","134467","6","268934"
"2013-05-04 14:22","Bookie.java","13432","108725","122157","5","244314"
"2012-12-18 13:04","Bookie.java","11114","71006","82120","2","164240"
"2016-11-18 00:18","Bookie.java","46573","84755","131328","","262656"
"2017-03-28 22:35","Bookie.java","46623","102498","149121","","298242"
"2016-07-14 23:02","Bookie.java","46498","76790","123288","","246576"
"2017-06-05 20:30","Bookie.java","47746","110926","158672","","317344"
"2016-11-30 00:02","Bookie.java","46580","85292","131872","","263744"
"2012-12-24 05:50","Bookie.java","11323","71323","82646","2","165292"
"2017-03-22 22:54","Bookie.java","46624","98195","144819","","289638"
"2012-12-24 06:23","Bookie.java","11372","71594","82966","2","165932"
"2017-07-04 06:27","LedgerStorage.java","82514","92679","175193","","350386"
"2017-03-28 22:37","LedgerStorage.java","80680","76878","157558","","315116"
"2016-03-08 06:49","LedgerStorage.java","9157","78686","87843","","175686"
"2017-01-31 04:01","LedgerStorage.java","80590","71981","152571","","305142"
"2016-11-18 00:18","LedgerStorage.java","80536","58826","139362","","278724"
"2013-05-04 14:22","LedgerStorage.java","4140","39541","43681","5","87362"
"2017-05-16 00:31","LedgerStorage.java","81360","81515","162875","","325750"
"2015-09-15 10:38","AbstractConfiguration.java","5889","32618","38507","","77014"
"2017-03-28 22:40","AbstractConfiguration.java","112444","69367","181811","","363622"
"2017-08-02 00:49","AbstractConfiguration.java","117642","106510","224152","","448304"
"2016-07-31 07:53","AbstractConfiguration.java","109566","40563","150129","","300258"
"2017-01-31 02:14","AbstractConfiguration.java","112279","58698","170977","","341954"
"2016-07-31 07:56","AbstractConfiguration.java","109566","40897","150463","","300926"
"2017-05-02 23:04","AbstractConfiguration.java","112858","71602","184460","","368920"
"2017-03-23 00:48","AbstractConfiguration.java","112373","64601","176974","","353948"
"2013-10-22 16:21","LedgerEntryPage.java","14264","114054","128318","6","256636"
"2017-07-04 06:27","LedgerEntryPage.java","49074","115627","164701","","329402"
"2012-05-25 17:13","LedgerEntryPage.java","498","1752","2250","1","4500"
"2016-07-14 23:02","TestClient.java","110113","46631","156744","","313488"
"2017-07-04 06:27","ServerConfiguration.java","10322","51876","62198","","124396"
"2016-04-14 00:51","ServerConfiguration.java","54","346","400","","800"
"2016-04-27 09:55","ServerConfiguration.java","242","1046","1288","","2576"
"2017-05-15 19:52","ServerConfiguration.java","8150","39276","47426","","94852"
"2017-03-22 22:54","ServerConfiguration.java","6767","29835","36602","","73204"
"2017-03-23 00:48","ServerConfiguration.java","6772","29892","36664","","73328"
"2017-01-31 02:11","ServerConfiguration.java","6163","22862","29025","","58050"
"2016-11-09 03:02","ServerConfiguration.java","6043","15570","21613","","43226"
"2016-11-30 00:02","ServerConfiguration.java","6108","16317","22425","","44850"
"2017-06-05 20:30","ServerConfiguration.java","9455","44132","53587","","107174"
"2016-09-10 20:27","ServerConfiguration.java","4345","10083","14428","","28856"
"2017-08-02 00:49","ServerConfiguration.java","14572","74332","88904","","177808"
"2017-10-03 12:31","ServerConfiguration.java","26717","76634","103351","","206702"
"2017-08-16 03:37","ServerConfiguration.java","16974","83367","100341","","200682"
"2017-05-26 12:38","ServerConfiguration.java","8406","41848","50254","","100508"
"2017-07-07 08:19","ServerConfiguration.java","10372","53889","64261","","128522"
"2017-06-28 23:24","ServerConfiguration.java","9827","47548","57375","","114750"
"2017-11-08 12:27","ServerConfiguration.java","29447","97238","126685","","253370"
"2014-02-05 22:43","TestReplicationWorker.java","7029","59285","66314","7","132628"
"2013-05-31 12:02","TestReplicationWorker.java","4635","44817","49452","5","98904"
"2013-06-15 19:05","TestReplicationWorker.java","4735","49017","53752","5","107504"
"2012-12-18 12:00","TestReplicationWorker.java","631","4693","5324","2","10648"
"2013-01-14 16:59","TestReplicationWorker.java","2781","10302","13083","2","26166"
"2016-04-27 09:00","TestReplicationWorker.java","77615","50883","128498","","256996"
"2015-07-10 22:48","TestReplicationWorker.java","8494","78776","87270","","174540"
"2014-07-24 01:41","TestReplicationWorker.java","7632","65646","73278","","146556"
"2016-04-14 00:51","TestBKConfiguration.java","109051","35287","144338","","288676"
"2014-04-29 22:07","TestBKConfiguration.java","2831","11581","14412","7","28824"
"2015-07-10 22:48","ZooKeeperUtil.java","10570","83785","94355","","188710"
"2014-08-18 23:00","ZooKeeperUtil.java","9916","78791","88707","","177414"
"2014-12-10 19:43","ZooKeeperUtil.java","10335","80910","91245","","182490"
"2013-03-25 06:27","ZooKeeperUtil.java","6321","47941","54262","4","108524"
"2016-04-05 21:52","ZooKeeperUtil.java","77336","53477","130813","","261626"
"2017-05-09 23:06","GarbageCollectorThread.java","112771","45508","158279","","316558"
"2017-11-08 12:27","GarbageCollectorThread.java","132826","103692","236518","","473036"
"2017-03-28 22:39","GarbageCollectorThread.java","112187","42868","155055","","310110"
"2017-01-30 23:25","GarbageCollectorThread.java","111895","31611","143506","","287012"
"2016-05-04 15:55","GarbageCollectorThread.java","106379","10281","116660","","233320"
"2016-03-08 06:49","GarbageCollectorThread.java","1555","5548","7103","","14206"
"2016-02-24 00:44","GarbageCollectorThread.java","1407","5048","6455","","12910"
"2017-07-04 06:27","FileInfo.java","4948","36823","41771","","83542"
"2017-01-31 04:01","FileInfo.java","779","13880","14659","","29318"
"2017-03-23 15:55","FileInfo.java","938","14405","15343","","30686"
"2017-06-01 23:58","FileInfo.java","3881","28521","32402","","64804"
"2017-07-17 23:27","FileInfo.java","5220","40202","45422","","90844"
"2017-05-16 00:31","FileInfo.java","2889","24754","27643","","55286"
"2012-12-08 11:18","Bookie.java","16702","76472","93174","2","186348"
"2012-09-14 15:42","Bookie.java","13650","54119","67769","2","135538"
"2012-10-25 15:35","Bookie.java","16271","65984","82255","2","164510"
"2012-10-26 16:25","Bookie.java","16401","67063","83464","2","166928"
"2017-01-31 04:01","Bookie.java","45848","101361","147209","","294418"
"2017-03-28 22:37","Bookie.java","45863","106183","152046","","304092"
"2016-01-26 22:11","Bookie.java","20875","153512","174387","","348774"
"2015-03-18 07:38","Bookie.java","20650","150035","170685","","341370"
"2015-04-21 09:17","Bookie.java","20649","150136","170785","","341570"
"2012-10-18 16:40","Bookie.java","16175","64751","80926","2","161852"
"2012-12-03 17:59","Bookie.java","16580","76305","92885","2","185770"
"2012-07-04 16:17","Bookie.java","10636","27607","38243","2","76486"
"2012-07-23 23:39","Bookie.java","12207","32574","44781","2","89562"
"2013-06-21 19:26","Bookie.java","19218","123397","142615","5","285230"
"2012-09-07 07:04","Bookie.java","13293","53101","66394","2","132788"
"2014-09-23 17:53","Bookie.java","20528","146856","167384","","334768"
"2017-07-04 06:27","Bookie.java","47009","121296","168305","","336610"
"2017-06-05 22:25","Bookie.java","46915","115416","162331","","324662"
"2014-02-06 09:25","Bookie.java","20018","132052","152070","7","304140"
"2014-04-29 22:07","Bookie.java","20108","135647","155755","7","311510"
"2013-12-06 07:39","Bookie.java","19595","129374","148969","6","297938"
"2012-07-05 14:45","Bookie.java","10652","28105","38757","2","77514"
"2012-05-10 14:47","Bookie.java","9183","16917","26100","1","52200"
"2014-08-02 20:02","Bookie.java","20517","144753","165270","","330540"
"2012-04-17 13:16","Bookie.java","8830","15337","24167","1","48334"
"2012-04-16 16:11","Bookie.java","8406","14501","22907","1","45814"
"2013-10-02 07:01","Bookie.java","19338","125362","144700","5","289400"
"2012-06-19 12:39","Bookie.java","10432","21816","32248","2","64496"
"2017-06-28 23:24","Bookie.java","46952","117406","164358","","328716"
"2017-07-07 08:19","Bookie.java","47003","123253","170256","","340512"
"2013-09-11 00:34","Bookie.java","19314","125137","144451","5","288902"
"2014-01-21 17:26","Bookie.java","19696","131212","150908","6","301816"
"2013-10-12 05:42","Bookie.java","19426","126183","145609","6","291218"
"2013-10-22 16:21","Bookie.java","19569","127093","146662","6","293324"
"2017-05-16 00:31","Bookie.java","46334","110611","156945","","313890"
"2013-07-24 16:55","Bookie.java","19259","124496","143755","5","287510"
"2014-02-05 22:43","Bookie.java","20018","132044","152062","7","304124"
"2014-08-18 23:03","Bookie.java","20517","146221","166738","","333476"
"2014-05-09 14:04","Bookie.java","20108","136288","156396","7","312792"
"2013-06-15 19:05","Bookie.java","19221","123273","142494","5","284988"
"2017-06-01 23:58","Bookie.java","46903","113955","160858","","321716"
"2012-03-29 15:18","Bookie.java","8239","13184","21423","1","42846"
"2012-04-17 12:18","Bookie.java","8465","14749","23214","1","46428"
"2012-03-20 14:09","Bookie.java","7962","12192","20154","1","40308"
"2012-03-13 07:31","Bookie.java","610","2911","3521","1","7042"
"2012-04-02 12:38","Bookie.java","8399","14320","22719","1","45438"
"2017-08-02 00:49","Bookie.java","47751","140244","187995","","375990"
"2013-12-02 18:45","Bookie.java","19590","129217","148807","6","297614"
"2013-05-04 14:22","Bookie.java","19039","118562","137601","5","275202"
"2012-12-18 13:04","Bookie.java","16980","81102","98082","2","196164"
"2016-11-18 00:18","Bookie.java","45818","88230","134048","","268096"
"2017-03-28 22:35","Bookie.java","45855","105960","151815","","303630"
"2016-07-14 23:02","Bookie.java","45739","80261","126000","","252000"
"2017-06-05 20:30","Bookie.java","46903","114313","161216","","322432"
"2016-11-30 00:02","Bookie.java","45814","88756","134570","","269140"
"2012-12-24 05:50","Bookie.java","17184","81414","98598","2","197196"
"2017-03-22 22:54","Bookie.java","45856","101657","147513","","295026"
"2012-12-24 06:23","Bookie.java","17233","81685","98918","2","197836"
"2017-06-12 17:20","LedgerManagerTestCase.java","3957","17273","21230","","42460"
"2017-05-16 00:31","LedgerManagerTestCase.java","2479","11243","13722","","27444"
"2017-03-28 22:37","LedgerManagerTestCase.java","375","5182","5557","","11114"
"2017-07-04 06:27","LedgerManagerTestCase.java","4684","23458","28142","","56284"
"2012-12-08 11:18","Bookie.java","16620","74089","90709","2","181418"
"2012-09-14 15:42","Bookie.java","13463","51631","65094","2","130188"
"2012-10-25 15:35","Bookie.java","16086","63498","79584","2","159168"
"2012-10-26 16:25","Bookie.java","16217","64578","80795","2","161590"
"2017-01-31 04:01","Bookie.java","46124","99336","145460","","290920"
"2017-03-28 22:37","Bookie.java","46139","104158","150297","","300594"
"2016-01-26 22:11","Bookie.java","21035","151371","172406","","344812"
"2015-03-18 07:38","Bookie.java","20783","147867","168650","","337300"
"2015-04-21 09:17","Bookie.java","20782","147968","168750","","337500"
"2012-10-18 16:40","Bookie.java","15989","62264","78253","2","156506"
"2012-12-03 17:59","Bookie.java","16486","73910","90396","2","180792"
"2012-07-04 16:17","Bookie.java","10388","25058","35446","2","70892"
"2012-07-23 23:39","Bookie.java","11959","30025","41984","2","83968"
"2013-06-21 19:26","Bookie.java","19160","121038","140198","5","280396"
"2012-09-07 07:04","Bookie.java","13103","50610","63713","2","127426"
"2014-09-23 17:53","Bookie.java","20598","144625","165223","","330446"
"2017-07-04 06:27","Bookie.java","47316","119302","166618","","333236"
"2017-06-05 22:25","Bookie.java","47215","113415","160630","","321260"
"2014-02-06 09:25","Bookie.java","20026","129759","149785","7","299570"
"2014-04-29 22:07","Bookie.java","20122","133360","153482","7","306964"
"2013-12-06 07:39","Bookie.java","19574","127052","146626","6","293252"
"2012-07-05 14:45","Bookie.java","10404","25556","35960","2","71920"
"2012-05-10 14:47","Bookie.java","8924","14357","23281","1","46562"
"2014-08-02 20:02","Bookie.java","20535","142470","163005","","326010"
"2012-04-17 13:16","Bookie.java","8476","12682","21158","1","42316"
"2012-04-16 16:11","Bookie.java","8025","11819","19844","1","39688"
"2013-10-02 07:01","Bookie.java","19279","123002","142281","5","284562"
"2012-06-19 12:39","Bookie.java","10184","19267","29451","2","58902"
"2017-06-28 23:24","Bookie.java","47250","115403","162653","","325306"
"2017-07-07 08:19","Bookie.java","47312","121261","168573","","337146"
"2013-09-11 00:34","Bookie.java","19254","122776","142030","5","284060"
"2014-01-21 17:26","Bookie.java","19675","128890","148565","6","297130"
"2013-10-12 05:42","Bookie.java","19402","123858","143260","6","286520"
"2013-10-22 16:21","Bookie.java","19549","124772","144321","6","288642"
"2017-05-16 00:31","Bookie.java","46620","108596","155216","","310432"
"2013-07-24 16:55","Bookie.java","19199","122135","141334","5","282668"
"2014-02-05 22:43","Bookie.java","20024","129749","149773","7","299546"
"2014-08-18 23:03","Bookie.java","20548","143951","164499","","328998"
"2014-05-09 14:04","Bookie.java","20124","134003","154127","7","308254"
"2013-06-15 19:05","Bookie.java","19155","120906","140061","5","280122"
"2017-06-01 23:58","Bookie.java","47190","111941","159131","","318262"
"2012-03-29 15:18","Bookie.java","7834","10478","18312","1","36624"
"2012-04-17 12:18","Bookie.java","8096","12079","20175","1","40350"
"2012-03-20 14:09","Bookie.java","7553","9482","17035","1","34070"
"2012-04-02 12:38","Bookie.java","7994","11614","19608","1","39216"
"2017-08-02 00:49","Bookie.java","48126","138318","186444","","372888"
"2013-12-02 18:45","Bookie.java","19569","126895","146464","6","292928"
"2013-05-04 14:22","Bookie.java","18981","116203","135184","5","270368"
"2012-12-18 13:04","Bookie.java","16899","78720","95619","2","191238"
"2016-11-18 00:18","Bookie.java","46083","86194","132277","","264554"
"2017-03-28 22:35","Bookie.java","46131","103935","150066","","300132"
"2016-07-14 23:02","Bookie.java","46004","78225","124229","","248458"
"2017-06-05 20:30","Bookie.java","47190","112299","159489","","318978"
"2016-11-30 00:02","Bookie.java","46090","86731","132821","","265642"
"2012-12-24 05:50","Bookie.java","17104","79033","96137","2","192274"
"2017-03-22 22:54","Bookie.java","46132","99632","145764","","291528"
"2012-12-24 06:23","Bookie.java","17153","79304","96457","2","192914"
"2017-03-22 22:54","Cookie.java","67274","83267","150541","","301082"
"2016-11-30 00:02","Cookie.java","67167","70301","137468","","274936"
"2014-02-05 22:43","Cookie.java","11186","83404","94590","7","189180"
"2014-05-09 14:04","Cookie.java","11353","87725","99078","7","198156"
"2014-09-23 17:53","Cookie.java","12034","98554","110588","","221176"
"2014-09-18 06:57","Cookie.java","12016","98480","110496","","220992"
"2014-12-06 08:03","Cookie.java","12069","99508","111577","","223154"
"2012-12-08 11:18","Cookie.java","5137","25099","30236","2","60472"
"2013-02-08 19:08","Cookie.java","7684","65880","73564","4","147128"
"2017-03-22 22:54","Cookie.java","112395","41868","154263","","308526"
"2016-11-30 00:02","Cookie.java","112225","28839","141064","","282128"
"2014-12-06 08:03","Cookie.java","94","1013","1107","","2214"
"2015-04-21 09:17","PendingAddOp.java","15939","139505","155444","","310888"
"2015-10-06 10:48","PendingAddOp.java","16189","141172","157361","","314722"
"2015-10-22 09:22","PendingAddOp.java","16199","142012","158211","","316422"
"2017-06-30 00:12","PendingAddOp.java","48697","115102","163799","","327598"
"2014-01-21 05:19","PendingAddOp.java","14771","120073","134844","6","269688"
"2012-09-12 11:59","PendingAddOp.java","7000","41412","48412","2","96824"
"2014-02-21 19:01","PendingAddOp.java","15209","122477","137686","7","275372"
"2014-02-05 22:43","PendingAddOp.java","15142","121247","136389","7","272778"
"2013-09-11 00:34","PendingAddOp.java","13768","113670","127438","5","254876"
"2013-10-14 18:32","PendingAddOp.java","14536","115465","130001","6","260002"
"2013-04-26 18:38","PendingAddOp.java","13460","106702","120162","5","240324"
"2017-08-02 00:49","PendingAddOp.java","49587","136159","185746","","371492"
"2012-12-27 23:16","PendingAddOp.java","11318","69898","81216","2","162432"
"2017-05-15 19:52","PendingAddOp.java","47971","105909","153880","","307760"
"2017-06-21 21:07","CompactionTest.java","3886","18305","22191","","44382"
"2017-11-08 12:27","CompactionTest.java","35668","80391","116059","","232118"
"2017-05-16 00:31","CompactionTest.java","2320","10796","13116","","26232"
"2017-07-07 08:19","CompactionTest.java","4606","25055","29661","","59322"
"2015-09-15 10:38","GcLedgersTest.java","6071","31144","37215","","74430"
"2016-04-27 09:55","GcLedgersTest.java","109723","37979","147702","","295404"
"2017-03-28 22:37","GcLedgersTest.java","112810","67849","180659","","361318"
"2016-03-08 06:49","GcLedgersTest.java","6398","34768","41166","","82332"
"2017-07-04 06:27","GcLedgersTest.java","115014","84020","199034","","398068"
"2014-07-24 01:41","GcLedgersTest.java","4186","16689","20875","","41750"
"2017-05-16 00:31","GcLedgersTest.java","113731","72727","186458","","372916"
"2014-01-21 05:05","BookieReadWriteTest.java","2440","13365","15805","6","31610"
"2014-07-24 01:41","BookieReadWriteTest.java","4302","22134","26436","","52872"
"2017-05-15 19:52","StabilizeNetworkTopology.java","2924","24826","27750","","55500"
"2017-06-12 17:20","ZkUtils.java","3623","11904","15527","","31054"
"2017-05-15 19:52","LedgerHandle.java","112556","66088","178644","","357288"
"2017-05-02 22:07","LedgerHandle.java","111798","62976","174774","","349548"
"2017-03-23 15:55","LedgerHandle.java","111653","57205","168858","","337716"
"2016-09-10 21:01","LedgerHandle.java","110013","38278","148291","","296582"
"2016-07-11 23:01","LedgerHandle.java","108721","32882","141603","","283206"
"2014-02-05 22:43","LedgerHandle.java","1505","3204","4709","7","9418"
"2014-02-21 19:01","LedgerHandle.java","1688","4550","6238","7","12476"
"2017-05-17 08:57","LedgerHandle.java","112697","66706","179403","","358806"
"2017-05-25 14:23","LedgerHandle.java","112730","68544","181274","","362548"
"2017-06-21 19:50","LedgerHandle.java","113765","72510","186275","","372550"
"2017-06-21 21:00","LedgerHandle.java","113776","73304","187080","","374160"
"2017-06-01 23:58","LedgerHandle.java","113501","70226","183727","","367454"
"2014-01-21 05:19","LedgerHandle.java","326","1222","1548","6","3096"
"2014-09-18 06:47","LedgerHandle.java","3405","19323","22728","","45456"
"2014-12-09 19:57","LedgerHandle.java","3552","20563","24115","","48230"
"2017-07-04 06:27","LedgerHandle.java","114111","78071","192182","","384364"
"2017-06-30 00:12","LedgerHandle.java","113974","75973","189947","","379894"
"2014-05-30 14:01","LedgerHandle.java","2147","8943","11090","7","22180"
"2014-05-30 15:07","LedgerHandle.java","2167","9002","11169","7","22338"
"2016-02-09 08:32","LedgerHandle.java","4874","27316","32190","","64380"
"2016-03-16 05:03","LedgerHandle.java","108378","28081","136459","","272918"
"2015-10-22 09:22","LedgerHandle.java","4743","26150","30893","","61786"
"2015-10-06 10:05","LedgerHandle.java","4712","25063","29775","","59550"
"2017-01-31 04:01","LedgerHandle.java","111542","56728","168270","","336540"
"2015-04-21 09:39","LedgerHandle.java","3968","23148","27116","","54232"
"2015-10-06 11:12","LedgerHandle.java","4715","25306","30021","","60042"
"2014-12-05 14:10","LedgerHandle.java","3503","20065","23568","","47136"
"2017-08-02 00:49","BookieNettyServer.java","14665","74183","88848","","177696"
"2017-06-01 09:47","BookieNettyServer.java","8457","42306","50763","","101526"
"2017-05-15 19:52","BookieNettyServer.java","8171","39055","47226","","94452"
"2016-09-10 20:27","BookieNettyServer.java","4363","9859","14222","","28444"
"2017-01-31 02:14","BookieNettyServer.java","6596","23665","30261","","60522"
"2017-03-23 00:48","BookieNettyServer.java","6791","29669","36460","","72920"
"2017-05-15 19:52","TestGetBookieInfoTimeout.java","2005","5759","7764","","15528"
"2014-06-06 15:29","CompactionTest.java","9208","69950","79158","7","158316"
"2013-10-30 16:23","CompactionTest.java","8000","60069","68069","6","136138"
"2014-01-17 18:13","CompactionTest.java","8120","61413","69533","6","139066"
"2016-03-08 06:49","CompactionTest.java","10885","87502","98387","","196774"
"2015-01-16 15:57","CompactionTest.java","10115","82298","92413","","184826"
"2014-12-10 19:43","CompactionTest.java","10109","80487","90596","","181192"
"2015-04-21 09:55","CompactionTest.java","10159","82783","92942","","185884"
"2016-05-04 15:55","CompactionTest.java","77453","53979","131432","","262864"
"2017-03-22 22:54","CompactionTest.java","78919","77686","156605","","313210"
"2017-06-21 21:07","CompactionTest.java","80414","93600","174014","","348028"
"2014-01-22 14:35","CompactionTest.java","8383","63241","71624","6","143248"
"2017-11-08 12:27","CompactionTest.java","88939","132429","221368","","442736"
"2017-05-16 00:31","CompactionTest.java","79591","86834","166425","","332850"
"2014-01-15 15:58","CompactionTest.java","8090","61027","69117","6","138234"
"2013-10-22 07:44","CompactionTest.java","7894","57990","65884","6","131768"
"2017-07-07 08:19","CompactionTest.java","80594","99810","180404","","360808"
"2013-05-04 14:22","CompactionTest.java","6424","48913","55337","5","110674"
"2012-11-23 11:49","TestBenchmark.java","9246","56807","66053","2","132106"
"2014-02-05 22:43","TestBenchmark.java","14443","116970","131413","7","262826"
"2016-02-09 08:12","TestBenchmark.java","15688","138785","154473","","308946"
"2016-02-23 19:16","LedgerMetadataImpl.java","19805","158874","178679","","357358"
"2012-06-27 15:35","LedgerMetadataImpl.java","10603","33324","43927","2","87854"
"2012-06-19 12:39","LedgerMetadataImpl.java","10418","27934","38352","2","76704"
"2012-09-12 11:59","LedgerMetadataImpl.java","13070","59535","72605","2","145210"
"2013-08-13 14:32","LedgerMetadataImpl.java","18526","130110","148636","5","297272"
"2017-06-01 23:58","LedgerMetadataImpl.java","43273","116457","159730","","319460"
"2013-03-25 18:02","LedgerMetadataImpl.java","18281","123213","141494","4","282988"
"2013-04-26 18:38","LedgerMetadataImpl.java","18282","123577","141859","5","283718"
"2017-07-28 20:12","LedgerMetadataImpl.java","43647","128660","172307","","344614"
"2016-07-11 23:01","LedgerMetadataImpl.java","42649","83269","125918","","251836"
"2012-07-18 17:00","LedgerMetadataImpl.java","12130","38561","50691","2","101382"
"2017-08-02 00:49","BookieNettyServer.java","117723","99339","217062","","434124"
"2017-06-01 09:47","BookieNettyServer.java","112877","68824","181701","","363402"
"2017-05-15 19:52","BookieNettyServer.java","112690","65672","178362","","356724"
"2016-09-10 20:27","BookieNettyServer.java","110111","37705","147816","","295632"
"2017-01-31 02:14","BookieNettyServer.java","111656","50823","162479","","324958"
"2016-04-05 08:45","BookieNettyServer.java","108507","30363","138870","","277740"
"2017-03-23 00:48","BookieNettyServer.java","111769","56745","168514","","337028"
"2016-04-05 18:47","BookieNettyServer.java","108515","30613","139128","","278256"
"2017-03-22 22:54","BookieAccessor.java","111092","67370","178462","","356924"
"2017-06-12 17:20","LedgerManagerTestCase.java","3722","12231","15953","","31906"
"2017-05-16 00:31","LedgerManagerTestCase.java","2203","6160","8363","","16726"
"2017-07-04 06:27","LedgerManagerTestCase.java","4475","18442","22917","","45834"
"2017-07-04 06:27","GcLedgersTest.java","2419","12429","14848","","29696"
"2017-07-04 06:27","FileInfo.java","82514","92679","175193","","350386"
"2014-12-04 12:28","FileInfo.java","7962","70720","78682","","157364"
"2017-01-31 04:01","FileInfo.java","80590","71981","152571","","305142"
"2017-03-23 15:55","FileInfo.java","80671","72428","153099","","306198"
"2016-11-18 00:18","FileInfo.java","80536","58826","139362","","278724"
"2013-05-04 14:22","FileInfo.java","4140","39541","43681","5","87362"
"2017-06-01 23:58","FileInfo.java","82096","85026","167122","","334244"
"2017-07-17 23:27","FileInfo.java","82607","95879","178486","","356972"
"2017-05-16 00:31","FileInfo.java","81360","81515","162875","","325750"
"2013-10-22 16:21","FileInfo.java","5833","49235","55068","6","110136"
"2013-10-11 08:36","FileInfo.java","5517","47611","53128","6","106256"
"2014-02-05 22:43","TestLedgerChecker.java","8505","70628","79133","7","158266"
"2015-04-21 10:19","TestLedgerChecker.java","9752","89555","99307","","198614"
"2014-07-24 01:41","TestLedgerChecker.java","9083","76964","86047","","172094"
"2012-12-08 11:18","Bookie.java","16678","78545","95223","2","190446"
"2012-09-14 15:42","Bookie.java","13678","56244","69922","2","139844"
"2012-10-25 15:35","Bookie.java","16286","68096","84382","2","168764"
"2012-10-26 16:25","Bookie.java","16415","69174","85589","2","171178"
"2017-01-31 04:01","Bookie.java","45367","102977","148344","","296688"
"2017-03-28 22:37","Bookie.java","45377","107794","153171","","306342"
"2016-01-26 22:11","Bookie.java","20474","155208","175682","","351364"
"2015-03-18 07:38","Bookie.java","20270","151752","172022","","344044"
"2015-04-21 09:17","Bookie.java","20269","151853","172122","","344244"
"2012-10-18 16:40","Bookie.java","16198","66871","83069","2","166138"
"2012-12-03 17:59","Bookie.java","16562","78384","94946","2","189892"
"2012-07-04 16:17","Bookie.java","10710","29778","40488","2","80976"
"2012-07-23 23:39","Bookie.java","12260","34724","46984","2","93968"
"2013-06-21 19:26","Bookie.java","18993","125269","144262","5","288524"
"2012-09-07 07:04","Bookie.java","13327","55232","68559","2","137118"
"2014-09-23 17:53","Bookie.java","20184","148609","168793","","337586"
"2017-07-04 06:27","Bookie.java","46452","122836","169288","","338576"
"2017-06-05 22:25","Bookie.java","46381","116979","163360","","326720"
"2014-02-06 09:25","Bookie.java","19708","133839","153547","7","307094"
"2014-04-29 22:07","Bookie.java","19781","137417","157198","7","314396"
"2013-12-06 07:39","Bookie.java","19329","131205","150534","6","301068"
"2012-07-05 14:45","Bookie.java","10720","30270","40990","2","81980"
"2012-05-10 14:47","Bookie.java","9354","19185","28539","1","57078"
"2014-08-02 20:02","Bookie.java","20173","146506","166679","","333358"
"2012-04-17 13:16","Bookie.java","9023","17627","26650","1","53300"
"2012-04-16 16:11","Bookie.java","8651","16843","25494","1","50988"
"2013-10-02 07:01","Bookie.java","19109","127230","146339","5","292678"
"2012-06-19 12:39","Bookie.java","10506","23987","34493","2","68986"
"2017-06-28 23:24","Bookie.java","46414","118965","165379","","330758"
"2017-07-07 08:19","Bookie.java","46445","124792","171237","","342474"
"2013-09-11 00:34","Bookie.java","19087","127007","146094","5","292188"
"2014-01-21 17:26","Bookie.java","19409","133022","152431","6","304862"
"2013-10-12 05:42","Bookie.java","19186","128040","147226","6","294452"
"2013-10-22 16:21","Bookie.java","19306","128927","148233","6","296466"
"2017-05-16 00:31","Bookie.java","45804","112178","157982","","315964"
"2013-07-24 16:55","Bookie.java","19032","126366","145398","5","290796"
"2014-02-05 22:43","Bookie.java","19708","133831","153539","7","307078"
"2014-08-18 23:03","Bookie.java","20173","147974","168147","","336294"
"2014-05-09 14:04","Bookie.java","19781","138058","157839","7","315678"
"2013-06-15 19:05","Bookie.java","18996","125145","144141","5","288282"
"2017-06-01 23:58","Bookie.java","46365","115514","161879","","323758"
"2012-03-29 15:18","Bookie.java","8511","15553","24064","1","48128"
"2012-04-17 12:18","Bookie.java","8684","17065","25749","1","51498"
"2012-03-08 19:24","Bookie.java","685","2826","3511","1","7022"
"2012-02-15 16:11","Bookie.java","169","428","597","1","1194"
"2012-02-17 12:50","Bookie.java","204","704","908","1","1816"
"2012-03-20 14:09","Bookie.java","8360","14687","23047","1","46094"
"2012-03-08 12:13","Bookie.java","615","2712","3327","1","6654"
"2012-03-13 07:31","Bookie.java","1158","5556","6714","1","13428"
"2012-04-02 12:38","Bookie.java","8644","16662","25306","1","50612"
"2017-08-02 00:49","Bookie.java","47162","141752","188914","","377828"
"2013-12-02 18:45","Bookie.java","19326","131050","150376","6","300752"
"2013-05-04 14:22","Bookie.java","18804","120424","139228","5","278456"
"2012-12-18 13:04","Bookie.java","16954","83173","100127","2","200254"
"2016-11-18 00:18","Bookie.java","45332","89841","135173","","270346"
"2017-03-28 22:35","Bookie.java","45369","107571","152940","","305880"
"2016-07-14 23:02","Bookie.java","45252","81871","127123","","254246"
"2017-06-05 20:30","Bookie.java","46365","115872","162237","","324474"
"2016-11-30 00:02","Bookie.java","45333","90372","135705","","271410"
"2012-12-24 05:50","Bookie.java","17145","83472","100617","2","201234"
"2017-03-22 22:54","Bookie.java","45371","103269","148640","","297280"
"2012-12-24 06:23","Bookie.java","17193","83742","100935","2","201870"
"2012-12-08 11:18","Bookie.java","10562","64411","74973","2","149946"
"2012-09-14 15:42","Bookie.java","7293","41841","49134","2","98268"
"2012-10-25 15:35","Bookie.java","9953","53745","63698","2","127396"
"2012-10-26 16:25","Bookie.java","10145","54886","65031","2","130062"
"2017-01-31 04:01","Bookie.java","47503","97095","144598","","289196"
"2017-03-28 22:37","Bookie.java","47528","101927","149455","","298910"
"2016-01-26 22:11","Bookie.java","16203","142919","159122","","318244"
"2015-03-18 07:38","Bookie.java","15940","139404","155344","","310688"
"2015-04-21 09:17","Bookie.java","15939","139505","155444","","310888"
"2012-10-18 16:40","Bookie.java","9845","52500","62345","2","124690"
"2012-12-03 17:59","Bookie.java","10423","64227","74650","2","149300"
"2012-07-04 16:17","Bookie.java","3872","14922","18794","2","37588"
"2012-07-23 23:39","Bookie.java","5530","19976","25506","2","51012"
"2013-06-21 19:26","Bookie.java","13661","111919","125580","5","251160"
"2012-09-07 07:04","Bookie.java","6913","40800","47713","2","95426"
"2014-09-23 17:53","Bookie.java","15743","136150","151893","","303786"
"2017-07-04 06:27","Bookie.java","48766","117132","165898","","331796"
"2017-06-05 22:25","Bookie.java","48653","111233","159886","","319772"
"2014-02-06 09:25","Bookie.java","15144","121257","136401","7","272802"
"2014-04-29 22:07","Bookie.java","15252","124870","140122","7","280244"
"2013-12-06 07:39","Bookie.java","14672","118530","133202","6","266404"
"2012-07-05 14:45","Bookie.java","3889","15421","19310","2","38620"
"2012-05-10 14:47","Bookie.java","1019","2832","3851","1","7702"
"2014-08-02 20:02","Bookie.java","15680","133995","149675","","299350"
"2012-04-17 13:16","Bookie.java","545","1131","1676","1","3352"
"2012-04-16 16:11","Bookie.java","37","211","248","1","496"
"2013-10-02 07:01","Bookie.java","13793","113896","127689","5","255378"
"2012-06-19 12:39","Bookie.java","2403","7866","10269","2","20538"
"2017-06-28 23:24","Bookie.java","48693","113226","161919","","323838"
"2017-07-07 08:19","Bookie.java","48763","119092","167855","","335710"
"2013-09-11 00:34","Bookie.java","13768","113670","127438","5","254876"
"2014-01-21 17:26","Bookie.java","14778","120373","135151","6","270302"
"2013-10-12 05:42","Bookie.java","14475","115311","129786","6","259572"
"2013-10-22 16:21","Bookie.java","14648","116251","130899","6","261798"
"2017-05-16 00:31","Bookie.java","48023","106379","154402","","308804"
"2013-07-24 16:55","Bookie.java","13707","113023","126730","5","253460"
"2014-02-05 22:43","Bookie.java","15142","121247","136389","7","272778"
"2014-08-18 23:03","Bookie.java","15693","135476","151169","","302338"
"2014-05-09 14:04","Bookie.java","15255","125514","140769","7","281538"
"2013-06-15 19:05","Bookie.java","13657","111788","125445","5","250890"
"2017-06-01 23:58","Bookie.java","48634","109765","158399","","316798"
"2012-04-17 12:18","Bookie.java","164","527","691","1","1382"
"2017-08-02 00:49","Bookie.java","49587","136159","185746","","371492"
"2013-12-02 18:45","Bookie.java","14668","118374","133042","6","266084"
"2013-05-04 14:22","Bookie.java","13485","107087","120572","5","241144"
"2012-12-18 13:04","Bookie.java","10871","69072","79943","2","159886"
"2016-11-18 00:18","Bookie.java","47462","83953","131415","","262830"
"2017-03-28 22:35","Bookie.java","47510","101694","149204","","298408"
"2016-07-14 23:02","Bookie.java","47388","75989","123377","","246754"
"2017-06-05 20:30","Bookie.java","48634","110123","158757","","317514"
"2016-11-30 00:02","Bookie.java","47469","84490","131959","","263918"
"2012-12-24 05:50","Bookie.java","11256","69565","80821","2","161642"
"2017-03-22 22:54","Bookie.java","47512","97392","144904","","289808"
"2012-12-24 06:23","Bookie.java","11308","69839","81147","2","162294"
"2017-06-30 00:12","PerChannelBookieClient.java","4267","20740","25007","","50014"
"2017-07-04 06:27","PerChannelBookieClient.java","4538","22972","27510","","55020"
"2017-04-15 13:58","PerChannelBookieClient.java","547","5899","6446","","12892"
"2017-05-15 19:52","PerChannelBookieClient.java","2089","10095","12184","","24368"
"2017-07-28 20:12","PerChannelBookieClient.java","6040","29068","35108","","70216"
"2017-03-28 22:35","PerChannelBookieClient.java","167","4419","4586","","9172"
"2017-08-02 00:49","PerChannelBookieClient.java","9191","45831","55022","","110044"
"2017-06-21 19:58","PerChannelBookieClient.java","3872","17201","21073","","42146"
"2017-06-01 23:58","PerChannelBookieClient.java","3366","14565","17931","","35862"
"2017-04-20 19:55","PerChannelBookieClient.java","560","5933","6493","","12986"
"2015-10-06 10:05","ReadOnlyLedgerHandle.java","3740","22392","26132","","52264"
"2017-01-31 04:01","ReadOnlyLedgerHandle.java","110826","54313","165139","","330278"
"2017-06-30 00:12","ReadOnlyLedgerHandle.java","113338","73638","186976","","373952"
"2017-03-23 15:55","ReadOnlyLedgerHandle.java","110933","54786","165719","","331438"
"2017-06-21 19:58","PendingReadOp.java","81055","88543","169598","","339196"
"2017-06-05 21:48","PendingReadOp.java","80999","87099","168098","","336196"
"2017-06-05 22:13","PendingReadOp.java","81001","87514","168515","","337030"
"2017-06-01 11:42","PendingReadOp.java","80297","85688","165985","","331970"
"2017-06-01 22:39","PendingReadOp.java","80908","85881","166789","","333578"
"2013-09-11 00:34","PendingReadOp.java","4894","49023","53917","5","107834"
"2014-02-05 22:43","PendingReadOp.java","7026","57358","64384","7","128768"
"2013-03-25 18:02","PendingReadOp.java","4105","41211","45316","4","90632"
"2017-05-15 19:52","PendingReadOp.java","80125","82290","162415","","324830"
"2015-04-21 09:17","PendingReadOp.java","8357","76150","84507","","169014"
"2016-02-09 08:39","PendingReadOp.java","9072","80204","89276","","178552"
"2016-02-09 08:32","PendingReadOp.java","9072","80147","89219","","178438"
"2017-07-04 06:27","PendingReadOp.java","81282","93875","175157","","350314"
"2014-01-21 05:19","PendingReadOp.java","6235","55764","61999","6","123998"
"2012-12-24 05:50","LedgerManagerFactory.java","6295","30717","37012","2","74024"
"2017-06-01 23:58","LedgerManagerFactory.java","68549","95793","164342","","328684"
"2015-09-15 10:38","LedgerManagerFactory.java","12707","103253","115960","","231920"
"2017-05-25 14:23","LedgerEntry.java","40482","120479","160961","","321922"
"2017-06-01 11:42","LedgerEntry.java","40521","121462","161983","","323966"
"2017-05-15 19:52","LedgerEntry.java","40437","118152","158589","","317178"
"2014-12-09 19:57","AuditorRollingRestartTest.java","1997","12036","14033","","28066"
"2017-08-16 03:41","RegionAwareEnsemblePlacementPolicy.java","12047","69440","81487","","162974"
"2016-10-20 19:38","RegionAwareEnsemblePlacementPolicy.java","169","154","323","","646"
"2017-03-28 22:35","RegionAwareEnsemblePlacementPolicy.java","1240","19388","20628","","41256"
"2017-07-28 20:12","RegionAwareEnsemblePlacementPolicy.java","6467","43391","49858","","99716"
"2017-01-31 04:01","LedgerDescriptor.java","45367","102977","148344","","296688"
"2017-05-16 00:31","LedgerDescriptor.java","45804","112178","157982","","315964"
"2012-04-17 12:18","LedgerDescriptor.java","8684","17065","25749","1","51498"
"2012-03-20 14:09","LedgerDescriptor.java","8360","14687","23047","1","46094"
"2012-12-18 13:04","LedgerDescriptor.java","16954","83173","100127","2","200254"
"2016-11-18 00:18","LedgerDescriptor.java","45332","89841","135173","","270346"
"2011-11-29 23:55","AsyncCallback.java","3227","9167","12394","","24788"
"2017-07-28 20:12","AsyncCallback.java","40646","132905","173551","","347102"
"2013-05-06 19:32","AsyncCallback.java","18305","131306","149611","5","299222"
"2017-01-31 04:01","AsyncCallback.java","40119","109010","149129","","298258"
"2012-05-25 17:13","AsyncCallback.java","11812","34178","45990","1","91980"
"2017-07-04 06:27","AsyncCallback.java","40417","128082","168499","","336998"
"2017-07-28 20:12","AsyncCallback.java","6172","29540","35712","","71424"
"2017-07-04 06:27","AsyncCallback.java","4684","23458","28142","","56284"
"2017-07-28 20:12","ClientAuthProvider.java","11588","57736","69324","","138648"
"2017-01-31 02:14","ClientAuthProvider.java","6577","23888","30465","","60930"
"2017-08-02 00:49","ClientAuthProvider.java","14572","74332","88904","","177808"
"2012-05-25 17:13","LedgerRecoveryOp.java","9682","20520","30202","1","60404"
"2012-05-10 14:47","LedgerRecoveryOp.java","9250","18834","28084","1","56168"
"2013-10-14 17:38","LedgerRecoveryOp.java","19150","127816","146966","6","293932"
"2017-06-21 19:58","LedgerRecoveryOp.java","46359","117391","163750","","327500"
"2017-06-21 21:00","LedgerRecoveryOp.java","46360","118065","164425","","328850"
"2017-06-21 19:50","LedgerRecoveryOp.java","46358","117280","163638","","327276"
"2013-03-25 18:02","LedgerRecoveryOp.java","18718","119368","138086","4","276172"
"2017-03-22 22:54","Cookie.java","112426","41955","154381","","308762"
"2016-11-30 00:02","Cookie.java","112262","28932","141194","","282388"
"2014-09-23 17:53","Cookie.java","43","99","142","","284"
"2014-12-06 08:03","Cookie.java","135","1110","1245","","2490"
"2017-03-23 00:48","ClientConfiguration.java","67270","82790","150060","","300120"
"2016-04-05 08:45","ClientConfiguration.java","65891","58291","124182","","248364"
"2017-03-28 22:35","ClientConfiguration.java","67268","87040","154308","","308616"
"2017-01-31 02:14","ClientConfiguration.java","67182","76893","144075","","288150"
"2017-04-15 13:58","ClientConfiguration.java","67368","88240","155608","","311216"
"2017-03-23 00:59","ClientConfiguration.java","67270","82802","150072","","300144"
"2017-05-15 19:52","ClientConfiguration.java","67845","91371","159216","","318432"
"2016-10-13 07:50","ClientConfiguration.java","67035","68659","135694","","271388"
"2017-06-21 19:58","ClientConfiguration.java","68593","97442","166035","","332070"
"2013-10-29 05:14","ClientConfiguration.java","10352","77679","88031","6","176062"
"2017-06-05 21:48","ClientConfiguration.java","68546","96007","164553","","329106"
"2017-06-21 19:50","ClientConfiguration.java","68593","97332","165925","","331850"
"2017-08-02 00:49","ClientConfiguration.java","70188","122348","192536","","385072"
"2017-08-01 08:34","ClientConfiguration.java","69704","119279","188983","","377966"
"2013-06-12 18:41","ClientConfiguration.java","9141","72433","81574","5","163148"
"2014-05-27 13:56","ClientConfiguration.java","11314","87722","99036","7","198072"
"2017-06-30 00:12","ClientConfiguration.java","68690","100683","169373","","338746"
"2014-09-18 06:47","ClientConfiguration.java","11899","97811","109710","","219420"
"2017-07-04 06:27","ClientConfiguration.java","68778","102732","171510","","343020"
"2017-01-31 04:01","ClientConfiguration.java","67194","82374","149568","","299136"
"2015-10-06 10:05","ClientConfiguration.java","12662","103007","115669","","231338"
"2015-10-06 10:48","ClientConfiguration.java","12665","103236","115901","","231802"
"2013-02-08 19:08","ClientConfiguration.java","7585","65256","72841","4","145682"
"2012-12-03 10:46","ClientConfiguration.java","4797","24336","29133","2","58266"
"2016-02-09 08:32","ClientConfiguration.java","12771","105207","117978","","235956"
"2014-12-06 07:54","ClientConfiguration.java","12009","98839","110848","","221696"
"2016-08-01 08:04","ClientConfiguration.java","66124","60978","127102","","254204"
"2012-12-13 13:07","ClientConfiguration.java","5258","26619","31877","2","63754"
"2013-05-31 12:02","BookieJournalRollingTest.java","13298","106743","120041","5","240082"
"2013-10-12 05:42","BookieJournalRollingTest.java","14185","114435","128620","6","257240"
"2014-07-24 01:41","BookieJournalRollingTest.java","15260","126537","141797","","283594"
"2017-06-01 23:58","EntryLogger.java","74177","92653","166830","","333660"
"2014-01-21 17:26","EntryLogger.java","7840","70780","78620","6","157240"
"2013-10-02 06:23","EntryLogger.java","6524","63782","70306","5","140612"
"2014-01-22 14:35","EntryLogger.java","7953","71269","79222","6","158444"
"2017-11-08 12:27","EntryLogger.java","82721","134669","217390","","434780"
"2013-10-22 07:44","EntryLogger.java","7432","65986","73418","6","146836"
"2013-05-04 14:22","EntryLogger.java","6070","57017","63087","5","126174"
"2017-01-31 02:11","EntryLogger.java","72734","73590","146324","","292648"
"2017-03-23 00:48","EntryLogger.java","72825","80102","152927","","305854"
"2016-07-14 23:02","EntryLogger.java","71542","57488","129030","","258060"
"2012-12-24 06:23","EntryLogger.java","3180","19056","22236","2","44472"
"2012-12-10 11:04","EntryLogger.java","1951","13244","15195","2","30390"
"2016-02-24 00:44","EntryLogger.java","10308","95031","105339","","210678"
"2015-04-21 10:02","EntryLogger.java","9665","90780","100445","","200890"
"2013-01-04 11:32","EntryLogger.java","3833","21100","24933","2","49866"
"2015-04-21 09:44","EntryLogger.java","9667","90598","100265","","200530"
"2017-06-01 23:58","EntryLogger.java","55214","101888","157102","","314204"
"2014-01-21 17:26","EntryLogger.java","10755","101893","112648","6","225296"
"2013-10-02 06:23","EntryLogger.java","9571","95027","104598","5","209196"
"2014-01-22 14:35","EntryLogger.java","10871","102385","113256","6","226512"
"2017-11-08 12:27","EntryLogger.java","61699","141845","203544","","407088"
"2013-10-22 07:44","EntryLogger.java","10450","97202","107652","6","215304"
"2013-05-04 14:22","EntryLogger.java","9257","88402","97659","5","195318"
"2017-01-31 02:11","EntryLogger.java","53956","83010","136966","","273932"
"2017-03-23 00:48","EntryLogger.java","54015","89490","143505","","287010"
"2016-07-14 23:02","EntryLogger.java","53448","67592","121040","","242080"
"2012-12-24 06:23","EntryLogger.java","6783","50857","57640","2","115280"
"2012-12-10 11:04","EntryLogger.java","5829","45320","51149","2","102298"
"2016-02-24 00:44","EntryLogger.java","12669","125590","138259","","276518"
"2015-04-21 10:02","EntryLogger.java","12120","121433","133553","","267106"
"2012-10-18 16:40","EntryLogger.java","4948","33146","38094","2","76188"
"2013-01-04 11:32","EntryLogger.java","7273","52738","60011","2","120022"
"2015-04-21 09:44","EntryLogger.java","12118","121247","133365","","266730"
"2015-10-06 10:05","BenchBookie.java","5303","29190","34493","","68986"
"2014-02-05 22:43","BenchBookie.java","2293","7528","9821","7","19642"
"2017-05-15 19:52","BenchBookie.java","112991","70059","183050","","366100"
"2016-07-14 23:02","BenchBookie.java","109280","37011","146291","","292582"
"2017-07-04 06:27","ServerConfiguration.java","4958","36985","41943","","83886"
"2017-05-15 19:52","ServerConfiguration.java","2735","24334","27069","","54138"
"2017-03-22 22:54","ServerConfiguration.java","949","14490","15439","","30878"
"2017-03-23 00:48","ServerConfiguration.java","954","14547","15501","","31002"
"2017-01-31 02:11","ServerConfiguration.java","240","7412","7652","","15304"
"2016-11-30 00:02","ServerConfiguration.java","147","829","976","","1952"
"2017-06-05 20:30","ServerConfiguration.java","4068","29218","33286","","66572"
"2017-08-02 00:49","ServerConfiguration.java","9370","59603","68973","","137946"
"2017-10-03 12:31","ServerConfiguration.java","29014","69404","98418","","196836"
"2017-08-16 03:37","ServerConfiguration.java","11794","68660","80454","","160908"
"2017-05-26 12:38","ServerConfiguration.java","2994","26909","29903","","59806"
"2017-07-07 08:19","ServerConfiguration.java","5017","39007","44024","","88048"
"2017-06-28 23:24","ServerConfiguration.java","4445","32639","37084","","74168"
"2017-11-08 12:27","ServerConfiguration.java","32210","90474","122684","","245368"
"2017-07-04 06:27","ServerConfiguration.java","4871","36216","41087","","82174"
"2017-05-15 19:52","ServerConfiguration.java","2617","23534","26151","","52302"
"2017-03-22 22:54","ServerConfiguration.java","831","13690","14521","","29042"
"2017-03-23 00:48","ServerConfiguration.java","836","13747","14583","","29166"
"2017-01-31 02:11","ServerConfiguration.java","94","6584","6678","","13356"
"2017-06-05 20:30","ServerConfiguration.java","3965","28433","32398","","64796"
"2017-08-02 00:49","ServerConfiguration.java","9311","58862","68173","","136346"
"2017-10-03 12:31","ServerConfiguration.java","28963","68671","97634","","195268"
"2017-08-16 03:37","ServerConfiguration.java","11735","67919","79654","","159308"
"2017-05-26 12:38","ServerConfiguration.java","2886","26119","29005","","58010"
"2017-07-07 08:19","ServerConfiguration.java","4931","38239","43170","","86340"
"2017-06-28 23:24","ServerConfiguration.java","4344","31856","36200","","72400"
"2017-11-08 12:27","ServerConfiguration.java","32203","89785","121988","","243976"
"2015-04-21 09:17","PendingAddOp.java","5366","35690","41056","","82112"
"2015-10-06 10:48","PendingAddOp.java","6026","37767","43793","","87586"
"2015-10-22 09:22","PendingAddOp.java","6053","38624","44677","","89354"
"2017-06-30 00:12","PendingAddOp.java","113195","86358","199553","","399106"
"2014-01-21 05:19","PendingAddOp.java","2801","14861","17662","6","35324"
"2014-02-21 19:01","PendingAddOp.java","3869","17895","21764","7","43528"
"2014-02-05 22:43","PendingAddOp.java","3706","16569","20275","7","40550"
"2013-09-11 00:34","PendingAddOp.java","1001","7661","8662","5","17324"
"2013-10-14 18:32","PendingAddOp.java","2134","9821","11955","6","23910"
"2017-08-02 00:49","PendingAddOp.java","116373","109703","226076","","452152"
"2017-05-15 19:52","PendingAddOp.java","111946","76642","188588","","377176"
"2017-06-12 17:20","LedgerManagerTestCase.java","113969","52444","166413","","332826"
"2017-05-16 00:31","LedgerManagerTestCase.java","112686","46609","159295","","318590"
"2016-11-18 00:18","LedgerManagerTestCase.java","110964","23022","133986","","267972"
"2017-01-31 04:01","LedgerManagerTestCase.java","111059","36218","147277","","294554"
"2017-03-28 22:37","LedgerManagerTestCase.java","111298","41264","152562","","305124"
"2016-04-27 09:55","LedgerManagerTestCase.java","105436","8619","114055","","228110"
"2017-07-04 06:27","LedgerManagerTestCase.java","114541","58474","173015","","346030"
"2015-09-15 10:38","BookKeeper.java","5889","32618","38507","","77014"
"2015-10-22 09:22","BookKeeper.java","5923","34032","39955","","79910"
"2017-01-31 04:01","BookKeeper.java","112286","64174","176460","","352920"
"2015-07-10 22:48","BookKeeper.java","5479","31906","37385","","74770"
"2017-06-30 00:12","BookKeeper.java","114422","83123","197545","","395090"
"2014-02-06 09:21","BookKeeper.java","3504","11909","15413","7","30826"
"2014-01-21 05:19","BookKeeper.java","2448","10046","12494","6","24988"
"2013-10-02 06:40","BookKeeper.java","580","2873","3453","5","6906"
"2014-02-21 19:01","BookKeeper.java","3674","13238","16912","7","33824"
"2016-10-13 07:50","BookKeeper.java","112110","50442","162552","","325104"
"2017-06-21 21:00","BookKeeper.java","114248","80478","194726","","389452"
"2017-03-28 22:35","BookKeeper.java","112368","68848","181216","","362432"
"2016-07-11 23:01","BookKeeper.java","109498","40361","149859","","299718"
"2016-10-13 09:27","BookKeeper.java","112227","50545","162772","","325544"
"2017-07-28 20:12","BookKeeper.java","115204","90460","205664","","411328"
"2017-05-15 19:52","BookKeeper.java","113166","73400","186566","","373132"
"2013-09-10 15:14","BookKeeper.java","515","2674","3189","5","6378"
"2011-11-29 23:55","AsyncCallback.java","8365","20686","29051","","58102"
"2017-07-28 20:12","AsyncCallback.java","36438","135078","171516","","343032"
"2013-05-06 19:32","AsyncCallback.java","15876","135258","151134","5","302268"
"2011-10-27 18:26","AsyncCallback.java","5861","12242","18103","","36206"
"2017-01-31 04:01","AsyncCallback.java","36044","111316","147360","","294720"
"2011-09-05 19:38","AsyncCallback.java","4901","10804","15705","","31410"
"2012-05-25 17:13","AsyncCallback.java","10317","39064","49381","1","98762"
"2017-07-04 06:27","AsyncCallback.java","36231","130277","166508","","333016"
"2013-10-14 17:38","LedgerRecoveryOp.java","2237","10253","12490","6","24980"
"2017-06-21 19:58","LedgerRecoveryOp.java","113055","83437","196492","","392984"
"2017-06-21 21:00","LedgerRecoveryOp.java","113060","84115","197175","","394350"
"2017-06-21 19:50","LedgerRecoveryOp.java","113053","83325","196378","","392756"
"2017-08-02 00:49","ClientAuthProvider.java","3657","17269","20926","","41852"
"2017-06-30 00:12","DistributionSchedule.java","46370","120546","166916","","333832"
"2012-09-12 11:59","DistributionSchedule.java","13319","55502","68821","2","137642"
"2012-08-17 12:41","DistributionSchedule.java","12604","43258","55862","2","111724"
"2017-07-04 06:27","ServerConfiguration.java","1095","7972","9067","","18134"
"2017-08-02 00:49","ServerConfiguration.java","6330","31413","37743","","75486"
"2017-10-03 12:31","ServerConfiguration.java","31432","46672","78104","","156208"
"2017-08-16 03:37","ServerConfiguration.java","8800","40516","49316","","98632"
"2017-07-07 08:19","ServerConfiguration.java","1234","10074","11308","","22616"
"2017-06-28 23:24","ServerConfiguration.java","451","3495","3946","","7892"
"2017-11-08 12:27","ServerConfiguration.java","35682","68796","104478","","208956"
"2014-01-22 14:35","BufferedChannel.java","826","5194","6020","6","12040"
"2011-11-28 19:25","BookKeeper.java","482","3226","3708","","7416"
"2015-09-15 10:38","BookKeeper.java","19212","159793","179005","","358010"
"2015-10-22 09:22","BookKeeper.java","19225","161186","180411","","360822"
"2017-01-31 04:01","BookKeeper.java","40857","106597","147454","","294908"
"2012-07-23 23:39","BookKeeper.java","12315","42909","55224","2","110448"
"2012-12-13 13:07","BookKeeper.java","16333","88254","104587","2","209174"
"2015-07-10 22:48","BookKeeper.java","19160","159439","178599","","357198"
"2017-06-30 00:12","BookKeeper.java","41181","123734","164915","","329830"
"2014-02-06 09:21","BookKeeper.java","18694","140951","159645","7","319290"
"2012-06-05 08:00","BookKeeper.java","10532","30162","40694","1","81388"
"2012-06-19 12:39","BookKeeper.java","10733","32344","43077","2","86154"
"2012-09-12 11:59","BookKeeper.java","13182","63742","76924","2","153848"
"2014-01-21 05:19","BookKeeper.java","18410","139860","158270","6","316540"
"2013-10-02 06:40","BookKeeper.java","18201","134346","152547","5","305094"
"2014-02-21 19:01","BookKeeper.java","18731","142147","160878","7","321756"
"2016-10-13 07:50","BookKeeper.java","40728","92912","133640","","267280"
"2017-06-21 21:00","BookKeeper.java","41177","121259","162436","","324872"
"2012-03-01 15:58","BookKeeper.java","1827","11127","12954","1","25908"
"2013-06-12 18:41","BookKeeper.java","18119","131971","150090","5","300180"
"2011-11-29 23:55","BookKeeper.java","872","3661","4533","","9066"
"2013-05-06 19:32","BookKeeper.java","17936","127786","145722","5","291444"
"2013-01-10 19:13","BookKeeper.java","16822","93714","110536","2","221072"
"2017-03-28 22:35","BookKeeper.java","40847","111179","152026","","304052"
"2016-07-11 23:01","BookKeeper.java","40715","85430","126145","","252290"
"2016-10-13 09:27","BookKeeper.java","40810","92980","133790","","267580"
"2017-07-28 20:12","BookKeeper.java","41451","130559","172010","","344020"
"2017-05-15 19:52","BookKeeper.java","41020","115106","156126","","312252"
"2013-09-10 15:14","BookKeeper.java","18175","134186","152361","5","304722"
"2014-12-10 19:43","ReadOnlyBookieTest.java","3698","19218","22916","","45832"
"2016-03-08 06:49","ReadOnlyBookieTest.java","4990","26749","31739","","63478"
"2016-04-14 00:51","ReadOnlyBookieTest.java","108377","29510","137887","","275774"
"2014-07-24 01:41","ReadOnlyBookieTest.java","2067","7959","10026","","20052"
"2016-04-07 21:39","ReadOnlyBookieTest.java","108364","29456","137820","","275640"
"2014-01-21 05:19","PerChannelBookieClient.java","4327","48885","53212","6","106424"
"2013-10-22 07:35","PerChannelBookieClient.java","3901","44105","48006","6","96012"
"2014-01-09 07:30","PerChannelBookieClient.java","4169","47295","51464","6","102928"
"2017-06-30 00:12","PerChannelBookieClient.java","82450","88111","170561","","341122"
"2014-05-27 13:56","PerChannelBookieClient.java","5611","55687","61298","7","122596"
"2017-07-04 06:27","PerChannelBookieClient.java","82554","90176","172730","","345460"
"2017-01-31 04:01","PerChannelBookieClient.java","80502","69350","149852","","299704"
"2015-10-06 10:05","PerChannelBookieClient.java","7374","71387","78761","","157522"
"2016-04-05 18:47","PerChannelBookieClient.java","78883","45193","124076","","248152"
"2017-04-15 13:58","PerChannelBookieClient.java","80690","75230","155920","","311840"
"2017-05-15 19:52","PerChannelBookieClient.java","81261","78455","159716","","319432"
"2016-04-05 08:45","PerChannelBookieClient.java","78881","44949","123830","","247660"
"2017-07-28 20:12","PerChannelBookieClient.java","83195","95411","178606","","357212"
"2017-01-31 02:14","PerChannelBookieClient.java","80488","63867","144355","","288710"
"2017-03-28 22:35","PerChannelBookieClient.java","80574","74014","154588","","309176"
"2017-03-23 00:48","PerChannelBookieClient.java","80580","69768","150348","","300696"
"2014-07-25 00:34","PerChannelBookieClient.java","6210","63151","69361","","138722"
"2017-08-02 00:49","PerChannelBookieClient.java","85615","111443","197058","","394116"
"2017-06-21 19:58","PerChannelBookieClient.java","82277","84794","167071","","334142"
"2017-06-01 23:58","PerChannelBookieClient.java","82087","82474","164561","","329122"
"2013-10-29 05:14","PerChannelBookieClient.java","4121","45116","49237","6","98474"
"2013-06-28 17:27","PerChannelBookieClient.java","2534","40230","42764","5","85528"
"2014-02-21 19:01","PerChannelBookieClient.java","5362","51886","57248","7","114496"
"2014-02-05 22:43","PerChannelBookieClient.java","5201","50562","55763","7","111526"
"2017-04-20 19:55","PerChannelBookieClient.java","80691","75252","155943","","311886"
"2013-09-11 00:34","PerChannelBookieClient.java","2816","41974","44790","5","89580"
"2013-08-20 12:51","PerChannelBookieClient.java","2664","41535","44199","5","88398"
"2014-05-12 08:10","InMemoryMetastoreTable.java","8451","65570","74021","7","148042"
"2013-10-02 06:40","InMemoryMetastoreTable.java","6268","52807","59075","5","118150"
"2015-09-15 10:38","AbstractConfiguration.java","15642","135378","151020","","302040"
"2017-03-28 22:40","AbstractConfiguration.java","48689","98619","147308","","294616"
"2012-10-05 16:24","AbstractConfiguration.java","8053","42846","50899","2","101798"
"2012-06-19 12:39","AbstractConfiguration.java","789","1555","2344","2","4688"
"2012-12-12 11:20","AbstractConfiguration.java","9550","59855","69405","2","138810"
"2017-08-02 00:49","AbstractConfiguration.java","50909","132784","183693","","367386"
"2013-06-12 18:41","AbstractConfiguration.java","12852","105859","118711","5","237422"
"2016-07-31 07:53","AbstractConfiguration.java","48479","72483","120962","","241924"
"2017-01-31 02:14","AbstractConfiguration.java","48583","88009","136592","","273184"
"2016-07-31 07:56","AbstractConfiguration.java","48479","72817","121296","","242592"
"2017-05-02 23:04","AbstractConfiguration.java","48893","100644","149537","","299074"
"2017-03-23 00:48","AbstractConfiguration.java","48635","93870","142505","","285010"
"2012-11-30 04:54","AbstractConfiguration.java","9303","57873","67176","2","134352"
"2016-07-11 23:01","LedgerCreateOp.java","108860","32125","140985","","281970"
"2014-02-05 22:43","LedgerCreateOp.java","1184","1987","3171","7","6342"
"2015-09-15 10:38","LedgerCreateOp.java","4797","23928","28725","","57450"
"2015-04-21 09:17","LedgerCreateOp.java","4052","22316","26368","","52736"
"2015-10-22 09:22","LedgerCreateOp.java","4870","25381","30251","","60502"
"2013-10-22 16:21","BufferedChannel.java","695","1462","2157","6","4314"
"2014-01-22 14:35","BufferedChannel.java","1456","6591","8047","6","16094"
"2017-06-01 11:31","LocalBookKeeper.java","111","1025","1136","","2272"
"2017-06-01 23:58","LocalBookKeeper.java","1085","1962","3047","","6094"
"2016-07-14 23:02","BenchThroughputLatency.java","108277","24991","133268","","266536"
"2017-07-28 20:12","DefaultEnsemblePlacementPolicy.java","6033","24809","30842","","61684"
"2016-07-14 23:02","TestClient.java","40229","88607","128836","","257672"
"2012-09-11 10:30","TestClient.java","14486","68186","82672","2","165344"
"2011-11-17 11:16","TestClient.java","2969","5310","8279","","16558"
"2013-02-08 19:08","TestClient.java","17898","129758","147656","4","295312"
"2012-05-04 20:11","TestClient.java","12011","32807","44818","1","89636"
"2012-05-09 13:20","TestClient.java","12195","33718","45913","1","91826"
"2017-05-26 16:52","Journal.java","8016","39689","47705","","95410"
"2017-03-22 22:54","Journal.java","6252","27531","33783","","67566"
"2016-11-12 03:37","Journal.java","5537","13323","18860","","37720"
"2017-06-01 23:58","Journal.java","8899","41429","50328","","100656"
"2017-05-09 22:24","Journal.java","7065","34940","42005","","84010"
"2017-05-16 00:31","Journal.java","7929","37684","45613","","91226"
"2015-09-15 10:38","BookKeeper.java","19919","157711","177630","","355260"
"2015-10-22 09:22","BookKeeper.java","19932","159104","179036","","358072"
"2017-01-31 04:01","BookKeeper.java","42030","104981","147011","","294022"
"2012-07-23 23:39","BookKeeper.java","12416","40221","52637","2","105274"
"2012-12-13 13:07","BookKeeper.java","16620","85752","102372","2","204744"
"2015-07-10 22:48","BookKeeper.java","19770","157260","177030","","354060"
"2017-06-30 00:12","BookKeeper.java","42578","122342","164920","","329840"
"2014-02-06 09:21","BookKeeper.java","19238","138706","157944","7","315888"
"2012-06-05 08:00","BookKeeper.java","10017","26858","36875","1","73750"
"2012-06-19 12:39","BookKeeper.java","10674","29496","40170","2","80340"
"2012-09-12 11:59","BookKeeper.java","13308","61079","74387","2","148774"
"2014-01-21 05:19","BookKeeper.java","18947","137608","156555","6","313110"
"2013-10-02 06:40","BookKeeper.java","18703","132059","150762","5","301524"
"2014-02-21 19:01","BookKeeper.java","19277","139904","159181","7","318362"
"2016-10-13 07:50","BookKeeper.java","41917","91312","133229","","266458"
"2017-06-21 21:00","BookKeeper.java","42574","119867","162441","","324882"
"2012-03-01 15:58","BookKeeper.java","1036","7547","8583","1","17166"
"2013-06-12 18:41","BookKeeper.java","18604","129667","148271","5","296542"
"2013-05-06 19:32","BookKeeper.java","18417","125478","143895","5","287790"
"2013-01-10 19:13","BookKeeper.java","17295","91398","108693","2","217386"
"2017-03-28 22:35","BookKeeper.java","42032","109575","151607","","303214"
"2016-07-11 23:01","BookKeeper.java","41902","83828","125730","","251460"
"2016-10-13 09:27","BookKeeper.java","41993","91374","133367","","266734"
"2017-07-28 20:12","BookKeeper.java","42839","129158","171997","","343994"
"2017-05-15 19:52","BookKeeper.java","42402","113699","156101","","312202"
"2013-09-10 15:14","BookKeeper.java","18675","131897","150572","5","301144"
"2017-07-28 20:12","SASLClientAuthProvider.java","2875","14704","17579","","35158"
"2011-11-29 23:55","AsyncCallback.java","4157","10575","14732","","29464"
"2017-07-28 20:12","AsyncCallback.java","40782","133519","174301","","348602"
"2013-05-06 19:32","AsyncCallback.java","18733","132212","150945","5","301890"
"2011-10-27 18:26","AsyncCallback.java","1168","1646","2814","","5628"
"2017-01-31 04:01","AsyncCallback.java","40292","109661","149953","","299906"
"2012-05-25 17:13","AsyncCallback.java","12570","35414","47984","1","95968"
"2017-07-04 06:27","AsyncCallback.java","40546","128689","169235","","338470"
"2013-05-04 14:22","LedgerDeleteTest.java","18739","132118","150857","5","301714"
"2011-11-18 11:18","LedgerDeleteTest.java","3592","7221","10813","","21626"
"2012-03-15 10:37","LedgerDeleteTest.java","11307","28799","40106","1","80212"
"2013-05-31 12:02","LedgerDeleteTest.java","18788","132596","151384","5","302768"
"2014-01-22 14:35","LedgerDeleteTest.java","19065","144813","163878","6","327756"
"2012-11-26 16:42","LedgerDeleteTest.java","17067","87957","105024","2","210048"
"2016-03-08 06:49","LedgerDeleteTest.java","19472","166979","186451","","372902"
"2012-06-19 12:39","LedgerDeleteTest.java","12679","37919","50598","2","101196"
"2014-07-24 01:41","LedgerDeleteTest.java","19365","151005","170370","","340740"
"2014-12-10 19:43","ReadOnlyBookieTest.java","3852","19748","23600","","47200"
"2016-03-08 06:49","ReadOnlyBookieTest.java","5141","27276","32417","","64834"
"2016-04-14 00:51","ReadOnlyBookieTest.java","108528","30037","138565","","277130"
"2014-07-24 01:41","ReadOnlyBookieTest.java","2222","8490","10712","","21424"
"2014-01-22 14:35","ReadOnlyBookieTest.java","155","531","686","6","1372"
"2016-04-07 21:39","ReadOnlyBookieTest.java","108515","29983","138498","","276996"
"2012-12-08 11:18","Bookie.java","16402","87992","104394","2","208788"
"2012-09-14 15:42","Bookie.java","13925","66214","80139","2","160278"
"2012-10-25 15:35","Bookie.java","16150","77683","93833","2","187666"
"2012-10-26 16:25","Bookie.java","16184","78666","94850","2","189700"
"2011-11-28 19:25","Bookie.java","1376","5713","7089","","14178"
"2012-02-01 12:06","Bookie.java","2100","8084","10184","1","20368"
"2017-01-31 04:01","Bookie.java","40434","107767","148201","","296402"
"2017-03-28 22:37","Bookie.java","40418","112558","152976","","305952"
"2016-01-26 22:11","Bookie.java","19311","163768","183079","","366158"
"2015-03-18 07:38","Bookie.java","19260","160465","179725","","359450"
"2015-04-21 09:17","Bookie.java","19260","160567","179827","","359654"
"2012-02-01 12:58","Bookie.java","2103","9875","11978","1","23956"
"2012-10-18 16:40","Bookie.java","16062","76458","92520","2","185040"
"2012-12-03 17:59","Bookie.java","16312","87857","104169","2","208338"
"2012-07-04 16:17","Bookie.java","11580","40371","51951","2","103902"
"2012-07-23 23:39","Bookie.java","12946","45133","58079","2","116158"
"2013-06-21 19:26","Bookie.java","18334","134333","152667","5","305334"
"2012-09-07 07:04","Bookie.java","13666","65294","78960","2","157920"
"2014-09-23 17:53","Bookie.java","19233","157381","176614","","353228"
"2017-07-04 06:27","Bookie.java","40764","126871","167635","","335270"
"2017-06-05 22:25","Bookie.java","40707","121028","161735","","323470"
"2014-02-06 09:25","Bookie.java","18833","142687","161520","7","323040"
"2014-04-29 22:07","Bookie.java","18873","146232","165105","7","330210"
"2013-12-06 07:39","Bookie.java","18516","140115","158631","6","317262"
"2012-07-05 14:45","Bookie.java","11585","40858","52443","2","104886"
"2012-05-10 14:47","Bookie.java","10872","30426","41298","1","82596"
"2014-08-02 20:02","Bookie.java","19221","155277","174498","","348996"
"2012-04-17 13:16","Bookie.java","10580","28907","39487","1","78974"
"2012-04-16 16:11","Bookie.java","10255","28170","38425","1","76850"
"2013-10-02 07:01","Bookie.java","18405","136249","154654","5","309308"
"2012-06-19 12:39","Bookie.java","11379","34583","45962","2","91924"
"2017-06-28 23:24","Bookie.java","40737","123011","163748","","327496"
"2017-07-07 08:19","Bookie.java","40769","128839","169608","","339216"
"2013-09-11 00:34","Bookie.java","18387","136030","154417","5","308834"
"2014-01-21 17:26","Bookie.java","18575","141911","160486","6","320972"
"2013-10-12 05:42","Bookie.java","18429","137006","155435","6","310870"
"2013-10-22 16:21","Bookie.java","18504","137848","156352","6","312704"
"2017-05-16 00:31","Bookie.java","40604","116701","157305","","314610"
"2013-07-24 16:55","Bookie.java","18352","135409","153761","5","307522"
"2014-02-05 22:43","Bookie.java","18833","142679","161512","7","323024"
"2014-08-18 23:03","Bookie.java","19221","156745","175966","","351932"
"2014-05-09 14:04","Bookie.java","18873","146873","165746","7","331492"
"2013-06-15 19:05","Bookie.java","18337","134209","152546","5","305092"
"2017-06-01 23:58","Bookie.java","40699","119571","160270","","320540"
"2012-03-29 15:18","Bookie.java","10187","26952","37139","1","74278"
"2012-04-17 12:18","Bookie.java","10281","28385","38666","1","77332"
"2012-03-08 19:24","Bookie.java","2776","14640","17416","1","34832"
"2012-02-15 16:11","Bookie.java","2459","12441","14900","1","29800"
"2012-02-17 12:50","Bookie.java","2463","12686","15149","1","30298"
"2012-03-20 14:09","Bookie.java","10058","26108","36166","1","72332"
"2012-03-08 12:13","Bookie.java","2730","14550","17280","1","34560"
"2012-03-13 07:31","Bookie.java","3162","17283","20445","1","40890"
"2012-02-09 18:14","Bookie.java","2323","12046","14369","1","28738"
"2012-04-02 12:38","Bookie.java","10252","27993","38245","1","76490"
"2017-08-02 00:49","Bookie.java","41403","145716","187119","","374238"
"2011-11-18 11:18","Bookie.java","968","2561","3529","","7058"
"2013-12-02 18:45","Bookie.java","18513","139960","158473","6","316946"
"2013-05-04 14:22","Bookie.java","18148","129491","147639","5","295278"
"2012-12-18 13:04","Bookie.java","16616","92558","109174","2","218348"
"2016-11-18 00:18","Bookie.java","40407","94639","135046","","270092"
"2017-03-28 22:35","Bookie.java","40417","112342","152759","","305518"
"2016-07-14 23:02","Bookie.java","40323","86665","126988","","253976"
"2017-06-05 20:30","Bookie.java","40699","119929","160628","","321256"
"2016-11-30 00:02","Bookie.java","40415","95177","135592","","271184"
"2012-12-24 05:50","Bookie.java","16629","92679","109308","2","218616"
"2017-03-22 22:54","Bookie.java","40422","108043","148465","","296930"
"2012-12-24 06:23","Bookie.java","16673","92945","109618","2","219236"
"2012-12-08 11:18","Bookie.java","16147","86144","102291","2","204582"
"2012-09-14 15:42","Bookie.java","13392","64088","77480","2","154960"
"2012-10-25 15:35","Bookie.java","15890","75830","91720","2","183440"
"2012-10-26 16:25","Bookie.java","15925","76814","92739","2","185478"
"2011-11-28 19:25","Bookie.java","482","3226","3708","","7416"
"2012-02-01 12:06","Bookie.java","1240","5631","6871","1","13742"
"2017-01-31 04:01","Bookie.java","40857","106597","147454","","294908"
"2017-03-28 22:37","Bookie.java","40848","111395","152243","","304486"
"2016-01-26 22:11","Bookie.java","19226","162090","181316","","362632"
"2015-03-18 07:38","Bookie.java","19135","158747","177882","","355764"
"2015-04-21 09:17","Bookie.java","19135","158849","177984","","355968"
"2012-02-01 12:58","Bookie.java","1243","7422","8665","1","17330"
"2012-10-18 16:40","Bookie.java","15802","74605","90407","2","180814"
"2012-12-03 17:59","Bookie.java","16057","86009","102066","2","204132"
"2012-07-04 16:17","Bookie.java","10934","38132","49066","2","98132"
"2012-07-23 23:39","Bookie.java","12315","42909","55224","2","110448"
"2013-06-21 19:26","Bookie.java","18121","132527","150648","5","301296"
"2012-09-07 07:04","Bookie.java","13106","63141","76247","2","152494"
"2014-09-23 17:53","Bookie.java","19106","155661","174767","","349534"
"2017-07-04 06:27","Bookie.java","41212","125726","166938","","333876"
"2017-06-05 22:25","Bookie.java","41154","119882","161036","","322072"
"2014-02-06 09:25","Bookie.java","18694","140955","159649","7","319298"
"2014-04-29 22:07","Bookie.java","18737","144503","163240","7","326480"
"2013-12-06 07:39","Bookie.java","18354","138360","156714","6","313428"
"2012-07-05 14:45","Bookie.java","10940","38620","49560","2","99120"
"2012-05-10 14:47","Bookie.java","10188","28149","38337","1","76674"
"2014-08-02 20:02","Bookie.java","19095","153558","172653","","345306"
"2012-04-17 13:16","Bookie.java","9891","26625","36516","1","73032"
"2012-04-16 16:11","Bookie.java","9560","25882","35442","1","70884"
"2013-10-02 07:01","Bookie.java","18201","134452","152653","5","305306"
"2012-06-19 12:39","Bookie.java","10733","32344","43077","2","86154"
"2017-06-28 23:24","Bookie.java","41183","121864","163047","","326094"
"2017-07-07 08:19","Bookie.java","41214","127691","168905","","337810"
"2013-09-11 00:34","Bookie.java","18181","134231","152412","5","304824"
"2014-01-21 17:26","Bookie.java","18415","140158","158573","6","317146"
"2013-10-12 05:42","Bookie.java","18238","135222","153460","6","306920"
"2013-10-22 16:21","Bookie.java","18334","136085","154419","6","308838"
"2017-05-16 00:31","Bookie.java","41044","115548","156592","","313184"
"2013-07-24 16:55","Bookie.java","18145","133609","151754","5","303508"
"2014-02-05 22:43","Bookie.java","18694","140947","159641","7","319282"
"2014-08-18 23:03","Bookie.java","19095","155026","174121","","348242"
"2014-05-09 14:04","Bookie.java","18737","145144","163881","7","327762"
"2013-06-15 19:05","Bookie.java","18124","132403","150527","5","301054"
"2017-06-01 23:58","Bookie.java","41147","118426","159573","","319146"
"2012-03-29 15:18","Bookie.java","9491","24663","34154","1","68308"
"2012-04-17 12:18","Bookie.java","9586","26097","35683","1","71366"
"2012-03-08 19:24","Bookie.java","1949","12220","14169","1","28338"
"2012-02-15 16:11","Bookie.java","1618","10007","11625","1","23250"
"2012-02-17 12:50","Bookie.java","1622","10252","11874","1","23748"
"2012-03-20 14:09","Bookie.java","9351","23808","33159","1","66318"
"2012-03-08 12:13","Bookie.java","1901","12128","14029","1","28058"
"2012-03-13 07:31","Bookie.java","2379","14907","17286","1","34572"
"2012-02-09 18:14","Bookie.java","1473","9603","11076","1","22152"
"2012-04-02 12:38","Bookie.java","9557","25705","35262","1","70524"
"2017-08-02 00:49","Bookie.java","41852","144572","186424","","372848"
"2013-12-02 18:45","Bookie.java","18351","138205","156556","6","313112"
"2013-05-04 14:22","Bookie.java","17936","127686","145622","5","291244"
"2012-12-18 13:04","Bookie.java","16368","90717","107085","2","214170"
"2016-11-18 00:18","Bookie.java","40809","93448","134257","","268514"
"2017-03-28 22:35","Bookie.java","40847","111179","152026","","304052"
"2016-07-14 23:02","Bookie.java","40717","85466","126183","","252366"
"2017-06-05 20:30","Bookie.java","41146","118783","159929","","319858"
"2016-11-30 00:02","Bookie.java","40822","93991","134813","","269626"
"2012-12-24 05:50","Bookie.java","16384","90841","107225","2","214450"
"2017-03-22 22:54","Bookie.java","40849","106877","147726","","295452"
"2012-12-24 06:23","Bookie.java","16428","91107","107535","2","215070"
"2015-07-10 22:48","ExponentialBackoffRetryPolicy.java","1878","6218","8096","","16192"
"2016-07-11 23:01","LedgerCreateOp.java","48025","71129","119154","","238308"
"2014-02-05 22:43","LedgerCreateOp.java","14036","114678","128714","7","257428"
"2014-01-21 05:19","LedgerCreateOp.java","13620","113459","127079","6","254158"
"2015-09-15 10:38","LedgerCreateOp.java","15234","134204","149438","","298876"
"2015-04-21 09:17","LedgerCreateOp.java","14909","133012","147921","","295842"
"2015-10-22 09:22","LedgerCreateOp.java","15245","135595","150840","","301680"
"2013-08-21 13:19","BookKeeperAdmin.java","9458","76844","86302","5","172604"
"2017-10-17 09:32","BookKeeperAdmin.java","75039","127201","202240","","404480"
"2017-06-01 23:58","BookKeeperAdmin.java","68255","96965","165220","","330440"
"2017-04-11 20:19","BookKeeperAdmin.java","67090","89315","156405","","312810"
"2014-02-21 19:01","BookKeeperAdmin.java","11367","86214","97581","7","195162"
"2014-02-05 22:43","BookKeeperAdmin.java","11271","84955","96226","7","192452"
"2017-07-07 05:11","BookKeeperAdmin.java","68463","106088","174551","","349102"
"2013-02-26 04:12","BookKeeperAdmin.java","8635","68325","76960","4","153920"
"2016-11-09 03:05","BookKeeperAdmin.java","66920","70855","137775","","275550"
"2016-11-30 00:07","BookKeeperAdmin.java","66924","71523","138447","","276894"
"2016-09-10 21:01","BookKeeperAdmin.java","66805","67055","133860","","267720"
"2016-07-14 23:02","BookKeeperAdmin.java","66119","62299","128418","","256836"
"2016-10-13 09:27","BookKeeperAdmin.java","66917","70518","137435","","274870"
"2012-11-30 04:54","BookKeeperAdmin.java","5038","25884","30922","2","61844"
"2013-02-08 19:08","BookKeeperAdmin.java","7782","67444","75226","4","150452"
"2016-03-16 05:03","BookKeeperAdmin.java","65923","57611","123534","","247068"
"2016-03-08 07:18","BookKeeperAdmin.java","12928","108902","121830","","243660"
"2014-12-06 08:03","BookKeeperAdmin.java","12107","101012","113119","","226238"
"2014-04-24 10:43","BookKeeperAdmin.java","11386","88205","99591","7","199182"
"2012-10-05 16:24","BookKeeperAdmin.java","3425","10494","13919","2","27838"
"2012-09-07 07:04","BookKeeperAdmin.java","172","1638","1810","2","3620"
"2014-09-06 07:51","BookKeeperAdmin.java","11998","99766","111764","","223528"
"2013-05-10 12:45","BookKeeperAdmin.java","9173","70684","79857","5","159714"
"2017-07-28 20:12","ClientAuthProvider.java","5908","34745","40653","","81306"
"2017-08-02 00:49","ClientAuthProvider.java","9032","51481","60513","","121026"
"2017-06-12 17:20","LedgerManagerTestCase.java","9652","44944","54596","","109192"
"2017-05-16 00:31","LedgerManagerTestCase.java","8252","38992","47244","","94488"
"2016-11-18 00:18","LedgerManagerTestCase.java","5873","14748","20621","","41242"
"2017-01-31 04:01","LedgerManagerTestCase.java","6443","28419","34862","","69724"
"2017-03-28 22:37","LedgerManagerTestCase.java","6680","33463","40143","","80286"
"2017-07-04 06:27","LedgerManagerTestCase.java","10260","51010","61270","","122540"
"2016-04-27 21:11","ZkLedgerUnderreplicationManager.java","107963","23733","131696","","263392"
"2016-07-14 23:02","ZkLedgerUnderreplicationManager.java","108274","25029","133303","","266606"
"2017-07-07 05:11","ZkLedgerUnderreplicationManager.java","114068","72268","186336","","372672"
"2017-06-28 23:28","ZkLedgerUnderreplicationManager.java","113667","66846","180513","","361026"
"2017-06-01 23:58","ZkLedgerUnderreplicationManager.java","113325","62610","175935","","351870"
"2014-08-18 23:03","ZkLedgerUnderreplicationManager.java","1457","9394","10851","","21702"
"2017-03-28 22:40","ZkLedgerUnderreplicationManager.java","111425","54206","165631","","331262"
"2016-04-27 09:55","ZkLedgerUnderreplicationManager.java","107963","23733","131696","","263392"
"2016-04-27 21:11","ZkLedgerUnderreplicationManager.java","107965","24203","132168","","264336"
"2016-07-14 23:02","ZkLedgerUnderreplicationManager.java","108276","25499","133775","","267550"
"2017-07-07 05:11","ZkLedgerUnderreplicationManager.java","114055","72723","186778","","373556"
"2017-06-28 23:28","ZkLedgerUnderreplicationManager.java","113667","67314","180981","","361962"
"2017-06-01 23:58","ZkLedgerUnderreplicationManager.java","113325","63078","176403","","352806"
"2014-08-18 23:03","ZkLedgerUnderreplicationManager.java","1499","9904","11403","","22806"
"2014-06-03 12:35","ZkLedgerUnderreplicationManager.java","42","510","552","7","1104"
"2017-03-28 22:40","ZkLedgerUnderreplicationManager.java","111425","54674","166099","","332198"
"2016-04-27 09:55","ZkLedgerUnderreplicationManager.java","107965","24203","132168","","264336"
"2014-02-05 22:43","LedgerFragment.java","8777","61615","70392","7","140784"
"2016-02-23 19:16","LedgerMetadataImpl.java","6289","40426","46715","","93430"
"2013-08-13 14:32","LedgerMetadataImpl.java","943","7595","8538","5","17076"
"2017-06-01 23:58","LedgerMetadataImpl.java","112855","81107","193962","","387924"
"2013-04-26 18:38","LedgerMetadataImpl.java","135","498","633","5","1266"
"2017-07-28 20:12","LedgerMetadataImpl.java","113982","94063","208045","","416090"
"2016-07-11 23:01","LedgerMetadataImpl.java","109723","45411","155134","","310268"
"2016-02-23 19:16","LedgerMetadataImpl.java","6189","39963","46152","","92304"
"2013-08-13 14:32","LedgerMetadataImpl.java","834","7123","7957","5","15914"
"2017-06-01 23:58","LedgerMetadataImpl.java","112815","80704","193519","","387038"
"2017-07-28 20:12","LedgerMetadataImpl.java","113944","93662","207606","","415212"
"2016-07-11 23:01","LedgerMetadataImpl.java","109633","44958","154591","","309182"
"2013-01-07 22:53","AuditorBookieTest.java","7171","38215","45386","2","90772"
"2012-12-18 12:00","AuditorBookieTest.java","5862","34682","40544","2","81088"
"2013-06-15 19:05","AuditorBookieTest.java","9358","78398","87756","5","175512"
"2014-02-05 22:43","AuditorBookieTest.java","11253","88267","99520","7","199040"
"2012-10-26 16:25","AuditorBookieTest.java","4687","20337","25024","2","50048"
"2017-07-04 06:27","ServerConfiguration.java","6475","42291","48766","","97532"
"2017-05-15 19:52","ServerConfiguration.java","4280","29668","33948","","67896"
"2017-03-22 22:54","ServerConfiguration.java","2557","19887","22444","","44888"
"2017-03-23 00:48","ServerConfiguration.java","2562","19944","22506","","45012"
"2017-01-31 02:11","ServerConfiguration.java","1850","12811","14661","","29322"
"2016-11-09 03:02","ServerConfiguration.java","1698","5487","7185","","14370"
"2016-11-30 00:02","ServerConfiguration.java","1763","6234","7997","","15994"
"2017-06-05 20:30","ServerConfiguration.java","5600","34539","40139","","80278"
"2017-08-02 00:49","ServerConfiguration.java","10828","64850","75678","","151356"
"2017-10-03 12:31","ServerConfiguration.java","30357","74536","104893","","209786"
"2017-08-16 03:37","ServerConfiguration.java","13249","73904","87153","","174306"
"2017-05-26 12:38","ServerConfiguration.java","4539","32243","36782","","73564"
"2017-07-07 08:19","ServerConfiguration.java","6525","44304","50829","","101658"
"2017-06-28 23:24","ServerConfiguration.java","5972","37955","43927","","87854"
"2017-11-08 12:27","ServerConfiguration.java","33199","95252","128451","","256902"
"2017-01-31 04:01","Bookie.java","111630","57516","169146","","338292"
"2017-03-28 22:37","Bookie.java","111765","62458","174223","","348446"
"2016-01-26 22:11","Bookie.java","4873","27883","32756","","65512"
"2015-03-18 07:38","Bookie.java","4039","23797","27836","","55672"
"2015-04-21 09:17","Bookie.java","4061","23921","27982","","55964"
"2014-09-23 17:53","Bookie.java","3580","20281","23861","","47722"
"2017-07-04 06:27","Bookie.java","114161","78821","192982","","385964"
"2017-06-05 22:25","Bookie.java","113757","72631","186388","","372776"
"2014-02-06 09:25","Bookie.java","1648","4055","5703","7","11406"
"2014-04-29 22:07","Bookie.java","2114","8026","10140","7","20280"
"2013-12-06 07:39","Bookie.java","35","187","222","6","444"
"2014-08-02 20:02","Bookie.java","3072","17681","20753","","41506"
"2017-06-28 23:24","Bookie.java","113852","74679","188531","","377062"
"2017-07-07 08:19","Bookie.java","114157","80780","194937","","389874"
"2014-01-21 17:26","Bookie.java","568","2457","3025","6","6050"
"2017-05-16 00:31","Bookie.java","112757","67407","180164","","360328"
"2014-02-05 22:43","Bookie.java","1643","4042","5685","7","11370"
"2014-08-18 23:03","Bookie.java","3445","19522","22967","","45934"
"2014-05-09 14:04","Bookie.java","2132","8685","10817","7","21634"
"2017-06-01 23:58","Bookie.java","113566","70991","184557","","369114"
"2017-08-02 00:49","Bookie.java","117621","100487","218108","","436216"
"2016-11-18 00:18","Bookie.java","111559","44344","155903","","311806"
"2017-03-28 22:35","Bookie.java","111726","62204","173930","","347860"
"2016-07-14 23:02","Bookie.java","108880","33775","142655","","285310"
"2017-06-05 20:30","Bookie.java","113661","71444","185105","","370210"
"2016-11-30 00:02","Bookie.java","111584","44899","156483","","312966"
"2017-03-22 22:54","Bookie.java","111725","57899","169624","","339248"
"2017-01-31 04:01","Bookie.java","111011","67001","178012","","356024"
"2017-03-28 22:37","Bookie.java","111109","71906","183015","","366030"
"2016-01-26 22:11","Bookie.java","6009","39123","45132","","90264"
"2015-03-18 07:38","Bookie.java","5280","35142","40422","","80844"
"2015-04-21 09:17","Bookie.java","5282","35246","40528","","81056"
"2013-06-21 19:26","Bookie.java","446","5102","5548","5","11096"
"2014-09-23 17:53","Bookie.java","4912","31717","36629","","73258"
"2017-07-04 06:27","Bookie.java","113249","88013","201262","","402524"
"2017-06-05 22:25","Bookie.java","112913","81891","194804","","389608"
"2014-02-06 09:25","Bookie.java","3603","16114","19717","7","39434"
"2014-04-29 22:07","Bookie.java","3970","19986","23956","7","47912"
"2013-12-06 07:39","Bookie.java","2285","12541","14826","6","29652"
"2014-08-02 20:02","Bookie.java","4771","29484","34255","","68510"
"2013-10-02 07:01","Bookie.java","850","7351","8201","5","16402"
"2017-06-28 23:24","Bookie.java","112982","83913","196895","","393790"
"2017-07-07 08:19","Bookie.java","113238","89965","203203","","406406"
"2013-09-11 00:34","Bookie.java","797","7097","7894","5","15788"
"2014-01-21 17:26","Bookie.java","2775","14768","17543","6","35086"
"2013-10-12 05:42","Bookie.java","1843","9077","10920","6","21840"
"2013-10-22 16:21","Bookie.java","2210","10211","12421","6","24842"
"2017-05-16 00:31","Bookie.java","111989","76743","188732","","377464"
"2013-07-24 16:55","Bookie.java","564","6278","6842","5","13684"
"2014-02-05 22:43","Bookie.java","3601","16104","19705","7","39410"
"2014-08-18 23:03","Bookie.java","4784","30965","35749","","71498"
"2014-05-09 14:04","Bookie.java","3988","20645","24633","7","49266"
"2013-06-15 19:05","Bookie.java","429","4958","5387","5","10774"
"2017-06-01 23:58","Bookie.java","112764","80293","193057","","386114"
"2017-08-02 00:49","Bookie.java","116343","109313","225656","","451312"
"2013-12-02 18:45","Bookie.java","2271","12375","14646","6","29292"
"2016-11-18 00:18","Bookie.java","110963","53852","164815","","329630"
"2017-03-28 22:35","Bookie.java","111091","71673","182764","","365528"
"2016-07-14 23:02","Bookie.java","109632","44631","154263","","308526"
"2017-06-05 20:30","Bookie.java","112819","80706","193525","","387050"
"2016-11-30 00:02","Bookie.java","110981","54400","165381","","330762"
"2017-03-22 22:54","Bookie.java","111092","67370","178462","","356924"
"2015-10-06 10:05","BenchBookie.java","3740","22392","26132","","52264"
"2017-05-15 19:52","BenchBookie.java","111874","63707","175581","","351162"
"2016-07-14 23:02","BenchBookie.java","107943","30439","138382","","276764"
"2016-02-09 08:28","BookieShell.java","6530","41261","47791","","95582"
"2016-03-16 05:03","BookieShell.java","109200","41198","150398","","300796"
"2014-12-06 07:47","BookieShell.java","5426","34437","39863","","79726"
"2014-12-06 08:03","BookieShell.java","5432","34647","40079","","80158"
"2014-09-29 16:29","BookieShell.java","5369","34027","39396","","78792"
"2014-06-03 12:35","BookieShell.java","4710","24445","29155","7","58310"
"2014-02-05 22:43","BookieShell.java","4178","18172","22350","7","44700"
"2013-10-02 06:54","BookieShell.java","1560","9470","11030","5","22060"
"2015-01-13 13:06","BookieShell.java","5699","36759","42458","","84916"
"2017-06-01 23:58","BookieShell.java","112502","81522","194024","","388048"
"2017-07-07 05:11","BookieShell.java","112964","90899","203863","","407726"
"2017-01-11 07:37","BookieShell.java","110829","61996","172825","","345650"
"2016-12-21 01:42","BookieShell.java","110826","61635","172461","","344922"
"2017-01-11 07:34","BookieShell.java","110829","61872","172701","","345402"
"2016-11-30 00:02","BookieShell.java","110806","55716","166522","","333044"
"2017-01-30 23:25","BookieShell.java","110830","62172","173002","","346004"
"2017-03-28 22:35","BookieShell.java","110915","72988","183903","","367806"
"2017-01-30 21:31","BookieShell.java","110829","62063","172892","","345784"
"2017-03-22 22:54","BookieShell.java","110916","68685","179601","","359202"
"2015-09-15 10:38","LedgerManager.java","8247","74371","82618","","165236"
"2014-01-17 18:13","LedgerManager.java","5306","51403","56709","6","113418"
"2013-04-04 11:21","LedgerManager.java","3159","37896","41055","5","82110"
"2014-08-02 20:02","ReadEntryProcessor.java","165","795","960","","1920"
"2015-10-06 10:05","ReadEntryProcessor.java","2400","9472","11872","","23744"
"2017-05-15 19:52","ReadEntryProcessor.java","114182","54435","168617","","337234"
"2017-06-01 23:58","ReadEntryProcessor.java","115196","58642","173838","","347676"
"2017-05-16 00:31","ReadEntryProcessor.java","114331","55002","169333","","338666"
"2016-04-29 05:05","ScanAndCompareGarbageCollector.java","13","13","26","","52"
"2017-03-28 22:40","ScanAndCompareGarbageCollector.java","6785","33796","40581","","81162"
"2017-06-30 00:12","PerChannelBookieClient.java","115875","64595","180470","","360940"
"2017-07-04 06:27","PerChannelBookieClient.java","116034","66715","182749","","365498"
"2017-01-31 04:01","PerChannelBookieClient.java","112868","44775","157643","","315286"
"2015-10-06 10:05","PerChannelBookieClient.java","2400","9472","11872","","23744"
"2016-04-05 18:47","PerChannelBookieClient.java","107324","16693","124017","","248034"
"2017-04-15 13:58","PerChannelBookieClient.java","113247","50846","164093","","328186"
"2017-05-15 19:52","PerChannelBookieClient.java","114182","54435","168617","","337234"
"2016-04-05 08:45","PerChannelBookieClient.java","107313","16440","123753","","247506"
"2017-07-28 20:12","PerChannelBookieClient.java","117126","72401","189527","","379054"
"2017-01-31 02:14","PerChannelBookieClient.java","112866","39304","152170","","304340"
"2017-03-28 22:35","PerChannelBookieClient.java","112996","49495","162491","","324982"
"2017-03-23 00:48","PerChannelBookieClient.java","112975","45222","158197","","316394"
"2017-08-02 00:49","PerChannelBookieClient.java","119734","88621","208355","","416710"
"2017-06-21 19:58","PerChannelBookieClient.java","115554","61130","176684","","353368"
"2017-06-01 23:58","PerChannelBookieClient.java","115196","58642","173838","","347676"
"2017-04-20 19:55","PerChannelBookieClient.java","113258","50878","164136","","328272"
"2017-03-28 22:40","AbstractConfiguration.java","6468","32394","38862","","77724"
"2017-08-02 00:49","AbstractConfiguration.java","14280","72151","86431","","172862"
"2017-01-31 02:14","AbstractConfiguration.java","6063","21485","27548","","55096"
"2017-05-02 23:04","AbstractConfiguration.java","7064","34811","41875","","83750"
"2017-03-23 00:48","AbstractConfiguration.java","6266","27497","33763","","67526"
"2017-03-23 00:48","ClientConfiguration.java","171","511","682","","1364"
"2017-03-28 22:35","ClientConfiguration.java","334","4926","5260","","10520"
"2017-04-15 13:58","ClientConfiguration.java","713","6405","7118","","14236"
"2017-03-23 00:59","ClientConfiguration.java","190","542","732","","1464"
"2017-05-15 19:52","ClientConfiguration.java","2252","10598","12850","","25700"
"2017-06-21 19:58","ClientConfiguration.java","4026","17695","21721","","43442"
"2017-06-05 21:48","ClientConfiguration.java","3694","15975","19669","","39338"
"2017-06-21 19:50","ClientConfiguration.java","4020","17579","21599","","43198"
"2017-08-02 00:49","ClientConfiguration.java","9319","46299","55618","","111236"
"2017-08-01 08:34","ClientConfiguration.java","8553","42948","51501","","103002"
"2017-06-30 00:12","ClientConfiguration.java","4415","21228","25643","","51286"
"2017-07-04 06:27","ClientConfiguration.java","4684","23458","28142","","56284"
"2013-05-04 14:22","LedgerDeleteTest.java","12215","100354","112569","5","225138"
"2013-05-31 12:02","LedgerDeleteTest.java","12335","100903","113238","5","226476"
"2014-01-22 14:35","LedgerDeleteTest.java","13732","114240","127972","6","255944"
"2012-11-26 16:42","LedgerDeleteTest.java","8591","54241","62832","2","125664"
"2016-03-08 06:49","LedgerDeleteTest.java","15444","137711","153155","","306310"
"2014-07-24 01:41","LedgerDeleteTest.java","14466","120866","135332","","270664"
"2017-07-04 06:27","FileInfo.java","113249","88013","201262","","402524"
"2014-12-04 12:28","FileInfo.java","4937","32294","37231","","74462"
"2017-01-31 04:01","FileInfo.java","111011","67001","178012","","356024"
"2017-03-23 15:55","FileInfo.java","111100","67456","178556","","357112"
"2016-11-18 00:18","FileInfo.java","110963","53852","164815","","329630"
"2017-06-01 23:58","FileInfo.java","112764","80293","193057","","386114"
"2017-07-17 23:27","FileInfo.java","113332","91203","204535","","409070"
"2017-05-16 00:31","FileInfo.java","111989","76743","188732","","377464"
"2013-10-22 16:21","FileInfo.java","2210","10211","12421","6","24842"
"2013-10-11 08:36","FileInfo.java","1681","8374","10055","6","20110"
"2012-06-19 12:39","BookieRecoveryTest.java","2455","8056","10511","2","21022"
"2012-12-12 11:20","BookieRecoveryTest.java","10678","65818","76496","2","152992"
"2012-09-12 11:59","BookieRecoveryTest.java","7052","41602","48654","2","97308"
"2017-06-30 00:12","BookieRecoveryTest.java","48666","115209","163875","","327750"
"2014-07-24 01:41","BookieRecoveryTest.java","15496","127497","142993","","285986"
"2012-12-04 22:15","BookieRecoveryTest.java","10561","64649","75210","2","150420"
"2017-04-11 20:15","BookieRecoveryTest.java","47540","102322","149862","","299724"
"2017-05-15 19:52","BookieRecoveryTest.java","47939","106015","153954","","307908"
"2012-07-18 17:00","BookieRecoveryTest.java","5526","20042","25568","2","51136"
"2012-12-10 16:02","BookieRecoveryTest.java","10662","64752","75414","2","150828"
"2013-08-13 14:32","BookieRecoveryTest.java","13718","113387","127105","5","254210"
"2014-02-05 22:43","BookieRecoveryTest.java","15124","121367","136491","7","272982"
"2017-08-16 03:41","RackawareEnsemblePlacementPolicy.java","11794","68589","80383","","160766"
"2017-03-28 22:35","RackawareEnsemblePlacementPolicy.java","925","18475","19400","","38800"
"2017-07-28 20:12","RackawareEnsemblePlacementPolicy.java","6211","42537","48748","","97496"
"2016-07-11 23:01","LedgerCreateOp.java","40227","88571","128798","","257596"
"2014-02-05 22:43","LedgerCreateOp.java","19159","145041","164200","7","328400"
"2012-01-18 15:11","LedgerCreateOp.java","4430","12281","16711","1","33422"
"2014-01-21 05:19","LedgerCreateOp.java","19001","144080","163081","6","326162"
"2012-06-19 12:39","LedgerCreateOp.java","12679","37919","50598","2","101196"
"2015-09-15 10:38","LedgerCreateOp.java","19467","163677","183144","","366288"
"2011-11-28 19:25","LedgerCreateOp.java","3825","10198","14023","","28046"
"2015-04-21 09:17","LedgerCreateOp.java","19430","162773","182203","","364406"
"2015-10-22 09:22","LedgerCreateOp.java","19474","165064","184538","","369076"
"2011-11-17 11:16","LedgerCreateOp.java","2969","5310","8279","","16558"
"2013-01-04 11:32","ServerConfiguration.java","11609","72507","84116","2","168232"
"2014-08-02 20:02","ServerConfiguration.java","15335","134626","149961","","299922"
"2014-05-06 12:30","ServerConfiguration.java","14912","125553","140465","7","280930"
"2014-05-15 00:41","ServerConfiguration.java","14915","126470","141385","7","282770"
"2014-09-18 06:47","ServerConfiguration.java","15359","136659","152018","","304036"
"2017-07-04 06:27","ServerConfiguration.java","48415","117757","166172","","332344"
"2014-03-07 13:14","ServerConfiguration.java","14869","123151","138020","7","276040"
"2014-04-29 22:07","ServerConfiguration.java","14912","125506","140418","7","280836"
"2012-10-18 16:40","ServerConfiguration.java","9876","53507","63383","2","126766"
"2012-09-12 20:34","ServerConfiguration.java","7034","42616","49650","2","99300"
"2016-04-14 00:51","ServerConfiguration.java","46957","75037","121994","","243988"
"2015-01-16 15:57","ServerConfiguration.java","15582","139854","155436","","310872"
"2013-02-08 19:08","ServerConfiguration.java","12170","105229","117399","4","234798"
"2016-03-08 06:49","ServerConfiguration.java","16023","144729","160752","","321504"
"2016-01-26 22:11","ServerConfiguration.java","15849","143541","159390","","318780"
"2014-01-21 05:05","ServerConfiguration.java","14401","120333","134734","6","269468"
"2014-03-12 21:26","ServerConfiguration.java","14880","124964","139844","7","279688"
"2016-04-05 18:47","ServerConfiguration.java","46942","74972","121914","","243828"
"2016-04-27 09:55","ServerConfiguration.java","46958","75550","122508","","245016"
"2015-04-21 09:55","ServerConfiguration.java","15604","140317","155921","","311842"
"2015-01-12 15:18","ServerConfiguration.java","15580","138914","154494","","308988"
"2015-04-21 10:02","ServerConfiguration.java","15604","140350","155954","","311908"
"2013-01-14 16:59","ServerConfiguration.java","12023","74369","86392","2","172784"
"2012-11-30 04:54","ServerConfiguration.java","10431","64674","75105","2","150210"
"2017-05-15 19:52","ServerConfiguration.java","47623","106537","154160","","308320"
"2017-03-22 22:54","ServerConfiguration.java","47159","98015","145174","","290348"
"2012-12-11 18:59","ServerConfiguration.java","10655","65854","76509","2","153018"
"2017-03-23 00:48","ServerConfiguration.java","47162","98070","145232","","290464"
"2017-01-31 02:11","ServerConfiguration.java","47136","91623","138759","","277518"
"2013-02-19 16:19","ServerConfiguration.java","12959","105971","118930","4","237860"
"2013-02-19 16:15","ServerConfiguration.java","12959","105952","118911","4","237822"
"2016-04-05 08:45","ServerConfiguration.java","46940","74728","121668","","243336"
"2016-11-09 03:02","ServerConfiguration.java","47113","84428","131541","","263082"
"2016-11-30 00:02","ServerConfiguration.java","47115","85112","132227","","264454"
"2017-06-05 20:30","ServerConfiguration.java","48286","110751","159037","","318074"
"2016-09-10 20:27","ServerConfiguration.java","47038","80564","127602","","255204"
"2017-08-02 00:49","ServerConfiguration.java","49234","136782","186016","","372032"
"2017-10-03 12:31","ServerConfiguration.java","50522","128227","178749","","357498"
"2017-08-16 03:37","ServerConfiguration.java","50058","144239","194297","","388594"
"2013-07-20 19:59","ServerConfiguration.java","13428","113104","126532","5","253064"
"2013-12-02 18:45","ServerConfiguration.java","14357","119039","133396","6","266792"
"2014-05-09 14:04","ServerConfiguration.java","14915","126150","141065","7","282130"
"2017-05-26 12:38","ServerConfiguration.java","47716","108946","156662","","313324"
"2013-06-15 19:05","ServerConfiguration.java","13381","112488","125869","5","251738"
"2014-01-15 15:58","ServerConfiguration.java","14374","119400","133774","6","267548"
"2013-10-22 07:44","ServerConfiguration.java","14245","116430","130675","6","261350"
"2017-07-07 08:19","ServerConfiguration.java","48412","119717","168129","","336258"
"2017-06-28 23:24","ServerConfiguration.java","48347","113856","162203","","324406"
"2017-11-08 12:27","ServerConfiguration.java","51284","146863","198147","","396294"
"2014-01-22 14:35","ServerConfiguration.java","14556","121503","136059","6","272118"
"2013-10-12 05:42","ServerConfiguration.java","14164","115976","130140","6","260280"
"2016-02-09 08:12","BenchReadThroughputLatency.java","4961","29897","34858","","69716"
"2016-07-14 23:02","BenchReadThroughputLatency.java","108873","35735","144608","","289216"
"2012-05-25 17:13","BookieJournalTest.java","9778","20863","30641","1","61282"
"2012-07-05 14:45","BookieJournalTest.java","10720","30270","40990","2","81980"
"2014-04-29 22:07","BookieJournalTest.java","19781","137417","157198","7","314396"
"2014-12-10 19:43","BookieJournalTest.java","20260","149769","170029","","340058"
"2017-05-15 19:52","BookieJournalTest.java","45761","111717","157478","","314956"
"2012-03-13 07:31","BookieJournalTest.java","1158","5556","6714","1","13428"
"2012-02-17 11:18","BookieJournalTest.java","179","634","813","1","1626"
"2012-03-29 15:18","BookieJournalTest.java","8511","15553","24064","1","48128"
"2017-05-16 00:31","BookieJournalTest.java","45804","112178","157982","","315964"
"2013-10-11 08:36","BookieJournalTest.java","19128","127441","146569","6","293138"
"2013-10-12 05:42","BookieJournalTest.java","19186","128040","147226","6","294452"
"2017-03-23 00:48","ClientConfiguration.java","111167","36342","147509","","295018"
"2016-04-05 08:45","ClientConfiguration.java","105296","7351","112647","","225294"
"2017-03-28 22:35","ClientConfiguration.java","111228","40655","151883","","303766"
"2017-01-31 02:14","ClientConfiguration.java","111001","30367","141368","","282736"
"2017-04-15 13:58","ClientConfiguration.java","111514","42041","153555","","307110"
"2017-03-23 00:59","ClientConfiguration.java","111180","36367","147547","","295094"
"2017-05-15 19:52","ClientConfiguration.java","112499","45680","158179","","316358"
"2016-10-13 07:50","ClientConfiguration.java","110746","22025","132771","","265542"
"2017-06-21 19:58","ClientConfiguration.java","114006","52510","166516","","333032"
"2017-06-05 21:48","ClientConfiguration.java","113692","50808","164500","","329000"
"2017-06-21 19:50","ClientConfiguration.java","114001","52395","166396","","332792"
"2017-08-02 00:49","ClientConfiguration.java","118417","80232","198649","","397298"
"2017-08-01 08:34","ClientConfiguration.java","117843","77073","194916","","389832"
"2017-06-30 00:12","ClientConfiguration.java","114336","55984","170320","","340640"
"2017-07-04 06:27","ClientConfiguration.java","114520","58129","172649","","345298"
"2017-01-31 04:01","ClientConfiguration.java","111029","35864","146893","","293786"
"2016-02-09 08:32","ClientConfiguration.java","266","2357","2623","","5246"
"2016-08-01 08:04","ClientConfiguration.java","105848","10357","116205","","232410"
"2012-08-27 19:21","ReflectionUtils.java","4626","29668","34294","2","68588"
"2013-05-31 12:02","BookieJournalRollingTest.java","18086","131201","149287","5","298574"
"2013-10-12 05:42","BookieJournalRollingTest.java","18222","138142","156364","6","312728"
"2012-02-17 12:50","BookieJournalRollingTest.java","2944","14510","17454","1","34908"
"2012-03-15 10:37","BookieJournalRollingTest.java","9669","26468","36137","1","72274"
"2011-11-18 11:18","BookieJournalRollingTest.java","1533","4469","6002","","12004"
"2014-07-24 01:41","BookieJournalRollingTest.java","18751","149698","168449","","336898"
"2012-04-17 13:16","BookieJournalRollingTest.java","10626","30296","40922","1","81844"
"2015-09-15 10:38","BookKeeper.java","5957","36688","42645","","85290"
"2015-10-22 09:22","BookKeeper.java","5991","38102","44093","","88186"
"2017-01-31 04:01","BookKeeper.java","111020","66910","177930","","355860"
"2015-07-10 22:48","BookKeeper.java","5548","35977","41525","","83050"
"2017-06-30 00:12","BookKeeper.java","113153","85856","199009","","398018"
"2014-02-06 09:21","BookKeeper.java","3601","16008","19609","7","39218"
"2014-01-21 05:19","BookKeeper.java","2690","14290","16980","6","33960"
"2013-10-02 06:40","BookKeeper.java","841","7136","7977","5","15954"
"2014-02-21 19:01","BookKeeper.java","3771","17337","21108","7","42216"
"2016-10-13 07:50","BookKeeper.java","110858","53192","164050","","328100"
"2017-06-21 21:00","BookKeeper.java","112979","83211","196190","","392380"
"2013-06-12 18:41","BookKeeper.java","354","4356","4710","5","9420"
"2017-03-28 22:35","BookKeeper.java","111100","71582","182682","","365364"
"2016-07-11 23:01","BookKeeper.java","109574","44439","154013","","308026"
"2016-10-13 09:27","BookKeeper.java","110973","53293","164266","","328532"
"2017-07-28 20:12","BookKeeper.java","113924","93182","207106","","414212"
"2017-05-15 19:52","BookKeeper.java","111899","76135","188034","","376068"
"2013-09-10 15:14","BookKeeper.java","776","6937","7713","5","15426"
"2016-02-09 08:12","BenchReadThroughputLatency.java","5449","31254","36703","","73406"
"2016-07-14 23:02","BenchReadThroughputLatency.java","109280","37011","146291","","292582"
"2013-10-29 05:14","BenchReadThroughputLatency.java","662","1531","2193","6","4386"
"2017-03-23 00:48","ClientConfiguration.java","111162","36111","147273","","294546"
"2016-04-05 08:45","ClientConfiguration.java","105289","7118","112407","","224814"
"2017-03-28 22:35","ClientConfiguration.java","111223","40424","151647","","303294"
"2017-01-31 02:14","ClientConfiguration.java","110996","30136","141132","","282264"
"2017-04-15 13:58","ClientConfiguration.java","111509","41810","153319","","306638"
"2017-03-23 00:59","ClientConfiguration.java","111175","36136","147311","","294622"
"2017-05-15 19:52","ClientConfiguration.java","112498","45453","157951","","315902"
"2016-10-13 07:50","ClientConfiguration.java","110741","21794","132535","","265070"
"2017-06-21 19:58","ClientConfiguration.java","114005","52283","166288","","332576"
"2017-06-05 21:48","ClientConfiguration.java","113691","50581","164272","","328544"
"2017-06-21 19:50","ClientConfiguration.java","114000","52168","166168","","332336"
"2017-08-02 00:49","ClientConfiguration.java","118418","80007","198425","","396850"
"2017-08-01 08:34","ClientConfiguration.java","117844","76848","194692","","389384"
"2017-06-30 00:12","ClientConfiguration.java","114336","55758","170094","","340188"
"2017-07-04 06:27","ClientConfiguration.java","114521","57904","172425","","344850"
"2017-01-31 04:01","ClientConfiguration.java","111024","35633","146657","","293314"
"2016-02-09 08:32","ClientConfiguration.java","259","2124","2383","","4766"
"2016-08-01 08:04","ClientConfiguration.java","105843","10126","115969","","231938"
"2017-11-08 12:27","CompactionTest.java","35439","65743","101182","","202364"
"2017-07-07 08:19","CompactionTest.java","875","6905","7780","","15560"
"2017-05-25 14:23","LedgerFragmentReplicator.java","64090","97748","161838","","323676"
"2014-02-05 22:43","LedgerFragmentReplicator.java","10685","90228","100913","7","201826"
"2014-02-21 19:01","LedgerFragmentReplicator.java","10780","91486","102266","7","204532"
"2016-09-10 21:01","LedgerFragmentReplicator.java","63274","69383","132657","","265314"
"2012-09-04 10:39","LedgerFragmentReplicator.java","459","6421","6880","2","13760"
"2012-10-05 16:24","LedgerFragmentReplicator.java","3417","16345","19762","2","39524"
"2013-08-22 16:40","ZkUtils.java","9368","75302","84670","5","169340"
"2017-06-12 17:20","ZkUtils.java","68573","97594","166167","","332334"
"2012-12-24 05:50","ZkUtils.java","6295","30717","37012","2","74024"
"2017-03-28 22:40","ZkUtils.java","67349","88089","155438","","310876"
"2012-06-19 12:39","BookieRecoveryTest.java","11001","35278","46279","2","92558"
"2012-12-12 11:20","BookieRecoveryTest.java","16046","89862","105908","2","211816"
"2012-09-12 11:59","BookieRecoveryTest.java","13339","66565","79904","2","159808"
"2017-06-30 00:12","BookieRecoveryTest.java","40149","125368","165517","","331034"
"2014-07-24 01:41","BookieRecoveryTest.java","18541","149218","167759","","335518"
"2011-11-28 19:25","BookieRecoveryTest.java","1465","6875","8340","","16680"
"2011-11-16 17:05","BookieRecoveryTest.java","128","863","991","","1982"
"2012-12-04 22:15","BookieRecoveryTest.java","15979","88743","104722","2","209444"
"2017-04-11 20:15","BookieRecoveryTest.java","39855","113313","153168","","306336"
"2017-05-15 19:52","BookieRecoveryTest.java","40018","116770","156788","","313576"
"2012-07-18 17:00","BookieRecoveryTest.java","12526","45718","58244","2","116488"
"2012-12-10 16:02","BookieRecoveryTest.java","16033","88799","104832","2","209664"
"2012-03-31 10:58","BookieRecoveryTest.java","9923","28599","38522","1","77044"
"2011-11-18 11:18","BookieRecoveryTest.java","1065","3731","4796","","9592"
"2012-02-13 15:46","BookieRecoveryTest.java","2522","13565","16087","1","32174"
"2013-08-13 14:32","BookieRecoveryTest.java","17912","136257","154169","5","308338"
"2014-02-05 22:43","BookieRecoveryTest.java","18324","143243","161567","7","323134"
"2012-06-19 12:39","BookieRecoveryTest.java","10733","32344","43077","2","86154"
"2012-12-12 11:20","BookieRecoveryTest.java","16209","87359","103568","2","207136"
"2012-09-12 11:59","BookieRecoveryTest.java","13182","63742","76924","2","153848"
"2017-06-30 00:12","BookieRecoveryTest.java","41181","123734","164915","","329830"
"2014-07-24 01:41","BookieRecoveryTest.java","18947","146958","165905","","331810"
"2011-11-28 19:25","BookieRecoveryTest.java","482","3226","3708","","7416"
"2012-12-04 22:15","BookieRecoveryTest.java","16140","86238","102378","2","204756"
"2017-04-11 20:15","BookieRecoveryTest.java","40848","111640","152488","","304976"
"2017-05-15 19:52","BookieRecoveryTest.java","41020","115106","156126","","312252"
"2012-07-18 17:00","BookieRecoveryTest.java","12283","42809","55092","2","110184"
"2012-12-10 16:02","BookieRecoveryTest.java","16196","86296","102492","2","204984"
"2012-03-31 10:58","BookieRecoveryTest.java","9542","25552","35094","1","70188"
"2012-02-13 15:46","BookieRecoveryTest.java","1609","9986","11595","1","23190"
"2013-08-13 14:32","BookieRecoveryTest.java","18156","133835","151991","5","303982"
"2014-02-05 22:43","BookieRecoveryTest.java","18694","140947","159641","7","319282"
"2017-10-17 09:32","BookKeeperAdmin.java","125990","101333","227323","","454646"
"2017-06-01 23:58","BookKeeperAdmin.java","113452","65343","178795","","357590"
"2017-04-11 20:19","BookKeeperAdmin.java","111674","57080","168754","","337508"
"2017-07-07 05:11","BookKeeperAdmin.java","114166","74972","189138","","378276"
"2016-11-09 03:05","BookKeeperAdmin.java","111284","38400","149684","","299368"
"2016-11-30 00:07","BookKeeperAdmin.java","111330","39110","150440","","300880"
"2016-09-10 21:01","BookKeeperAdmin.java","109704","33135","142839","","285678"
"2016-07-14 23:02","BookKeeperAdmin.java","108468","27829","136297","","272594"
"2016-10-13 09:27","BookKeeperAdmin.java","111270","38052","149322","","298644"
"2016-03-16 05:03","BookKeeperAdmin.java","108049","22918","130967","","261934"
"2016-03-08 07:18","BookKeeperAdmin.java","4028","23183","27211","","54422"
"2014-12-06 08:03","BookKeeperAdmin.java","2288","14374","16662","","33324"
"2014-09-06 07:51","BookKeeperAdmin.java","1805","12754","14559","","29118"
"2015-04-21 09:17","PendingAddOp.java","7550","72536","80086","","160172"
"2015-10-06 10:48","PendingAddOp.java","8201","74604","82805","","165610"
"2015-10-22 09:22","PendingAddOp.java","8224","75457","83681","","167362"
"2017-06-30 00:12","PendingAddOp.java","82036","89861","171897","","343794"
"2014-01-21 05:19","PendingAddOp.java","5292","52014","57306","6","114612"
"2014-02-21 19:01","PendingAddOp.java","6232","54920","61152","7","122304"
"2014-02-05 22:43","PendingAddOp.java","6098","53623","59721","7","119442"
"2013-09-11 00:34","PendingAddOp.java","3912","45234","49146","5","98292"
"2013-10-14 18:32","PendingAddOp.java","4962","47311","52273","6","104546"
"2013-04-26 18:38","PendingAddOp.java","3119","37781","40900","5","81800"
"2017-08-02 00:49","PendingAddOp.java","85204","113196","198400","","396800"
"2017-05-15 19:52","PendingAddOp.java","80877","80235","161112","","322224"
"2017-07-28 20:12","EnsemblePlacementPolicy.java","6033","24809","30842","","61684"
"2016-07-14 23:02","TestClient.java","47482","75064","122546","","245092"
"2012-09-11 10:30","TestClient.java","6531","39435","45966","2","91932"
"2013-02-08 19:08","TestClient.java","12094","103158","115252","4","230504"
"2012-05-09 13:20","TestClient.java","335","1062","1397","1","2794"
"2017-03-28 22:40","AbstractConfiguration.java","491","10995","11486","","22972"
"2017-08-02 00:49","AbstractConfiguration.java","9032","51481","60513","","121026"
"2017-05-02 23:04","AbstractConfiguration.java","1111","13436","14547","","29094"
"2017-03-23 00:48","AbstractConfiguration.java","250","6059","6309","","12618"
"2013-01-04 11:32","ServerConfiguration.java","17370","85066","102436","2","204872"
"2014-08-02 20:02","ServerConfiguration.java","20101","146190","166291","","332582"
"2014-05-06 12:30","ServerConfiguration.java","19703","137142","156845","7","313690"
"2014-05-15 00:41","ServerConfiguration.java","19703","138056","157759","7","315518"
"2014-09-18 06:47","ServerConfiguration.java","20112","148210","168322","","336644"
"2017-07-04 06:27","ServerConfiguration.java","46405","122545","168950","","337900"
"2014-03-07 13:14","ServerConfiguration.java","19669","134749","154418","7","308836"
"2014-04-29 22:07","ServerConfiguration.java","19703","137095","156798","7","313596"
"2012-10-18 16:40","ServerConfiguration.java","16106","66535","82641","2","165282"
"2012-09-12 20:34","ServerConfiguration.java","13312","55692","69004","2","138008"
"2016-04-14 00:51","ServerConfiguration.java","45150","80028","125178","","250356"
"2015-01-16 15:57","ServerConfiguration.java","20200","151270","171470","","342940"
"2013-02-08 19:08","ServerConfiguration.java","17700","117557","135257","4","270514"
"2016-03-08 06:49","ServerConfiguration.java","20408","155912","176320","","352640"
"2016-01-26 22:11","ServerConfiguration.java","20415","154905","175320","","350640"
"2014-01-21 05:05","ServerConfiguration.java","19270","132000","151270","6","302540"
"2014-03-12 21:26","ServerConfiguration.java","19677","136559","156236","7","312472"
"2016-04-05 18:47","ServerConfiguration.java","45135","79963","125098","","250196"
"2016-04-27 09:55","ServerConfiguration.java","45151","80541","125692","","251384"
"2015-04-21 09:55","ServerConfiguration.java","20210","151721","171931","","343862"
"2015-01-12 15:18","ServerConfiguration.java","20200","150332","170532","","341064"
"2015-04-21 10:02","ServerConfiguration.java","20211","151755","171966","","343932"
"2013-01-14 16:59","ServerConfiguration.java","17573","86717","104290","2","208580"
"2012-11-30 04:54","ServerConfiguration.java","16449","77490","93939","2","187878"
"2017-05-15 19:52","ServerConfiguration.java","45703","111415","157118","","314236"
"2017-03-22 22:54","ServerConfiguration.java","45313","102967","148280","","296560"
"2012-12-11 18:59","ServerConfiguration.java","16652","78649","95301","2","190602"
"2017-03-23 00:48","ServerConfiguration.java","45315","103021","148336","","296672"
"2017-01-31 02:11","ServerConfiguration.java","45296","96581","141877","","283754"
"2013-02-19 16:19","ServerConfiguration.java","18488","118298","136786","4","273572"
"2013-02-19 16:15","ServerConfiguration.java","18488","118279","136767","4","273534"
"2016-04-05 08:45","ServerConfiguration.java","45133","79719","124852","","249704"
"2016-11-09 03:02","ServerConfiguration.java","45275","89388","134663","","269326"
"2016-11-30 00:02","ServerConfiguration.java","45275","90070","135345","","270690"
"2017-06-05 20:30","ServerConfiguration.java","46307","115570","161877","","323754"
"2016-09-10 20:27","ServerConfiguration.java","45199","85523","130722","","261444"
"2012-03-29 15:18","ServerConfiguration.java","8386","15184","23570","1","47140"
"2012-02-24 19:08","ServerConfiguration.java","154","926","1080","1","2160"
"2017-08-02 00:49","ServerConfiguration.java","47115","141461","188576","","377152"
"2017-10-03 12:31","ServerConfiguration.java","48298","132801","181099","","362198"
"2017-08-16 03:37","ServerConfiguration.java","47898","148877","196775","","393550"
"2013-07-20 19:59","ServerConfiguration.java","18939","125413","144352","5","288704"
"2013-12-02 18:45","ServerConfiguration.java","19237","130717","149954","6","299908"
"2012-03-08 12:13","ServerConfiguration.java","467","2320","2787","1","5574"
"2014-05-09 14:04","ServerConfiguration.java","19703","137736","157439","7","314878"
"2017-05-26 12:38","ServerConfiguration.java","45786","113814","159600","","319200"
"2013-06-15 19:05","ServerConfiguration.java","18904","124809","143713","5","287426"
"2014-01-15 15:58","ServerConfiguration.java","19243","131067","150310","6","300620"
"2013-10-22 07:44","ServerConfiguration.java","19149","128132","147281","6","294562"
"2017-07-07 08:19","ServerConfiguration.java","46398","124501","170899","","341798"
"2017-06-28 23:24","ServerConfiguration.java","46361","118668","165029","","330058"
"2017-11-08 12:27","ServerConfiguration.java","48962","151339","200301","","400602"
"2014-01-22 14:35","ServerConfiguration.java","19400","133145","152545","6","305090"
"2013-10-12 05:42","ServerConfiguration.java","19096","127706","146802","6","293604"
"2017-07-07 05:11","ZkLedgerUnderreplicationManager.java","4430","19849","24279","","48558"
"2017-06-28 23:28","ZkLedgerUnderreplicationManager.java","3793","14191","17984","","35968"
"2017-06-01 23:58","ZkLedgerUnderreplicationManager.java","3184","9688","12872","","25744"
"2013-01-04 11:32","ServerConfiguration.java","17429","84353","101782","2","203564"
"2014-08-02 20:02","ServerConfiguration.java","20342","145659","166001","","332002"
"2014-05-06 12:30","ServerConfiguration.java","19940","136607","156547","7","313094"
"2014-05-15 00:41","ServerConfiguration.java","19940","137521","157461","7","314922"
"2014-09-18 06:47","ServerConfiguration.java","20353","147679","168032","","336064"
"2017-07-04 06:27","ServerConfiguration.java","46684","122052","168736","","337472"
"2014-03-07 13:14","ServerConfiguration.java","19903","134211","154114","7","308228"
"2014-04-29 22:07","ServerConfiguration.java","19940","136560","156500","7","313000"
"2012-10-18 16:40","ServerConfiguration.java","16152","65809","81961","2","163922"
"2012-09-12 20:34","ServerConfiguration.java","13360","54968","68328","2","136656"
"2016-04-14 00:51","ServerConfiguration.java","45420","79526","124946","","249892"
"2015-01-16 15:57","ServerConfiguration.java","20464","150762","171226","","342452"
"2013-02-08 19:08","ServerConfiguration.java","17927","117012","134939","4","269878"
"2016-03-08 06:49","ServerConfiguration.java","20678","155410","176088","","352176"
"2016-01-26 22:11","ServerConfiguration.java","20686","154404","175090","","350180"
"2014-01-21 05:05","ServerConfiguration.java","19504","131462","150966","6","301932"
"2014-03-12 21:26","ServerConfiguration.java","19913","136023","155936","7","311872"
"2016-04-05 18:47","ServerConfiguration.java","45405","79461","124866","","249732"
"2016-04-27 09:55","ServerConfiguration.java","45421","80039","125460","","250920"
"2015-04-21 09:55","ServerConfiguration.java","20474","151213","171687","","343374"
"2015-01-12 15:18","ServerConfiguration.java","20464","149824","170288","","340576"
"2015-04-21 10:02","ServerConfiguration.java","20475","151247","171722","","343444"
"2013-01-14 16:59","ServerConfiguration.java","17799","86171","103970","2","207940"
"2012-11-30 04:54","ServerConfiguration.java","16496","76765","93261","2","186522"
"2017-05-15 19:52","ServerConfiguration.java","45974","110914","156888","","313776"
"2017-03-22 22:54","ServerConfiguration.java","45578","102460","148038","","296076"
"2012-12-11 18:59","ServerConfiguration.java","16703","77928","94631","2","189262"
"2017-03-23 00:48","ServerConfiguration.java","45580","102514","148094","","296188"
"2017-01-31 02:11","ServerConfiguration.java","45569","96082","141651","","283302"
"2013-02-19 16:19","ServerConfiguration.java","18714","117752","136466","4","272932"
"2013-02-19 16:15","ServerConfiguration.java","18714","117733","136447","4","272894"
"2016-04-05 08:45","ServerConfiguration.java","45403","79217","124620","","249240"
"2016-11-09 03:02","ServerConfiguration.java","45545","88886","134431","","268862"
"2016-11-30 00:02","ServerConfiguration.java","45548","89571","135119","","270238"
"2017-06-05 20:30","ServerConfiguration.java","46584","115075","161659","","323318"
"2016-09-10 20:27","ServerConfiguration.java","45469","85021","130490","","260980"
"2012-03-29 15:18","ServerConfiguration.java","8396","14422","22818","1","45636"
"2017-08-02 00:49","ServerConfiguration.java","47410","140984","188394","","376788"
"2017-10-03 12:31","ServerConfiguration.java","48616","132347","180963","","361926"
"2017-08-16 03:37","ServerConfiguration.java","48212","148419","196631","","393262"
"2013-07-20 19:59","ServerConfiguration.java","19163","124865","144028","5","288056"
"2013-12-02 18:45","ServerConfiguration.java","19470","130178","149648","6","299296"
"2012-03-08 12:13","ServerConfiguration.java","319","1400","1719","1","3438"
"2014-05-09 14:04","ServerConfiguration.java","19940","137201","157141","7","314282"
"2017-05-26 12:38","ServerConfiguration.java","46055","113311","159366","","318732"
"2013-06-15 19:05","ServerConfiguration.java","19128","124261","143389","5","286778"
"2014-01-15 15:58","ServerConfiguration.java","19477","130529","150006","6","300012"
"2013-10-22 07:44","ServerConfiguration.java","19382","127593","146975","6","293950"
"2017-07-07 08:19","ServerConfiguration.java","46679","124010","170689","","341378"
"2017-06-28 23:24","ServerConfiguration.java","46638","118173","164811","","329622"
"2017-11-08 12:27","ServerConfiguration.java","49275","150880","200155","","400310"
"2014-01-22 14:35","ServerConfiguration.java","19634","132607","152241","6","304482"
"2013-10-12 05:42","ServerConfiguration.java","19330","127168","146498","6","292996"
"2016-07-11 23:01","LedgerCreateOp.java","105805","9939","115744","","231488"
"2015-10-22 09:22","LedgerCreateOp.java","88","1468","1556","","3112"
"2014-01-21 05:19","PerChannelBookieClient.java","19516","131810","151326","6","302652"
"2013-10-22 07:35","PerChannelBookieClient.java","19341","127281","146622","6","293244"
"2012-05-17 16:05","PerChannelBookieClient.java","9446","18959","28405","1","56810"
"2012-05-26 19:16","PerChannelBookieClient.java","9687","19801","29488","1","58976"
"2014-01-09 07:30","PerChannelBookieClient.java","19436","130298","149734","6","299468"
"2017-06-30 00:12","PerChannelBookieClient.java","46611","120008","166619","","333238"
"2014-05-27 13:56","PerChannelBookieClient.java","19941","137753","157694","7","315388"
"2017-07-04 06:27","PerChannelBookieClient.java","46655","122013","168668","","337336"
"2012-07-23 23:39","PerChannelBookieClient.java","12183","33621","45804","2","91608"
"2012-08-13 11:38","PerChannelBookieClient.java","12604","39937","52541","2","105082"
"2017-01-31 04:01","PerChannelBookieClient.java","45552","102136","147688","","295376"
"2015-10-06 10:05","PerChannelBookieClient.java","20642","152391","173033","","346066"
"2016-04-05 18:47","PerChannelBookieClient.java","45375","79421","124796","","249592"
"2017-04-15 13:58","PerChannelBookieClient.java","45565","107841","153406","","306812"
"2017-05-15 19:52","PerChannelBookieClient.java","45944","110874","156818","","313636"
"2012-12-01 15:04","PerChannelBookieClient.java","16464","76889","93353","2","186706"
"2016-04-05 08:45","PerChannelBookieClient.java","45373","79177","124550","","249100"
"2017-07-28 20:12","PerChannelBookieClient.java","46971","126923","173894","","347788"
"2017-01-31 02:14","PerChannelBookieClient.java","45539","96654","142193","","284386"
"2017-03-28 22:35","PerChannelBookieClient.java","45546","106722","152268","","304536"
"2017-03-23 00:48","PerChannelBookieClient.java","45550","102474","148024","","296048"
"2013-01-10 19:13","PerChannelBookieClient.java","17716","85452","103168","2","206336"
"2014-07-25 00:34","PerChannelBookieClient.java","20315","144992","165307","","330614"
"2017-08-02 00:49","PerChannelBookieClient.java","47382","140946","188328","","376656"
"2012-04-02 12:38","PerChannelBookieClient.java","8501","15493","23994","1","47988"
"2017-06-21 19:58","PerChannelBookieClient.java","46600","116853","163453","","326906"
"2017-06-01 23:58","PerChannelBookieClient.java","46554","114677","161231","","322462"
"2013-10-29 05:14","PerChannelBookieClient.java","19427","128158","147585","6","295170"
"2013-06-28 17:27","PerChannelBookieClient.java","19100","124532","143632","5","287264"
"2014-02-21 19:01","PerChannelBookieClient.java","19871","134131","154002","7","308004"
"2014-02-05 22:43","PerChannelBookieClient.java","19822","132919","152741","7","305482"
"2017-04-20 19:55","PerChannelBookieClient.java","45566","107863","153429","","306858"
"2013-09-11 00:34","PerChannelBookieClient.java","19177","126071","145248","5","290496"
"2013-08-20 12:51","PerChannelBookieClient.java","19144","125751","144895","5","289790"
"2014-02-05 22:43","TestReplicationWorker.java","10911","89562","100473","7","200946"
"2013-05-31 12:02","TestReplicationWorker.java","8987","75564","84551","5","169102"
"2013-06-15 19:05","TestReplicationWorker.java","9053","79730","88783","5","177566"
"2012-12-18 12:00","TestReplicationWorker.java","5596","36053","41649","2","83298"
"2013-01-14 16:59","TestReplicationWorker.java","7335","41251","48586","2","97172"
"2016-04-27 09:00","TestReplicationWorker.java","62662","62325","124987","","249974"
"2012-08-28 14:25","TestReplicationWorker.java","349","3718","4067","2","8134"
"2012-08-31 15:25","TestReplicationWorker.java","399","3915","4314","2","8628"
"2012-09-12 20:34","TestReplicationWorker.java","873","8025","8898","2","17796"
"2012-12-08 11:18","TestReplicationWorker.java","5251","31646","36897","2","73794"
"2012-10-05 16:24","TestReplicationWorker.java","3549","15585","19134","2","38268"
"2015-07-10 22:48","TestReplicationWorker.java","12077","108754","120831","","241662"
"2014-07-24 01:41","TestReplicationWorker.java","11401","95810","107211","","214422"
"2016-07-14 23:02","TestClient.java","47652","74507","122159","","244318"
"2012-09-11 10:30","TestClient.java","6235","38412","44647","2","89294"
"2013-02-08 19:08","TestClient.java","11847","102184","114031","4","228062"
"2017-03-23 00:48","ClientConfiguration.java","111548","69397","180945","","361890"
"2016-04-05 08:45","ClientConfiguration.java","109849","44578","154427","","308854"
"2017-03-28 22:35","ClientConfiguration.java","111542","73643","185185","","370370"
"2017-01-31 02:14","ClientConfiguration.java","111456","63496","174952","","349904"
"2017-04-15 13:58","ClientConfiguration.java","111658","74859","186517","","373034"
"2017-03-23 00:59","ClientConfiguration.java","111549","69410","180959","","361918"
"2017-05-15 19:52","ClientConfiguration.java","112230","78085","190315","","380630"
"2016-10-13 07:50","ClientConfiguration.java","111306","55259","166565","","333130"
"2017-06-21 19:58","ClientConfiguration.java","113255","84433","197688","","395376"
"2013-10-29 05:14","ClientConfiguration.java","3763","13419","17182","6","34364"
"2017-06-05 21:48","ClientConfiguration.java","113120","82910","196030","","392060"
"2017-06-21 19:50","ClientConfiguration.java","113253","84321","197574","","395148"
"2017-08-02 00:49","ClientConfiguration.java","116603","111092","227695","","455390"
"2017-08-01 08:34","ClientConfiguration.java","116090","107994","224084","","448168"
"2013-06-12 18:41","ClientConfiguration.java","2047","7668","9715","5","19430"
"2014-05-27 13:56","ClientConfiguration.java","5262","23999","29261","7","58522"
"2017-06-30 00:12","ClientConfiguration.java","113431","87753","201184","","402368"
"2014-09-18 06:47","ClientConfiguration.java","5958","34199","40157","","80314"
"2017-07-04 06:27","ClientConfiguration.java","113535","89818","203353","","406706"
"2017-01-31 04:01","ClientConfiguration.java","111470","68979","180449","","360898"
"2015-10-06 10:05","ClientConfiguration.java","7045","39719","46764","","93528"
"2015-10-06 10:48","ClientConfiguration.java","7048","39948","46996","","93992"
"2016-02-09 08:32","ClientConfiguration.java","7191","41956","49147","","98294"
"2014-12-06 07:54","ClientConfiguration.java","6083","35242","41325","","82650"
"2016-08-01 08:04","ClientConfiguration.java","110122","47305","157427","","314854"
"2017-03-28 22:40","AbstractConfiguration.java","6468","32060","38528","","77056"
"2017-08-02 00:49","AbstractConfiguration.java","14281","71818","86099","","172198"
"2017-01-31 02:14","AbstractConfiguration.java","6063","21151","27214","","54428"
"2017-05-02 23:04","AbstractConfiguration.java","7064","34477","41541","","83082"
"2017-03-23 00:48","AbstractConfiguration.java","6266","27163","33429","","66858"
"2014-02-05 22:43","TestLedgerChecker.java","11012","94234","105246","7","210492"
"2012-10-25 16:50","TestLedgerChecker.java","4732","25831","30563","2","61126"
"2015-04-21 10:19","TestLedgerChecker.java","12001","112903","124904","","249808"
"2014-07-24 01:41","TestLedgerChecker.java","11482","100462","111944","","223888"
"2016-10-13 07:50","NetworkTopology.java","112110","50442","162552","","325104"
"2013-04-04 11:21","LedgerManagerTestCase.java","12029","99612","111641","5","223282"
"2017-06-12 17:20","LedgerManagerTestCase.java","49448","106893","156341","","312682"
"2017-05-16 00:31","LedgerManagerTestCase.java","48805","101698","150503","","301006"
"2012-12-24 05:50","LedgerManagerTestCase.java","9710","62556","72266","2","144532"
"2016-11-18 00:18","LedgerManagerTestCase.java","48146","79174","127320","","254640"
"2017-01-31 04:01","LedgerManagerTestCase.java","48191","92320","140511","","281022"
"2017-03-28 22:37","LedgerManagerTestCase.java","48247","97183","145430","","290860"
"2015-09-15 10:38","LedgerManagerTestCase.java","15234","134204","149438","","298876"
"2016-04-27 09:55","LedgerManagerTestCase.java","47977","70130","118107","","236214"
"2017-07-04 06:27","LedgerManagerTestCase.java","49576","112479","162055","","324110"
"2017-06-01 23:58","MSLedgerManagerFactory.java","113501","70226","183727","","367454"
"2015-09-15 10:38","MSLedgerManagerFactory.java","4673","24700","29373","","58746"
"2017-03-28 22:40","MSLedgerManagerFactory.java","111746","61967","173713","","347426"
"2014-05-12 08:10","MSLedgerManagerFactory.java","2009","8180","10189","7","20378"
"2016-07-11 23:01","BookieWriteLedgerTest.java","105742","8496","114238","","228476"
"2012-12-03 17:59","ReadOnlyBookieTest.java","622","1426","2048","2","4096"
"2014-12-10 19:43","ReadOnlyBookieTest.java","10025","78516","88541","","177082"
"2016-03-08 06:49","ReadOnlyBookieTest.java","10806","85536","96342","","192684"
"2016-04-14 00:51","ReadOnlyBookieTest.java","77682","51786","129468","","258936"
"2014-07-24 01:41","ReadOnlyBookieTest.java","9404","68267","77671","","155342"
"2013-03-25 06:48","ReadOnlyBookieTest.java","5995","45566","51561","4","103122"
"2014-01-22 14:35","ReadOnlyBookieTest.java","8297","61268","69565","6","139130"
"2014-01-21 17:26","ReadOnlyBookieTest.java","8184","60779","68963","6","137926"
"2016-04-07 21:39","ReadOnlyBookieTest.java","77672","51735","129407","","258814"
"2014-05-12 08:10","InMemoryMetastoreTable.java","3500","14080","17580","7","35160"
"2016-07-11 23:01","LedgerCreateOp.java","42045","84016","126061","","252122"
"2014-02-05 22:43","LedgerCreateOp.java","19520","139029","158549","7","317098"
"2012-01-18 15:11","LedgerCreateOp.java","829","2307","3136","1","6272"
"2014-01-21 05:19","LedgerCreateOp.java","19229","137935","157164","6","314328"
"2012-06-19 12:39","LedgerCreateOp.java","10996","29863","40859","2","81718"
"2015-09-15 10:38","LedgerCreateOp.java","20183","158020","178203","","356406"
"2015-04-21 09:17","LedgerCreateOp.java","19999","156969","176968","","353936"
"2015-10-22 09:22","LedgerCreateOp.java","20196","159413","179609","","359218"
"2012-09-12 11:59","TestReadTimeout.java","8007","44704","52711","2","105422"
"2013-10-29 05:14","TestReadTimeout.java","14531","118555","133086","6","266172"
"2014-02-05 22:43","TestReadTimeout.java","14988","123378","138366","7","276732"
"2012-05-25 17:13","BookieJournalTest.java","9368","16055","25423","1","50846"
"2012-07-05 14:45","BookieJournalTest.java","10404","25556","35960","2","71920"
"2014-04-29 22:07","BookieJournalTest.java","20122","133360","153482","7","306964"
"2014-12-10 19:43","BookieJournalTest.java","20772","145883","166655","","333310"
"2017-05-15 19:52","BookieJournalTest.java","46580","108138","154718","","309436"
"2012-03-29 15:18","BookieJournalTest.java","7834","10478","18312","1","36624"
"2017-05-16 00:31","BookieJournalTest.java","46620","108596","155216","","310432"
"2013-10-11 08:36","BookieJournalTest.java","19320","123235","142555","6","285110"
"2013-10-12 05:42","BookieJournalTest.java","19402","123858","143260","6","286520"
"2014-01-21 05:19","PerChannelBookieClient.java","18410","139860","158270","6","316540"
"2013-10-22 07:35","PerChannelBookieClient.java","18278","135374","153652","6","307304"
"2012-05-17 16:05","PerChannelBookieClient.java","10373","29042","39415","1","78830"
"2012-05-26 19:16","PerChannelBookieClient.java","10528","29798","40326","1","80652"
"2014-01-09 07:30","PerChannelBookieClient.java","18357","138375","156732","6","313464"
"2017-06-30 00:12","PerChannelBookieClient.java","41181","123734","164915","","329830"
"2014-05-27 13:56","PerChannelBookieClient.java","18770","145738","164508","7","329016"
"2017-07-04 06:27","PerChannelBookieClient.java","41212","125726","166938","","333876"
"2012-07-23 23:39","PerChannelBookieClient.java","12315","42909","55224","2","110448"
"2012-08-13 11:38","PerChannelBookieClient.java","12715","49204","61919","2","123838"
"2017-01-31 04:01","PerChannelBookieClient.java","40857","106597","147454","","294908"
"2015-10-06 10:05","PerChannelBookieClient.java","19214","160119","179333","","358666"
"2016-04-05 18:47","PerChannelBookieClient.java","40666","83868","124534","","249068"
"2012-02-01 12:06","PerChannelBookieClient.java","1240","5631","6871","1","13742"
"2017-04-15 13:58","PerChannelBookieClient.java","40854","112286","153140","","306280"
"2017-05-15 19:52","PerChannelBookieClient.java","41020","115106","156126","","312252"
"2012-12-01 15:04","PerChannelBookieClient.java","16042","85623","101665","2","203330"
"2016-04-05 08:45","PerChannelBookieClient.java","40664","83624","124288","","248576"
"2017-07-28 20:12","PerChannelBookieClient.java","41451","130559","172010","","344020"
"2017-01-31 02:14","PerChannelBookieClient.java","40843","101114","141957","","283914"
"2017-03-28 22:35","PerChannelBookieClient.java","40847","111179","152026","","304052"
"2017-03-23 00:48","PerChannelBookieClient.java","40851","106931","147782","","295564"
"2013-01-10 19:13","PerChannelBookieClient.java","16822","93714","110536","2","221072"
"2014-07-25 00:34","PerChannelBookieClient.java","19101","152934","172035","","344070"
"2012-02-24 20:07","PerChannelBookieClient.java","1764","10920","12684","1","25368"
"2017-08-02 00:49","PerChannelBookieClient.java","41852","144572","186424","","372848"
"2012-04-02 12:38","PerChannelBookieClient.java","9557","25705","35262","1","70524"
"2017-06-21 19:58","PerChannelBookieClient.java","41175","120584","161759","","323518"
"2017-06-01 23:58","PerChannelBookieClient.java","41147","118426","159573","","319146"
"2013-10-29 05:14","PerChannelBookieClient.java","18349","136236","154585","6","309170"
"2013-06-28 17:27","PerChannelBookieClient.java","18127","132715","150842","5","301684"
"2014-02-21 19:01","PerChannelBookieClient.java","18731","142147","160878","7","321756"
"2014-02-05 22:43","PerChannelBookieClient.java","18694","140947","159641","7","319282"
"2017-04-20 19:55","PerChannelBookieClient.java","40855","112308","153163","","306326"
"2013-09-11 00:34","PerChannelBookieClient.java","18181","134231","152412","5","304824"
"2013-08-20 12:51","PerChannelBookieClient.java","18161","133924","152085","5","304170"
"2017-05-15 19:52","TestRackawareEnsemblePlacementPolicy.java","113166","73400","186566","","373132"
"2017-03-28 22:35","TestRackawareEnsemblePlacementPolicy.java","112368","68848","181216","","362432"
"2017-08-16 03:41","TestRackawareEnsemblePlacementPolicy.java","119164","114889","234053","","468106"
"2016-10-13 07:50","TestRackawareEnsemblePlacementPolicy.java","112110","50442","162552","","325104"
"2013-06-26 03:35","TestRackawareEnsemblePlacementPolicy.java","101","723","824","5","1648"
"2014-02-05 22:43","TestRackawareEnsemblePlacementPolicy.java","3504","11905","15409","7","30818"
"2012-05-25 17:13","BookieJournalTest.java","9820","20954","30774","1","61548"
"2012-07-05 14:45","BookieJournalTest.java","10760","30359","41119","2","82238"
"2014-04-29 22:07","BookieJournalTest.java","19811","137496","157307","7","314614"
"2014-12-10 19:43","BookieJournalTest.java","20293","149851","170144","","340288"
"2017-05-15 19:52","BookieJournalTest.java","45790","111795","157585","","315170"
"2012-02-09 18:14","BookieJournalTest.java","163","212","375","1","750"
"2012-03-13 07:31","BookieJournalTest.java","1270","5717","6987","1","13974"
"2012-02-17 11:18","BookieJournalTest.java","327","831","1158","1","2316"
"2012-03-29 15:18","BookieJournalTest.java","8566","15657","24223","1","48446"
"2017-05-16 00:31","BookieJournalTest.java","45830","112253","158083","","316166"
"2013-10-11 08:36","BookieJournalTest.java","19161","127523","146684","6","293368"
"2013-10-12 05:42","BookieJournalTest.java","19219","128122","147341","6","294682"
"2015-09-15 10:38","BookKeeper.java","7371","71060","78431","","156862"
"2015-10-22 09:22","BookKeeper.java","7404","72473","79877","","159754"
"2017-01-31 04:01","BookKeeper.java","80502","69350","149852","","299704"
"2015-07-10 22:48","BookKeeper.java","6963","70350","77313","","154626"
"2017-06-30 00:12","BookKeeper.java","82450","88111","170561","","341122"
"2014-02-06 09:21","BookKeeper.java","5201","50566","55767","7","111534"
"2014-01-21 05:19","BookKeeper.java","4327","48885","53212","6","106424"
"2013-10-02 06:40","BookKeeper.java","2853","42106","44959","5","89918"
"2014-02-21 19:01","BookKeeper.java","5362","51886","57248","7","114496"
"2016-10-13 07:50","BookKeeper.java","80338","55630","135968","","271936"
"2017-06-21 21:00","BookKeeper.java","82280","85470","167750","","335500"
"2013-06-12 18:41","BookKeeper.java","2436","39396","41832","5","83664"
"2013-05-06 19:32","BookKeeper.java","2147","35105","37252","5","74504"
"2017-03-28 22:35","BookKeeper.java","80574","74014","154588","","309176"
"2016-07-11 23:01","BookKeeper.java","79081","46904","125985","","251970"
"2016-10-13 09:27","BookKeeper.java","80452","55730","136182","","272364"
"2017-07-28 20:12","BookKeeper.java","83195","95411","178606","","357212"
"2017-05-15 19:52","BookKeeper.java","81261","78455","159716","","319432"
"2013-09-10 15:14","BookKeeper.java","2799","41918","44717","5","89434"
"2017-08-16 03:41","ScriptBasedMapping.java","12047","69440","81487","","162974"
"2017-01-31 04:01","LedgerDescriptor.java","80590","71981","152571","","305142"
"2017-05-16 00:31","LedgerDescriptor.java","81360","81515","162875","","325750"
"2016-11-18 00:18","LedgerDescriptor.java","80536","58826","139362","","278724"
"2016-04-29 05:05","ScanAndCompareGarbageCollector.java","104979","4865","109844","","219688"
"2016-04-27 09:55","ScanAndCompareGarbageCollector.java","104977","4863","109840","","219680"
"2017-03-28 22:40","ScanAndCompareGarbageCollector.java","110949","37846","148795","","297590"
"2017-06-01 23:58","BookieShell.java","3760","21613","25373","","50746"
"2017-07-07 05:11","BookieShell.java","4923","31691","36614","","73228"
"2017-01-30 23:25","BookieShell.java","13","188","201","","402"
"2017-03-28 22:35","BookieShell.java","852","11758","12610","","25220"
"2017-01-30 21:31","BookieShell.java","8","75","83","","166"
"2017-03-22 22:54","BookieShell.java","752","7354","8106","","16212"
"2014-06-06 15:29","CompactionTest.java","1737","7621","9358","7","18716"
"2016-03-08 06:49","CompactionTest.java","4990","26749","31739","","63478"
"2015-01-16 15:57","CompactionTest.java","3711","21036","24747","","49494"
"2014-12-10 19:43","CompactionTest.java","3698","19218","22916","","45832"
"2015-04-21 09:55","CompactionTest.java","3842","21608","25450","","50900"
"2016-05-04 15:55","CompactionTest.java","108480","30148","138628","","277256"
"2017-03-22 22:54","CompactionTest.java","111601","55510","167111","","334222"
"2017-06-21 21:07","CompactionTest.java","113767","72095","185862","","371724"
"2017-11-08 12:27","CompactionTest.java","126878","115510","242388","","484776"
"2017-05-16 00:31","CompactionTest.java","112658","65043","177701","","355402"
"2017-07-07 08:19","CompactionTest.java","114093","78451","192544","","385088"
"2014-12-10 19:43","LocalBookKeeper.java","6580","66701","73281","","146562"
"2013-02-08 19:08","LocalBookKeeper.java","269","30982","31251","4","62502"
"2015-07-10 22:48","LocalBookKeeper.java","6861","69622","76483","","152966"
"2017-05-26 12:38","LocalBookKeeper.java","81757","80641","162398","","324796"
"2017-06-01 11:31","LocalBookKeeper.java","81796","81594","163390","","326780"
"2017-06-01 23:58","LocalBookKeeper.java","82455","82216","164671","","329342"
"2017-06-01 23:58","ReplicationWorker.java","113548","70821","184369","","368738"
"2017-04-11 20:14","ReplicationWorker.java","111850","62635","174485","","348970"
"2014-02-05 22:43","ReplicationWorker.java","1608","3855","5463","7","10926"
"2016-03-16 04:51","ReplicationWorker.java","108444","28492","136936","","273872"
"2016-09-10 21:01","ReplicationWorker.java","110084","38897","148981","","297962"
"2017-05-26 16:52","ReplicationWorker.java","112795","69211","182006","","364012"
"2015-04-21 09:17","ReplicationWorker.java","4036","23744","27780","","55560"
"2014-04-24 10:43","ReplicationWorker.java","2010","7392","9402","7","18804"
"2014-09-06 07:58","ReplicationWorker.java","3460","19923","23383","","46766"
"2017-06-05 22:25","BookieRequestProcessor.java","3728","12124","15852","","31704"
"2017-07-04 06:27","BookieRequestProcessor.java","4491","18673","23164","","46328"
"2017-08-02 00:49","BookieRequestProcessor.java","9396","41784","51180","","102360"
"2017-05-15 19:52","BookieRequestProcessor.java","2005","5759","7764","","15528"
"2017-06-21 21:07","CompactionTest.java","1701","7644","9345","","18690"
"2017-11-08 12:27","CompactionTest.java","36687","72934","109621","","219242"
"2017-07-07 08:19","CompactionTest.java","2510","14483","16993","","33986"
"2017-05-02 23:04","HierarchicalLedgerManager.java","42380","112232","154612","","309224"
"2012-12-24 05:50","HierarchicalLedgerManager.java","17146","88859","106005","2","212010"
"2017-05-12 16:39","HierarchicalLedgerManager.java","42382","112914","155296","","310592"
"2012-03-28 23:57","HierarchicalLedgerManager.java","9095","20818","29913","1","59826"
"2013-04-04 11:21","HierarchicalLedgerManager.java","18700","125150","143850","5","287700"
"2014-01-17 18:13","HierarchicalLedgerManager.java","19187","136997","156184","6","312368"
"2017-06-05 22:25","BookieRequestProcessor.java","3713","22170","25883","","51766"
"2017-07-04 06:27","BookieRequestProcessor.java","4425","28668","33093","","66186"
"2017-08-02 00:49","BookieRequestProcessor.java","9032","51481","60513","","121026"
"2017-03-28 22:35","BookieRequestProcessor.java","345","10406","10751","","21502"
"2017-05-15 19:52","BookieRequestProcessor.java","2090","15905","17995","","35990"
"2017-06-01 23:58","BookieShell.java","3754","21965","25719","","51438"
"2017-07-07 05:11","BookieShell.java","4917","32043","36960","","73920"
"2017-01-11 07:37","BookieShell.java","13","371","384","","768"
"2017-01-11 07:34","BookieShell.java","12","246","258","","516"
"2017-01-30 23:25","BookieShell.java","24","557","581","","1162"
"2017-03-28 22:35","BookieShell.java","861","12125","12986","","25972"
"2017-01-30 21:31","BookieShell.java","21","446","467","","934"
"2017-03-22 22:54","BookieShell.java","761","7721","8482","","16964"
"2017-08-16 03:41","RackawareEnsemblePlacementPolicy.java","11924","51169","63093","","126186"
"2017-07-28 20:12","RackawareEnsemblePlacementPolicy.java","6033","24809","30842","","61684"
"2013-08-21 13:19","BookKeeperAdmin.java","7343","67660","75003","5","150006"
"2017-10-17 09:32","BookKeeperAdmin.java","79765","124858","204623","","409246"
"2017-06-01 23:58","BookKeeperAdmin.java","72310","93951","166261","","332522"
"2017-04-11 20:19","BookKeeperAdmin.java","71077","86233","157310","","314620"
"2014-02-21 19:01","BookKeeperAdmin.java","9360","77138","86498","7","172996"
"2014-02-05 22:43","BookKeeperAdmin.java","9255","75870","85125","7","170250"
"2017-07-07 05:11","BookKeeperAdmin.java","72539","103095","175634","","351268"
"2013-02-26 04:12","BookKeeperAdmin.java","6477","59098","65575","4","131150"
"2016-11-09 03:05","BookKeeperAdmin.java","70846","67712","138558","","277116"
"2016-11-30 00:07","BookKeeperAdmin.java","70855","68385","139240","","278480"
"2016-09-10 21:01","BookKeeperAdmin.java","70731","63912","134643","","269286"
"2016-07-14 23:02","BookKeeperAdmin.java","69811","58922","128733","","257466"
"2016-10-13 09:27","BookKeeperAdmin.java","70845","67377","138222","","276444"
"2012-11-30 04:54","BookKeeperAdmin.java","2161","15938","18099","2","36198"
"2013-02-08 19:08","BookKeeperAdmin.java","5612","58205","63817","4","127634"
"2016-03-16 05:03","BookKeeperAdmin.java","69588","54207","123795","","247590"
"2016-03-08 07:18","BookKeeperAdmin.java","11103","100008","111111","","222222"
"2014-12-06 08:03","BookKeeperAdmin.java","10185","92021","102206","","204412"
"2014-04-24 10:43","BookKeeperAdmin.java","9382","79132","88514","7","177028"
"2014-09-06 07:51","BookKeeperAdmin.java","10016","90715","100731","","201462"
"2013-05-10 12:45","BookKeeperAdmin.java","7029","61471","68500","5","137000"
"2013-01-14 16:59","BookieServer.java","7766","54690","62456","2","124912"
"2013-01-09 17:18","BookieServer.java","7628","53488","61116","2","122232"
"2013-02-12 11:16","BookieServer.java","8788","86298","95086","4","190172"
"2013-04-02 17:38","BookieServer.java","9063","87576","96639","5","193278"
"2017-08-16 03:37","BookieServer.java","57701","136460","194161","","388322"
"2017-08-02 00:49","BookieServer.java","56717","128843","185560","","371120"
"2013-07-03 17:39","BookieServer.java","9468","93470","102938","5","205876"
"2013-07-24 16:55","BookieServer.java","9500","94370","103870","5","207740"
"2014-02-05 22:43","BookieServer.java","11180","102839","114019","7","228038"
"2017-06-28 23:24","BookieServer.java","55264","105351","160615","","321230"
"2013-06-15 19:05","BookieServer.java","9444","93129","102573","5","205146"
"2017-06-01 23:58","BookieServer.java","55207","101892","157099","","314198"
"2017-10-17 09:32","BookieServer.java","61216","131353","192569","","385138"
"2014-08-02 20:02","BookieServer.java","11773","115642","127415","","254830"
"2013-12-06 07:39","BookieServer.java","10603","100015","110618","6","221236"
"2012-10-18 16:40","BookieServer.java","4951","33160","38111","2","76222"
"2014-01-21 05:05","BookieServer.java","10649","101159","111808","6","223616"
"2013-01-14 16:59","BookieServer.java","9321","59154","68475","2","136950"
"2013-01-09 17:18","BookieServer.java","9184","57953","67137","2","134274"
"2013-02-12 11:16","BookieServer.java","10336","90755","101091","4","202182"
"2013-04-02 17:38","BookieServer.java","10605","92027","102632","5","205264"
"2017-08-16 03:37","BookieServer.java","55408","137076","192484","","384968"
"2017-08-02 00:49","BookieServer.java","54424","129459","183883","","367766"
"2013-07-03 17:39","BookieServer.java","11010","97921","108931","5","217862"
"2013-07-24 16:55","BookieServer.java","11039","98818","109857","5","219714"
"2014-02-05 22:43","BookieServer.java","12704","107272","119976","7","239952"
"2017-06-28 23:24","BookieServer.java","52988","105984","158972","","317944"
"2013-06-15 19:05","BookieServer.java","10986","97580","108566","5","217132"
"2017-06-01 23:58","BookieServer.java","52931","102525","155456","","310912"
"2017-10-17 09:32","BookieServer.java","58636","131682","190318","","380636"
"2014-08-02 20:02","BookieServer.java","13299","120077","133376","","266752"
"2013-12-06 07:39","BookieServer.java","12137","104458","116595","6","233190"
"2012-07-23 23:39","BookieServer.java","1858","4767","6625","2","13250"
"2012-10-18 16:40","BookieServer.java","6575","37693","44268","2","88536"
"2014-01-21 05:05","BookieServer.java","12180","105599","117779","6","235558"
"2014-01-21 05:19","PerChannelBookieClient.java","14771","120073","134844","6","269688"
"2013-10-22 07:35","PerChannelBookieClient.java","14536","115484","130020","6","260040"
"2012-05-17 16:05","PerChannelBookieClient.java","1220","3741","4961","1","9922"
"2012-05-26 19:16","PerChannelBookieClient.java","1476","4598","6074","1","12148"
"2014-01-09 07:30","PerChannelBookieClient.java","14676","118546","133222","6","266444"
"2017-06-30 00:12","PerChannelBookieClient.java","48697","115102","163799","","327598"
"2014-05-27 13:56","PerChannelBookieClient.java","15289","126109","141398","7","282796"
"2017-07-04 06:27","PerChannelBookieClient.java","48766","117132","165898","","331796"
"2012-07-23 23:39","PerChannelBookieClient.java","5530","19976","25506","2","51012"
"2012-08-13 11:38","PerChannelBookieClient.java","6032","26373","32405","2","64810"
"2017-01-31 04:01","PerChannelBookieClient.java","47503","97095","144598","","289196"
"2015-10-06 10:05","PerChannelBookieClient.java","16188","140945","157133","","314266"
"2016-04-05 18:47","PerChannelBookieClient.java","47296","74350","121646","","243292"
"2017-04-15 13:58","PerChannelBookieClient.java","47577","102861","150438","","300876"
"2017-05-15 19:52","PerChannelBookieClient.java","47971","105909","153880","","307760"
"2012-12-01 15:04","PerChannelBookieClient.java","10404","63837","74241","2","148482"
"2016-04-05 08:45","PerChannelBookieClient.java","47294","74106","121400","","242800"
"2017-07-28 20:12","PerChannelBookieClient.java","49151","122111","171262","","342524"
"2017-01-31 02:14","PerChannelBookieClient.java","47490","91613","139103","","278206"
"2017-03-28 22:35","PerChannelBookieClient.java","47510","101694","149204","","298408"
"2017-03-23 00:48","PerChannelBookieClient.java","47515","97447","144962","","289924"
"2013-01-10 19:13","PerChannelBookieClient.java","12157","72901","85058","2","170116"
"2014-07-25 00:34","PerChannelBookieClient.java","15674","133359","149033","","298066"
"2017-08-02 00:49","PerChannelBookieClient.java","49587","136159","185746","","371492"
"2017-06-21 19:58","PerChannelBookieClient.java","48685","111946","160631","","321262"
"2017-06-01 23:58","PerChannelBookieClient.java","48634","109765","158399","","316798"
"2013-10-29 05:14","PerChannelBookieClient.java","14667","116406","131073","6","262146"
"2013-06-28 17:27","PerChannelBookieClient.java","13680","112120","125800","5","251600"
"2014-02-21 19:01","PerChannelBookieClient.java","15209","122477","137686","7","275372"
"2014-02-05 22:43","PerChannelBookieClient.java","15142","121247","136389","7","272778"
"2017-04-20 19:55","PerChannelBookieClient.java","47578","102883","150461","","300922"
"2013-09-11 00:34","PerChannelBookieClient.java","13768","113670","127438","5","254876"
"2013-08-20 12:51","PerChannelBookieClient.java","13729","113344","127073","5","254146"
"2012-12-24 05:50","InterleavedLedgerStorage.java","3115","18769","21884","2","43768"
"2012-12-18 13:04","InterleavedLedgerStorage.java","2494","18040","20534","2","41068"
"2016-11-18 00:18","InterleavedLedgerStorage.java","72694","66530","139224","","278448"
"2013-12-02 18:45","InterleavedLedgerStorage.java","7581","68632","76213","6","152426"
"2013-05-04 14:22","InterleavedLedgerStorage.java","6070","57017","63087","5","126174"
"2014-01-15 15:58","InterleavedLedgerStorage.java","7660","69055","76715","6","153430"
"2014-01-21 17:26","InterleavedLedgerStorage.java","7840","70780","78620","6","157240"
"2013-10-02 06:23","InterleavedLedgerStorage.java","6524","63782","70306","5","140612"
"2017-05-16 00:31","InterleavedLedgerStorage.java","73492","89193","162685","","325370"
"2014-08-02 20:02","InterleavedLedgerStorage.java","9204","84864","94068","","188136"
"2017-07-04 06:27","InterleavedLedgerStorage.java","74466","100177","174643","","349286"
"2015-04-21 09:55","InterleavedLedgerStorage.java","9669","90751","100420","","200840"
"2017-01-31 04:01","InterleavedLedgerStorage.java","72747","79684","152431","","304862"
"2016-03-08 06:49","InterleavedLedgerStorage.java","10318","95393","105711","","211422"
"2017-03-28 22:37","InterleavedLedgerStorage.java","72842","84586","157428","","314856"
"2015-04-21 09:17","InterleavedLedgerStorage.java","9649","90560","100209","","200418"
"2017-03-23 00:48","ClientConfiguration.java","79606","75587","155193","","310386"
"2016-04-05 08:45","ClientConfiguration.java","78075","50936","129011","","258022"
"2017-03-28 22:35","ClientConfiguration.java","79600","79833","159433","","318866"
"2017-01-31 02:14","ClientConfiguration.java","79516","69688","149204","","298408"
"2017-04-15 13:58","ClientConfiguration.java","79717","81050","160767","","321534"
"2017-03-23 00:59","ClientConfiguration.java","79607","75600","155207","","310414"
"2017-05-15 19:52","ClientConfiguration.java","80204","84191","164395","","328790"
"2016-10-13 07:50","ClientConfiguration.java","79368","61453","140821","","281642"
"2017-06-21 19:58","ClientConfiguration.java","81111","90421","171532","","343064"
"2013-10-29 05:14","ClientConfiguration.java","7895","55683","63578","6","127156"
"2017-06-05 21:48","ClientConfiguration.java","81062","88984","170046","","340092"
"2017-06-21 19:50","ClientConfiguration.java","81109","90309","171418","","342836"
"2017-08-02 00:49","ClientConfiguration.java","84329","116950","201279","","402558"
"2017-08-01 08:34","ClientConfiguration.java","83835","113871","197706","","395412"
"2013-06-12 18:41","ClientConfiguration.java","6510","50263","56773","5","113546"
"2014-05-27 13:56","ClientConfiguration.java","9067","65936","75003","7","150006"
"2017-06-30 00:12","ClientConfiguration.java","81245","93699","174944","","349888"
"2014-09-18 06:47","ClientConfiguration.java","9699","76072","85771","","171542"
"2017-07-04 06:27","ClientConfiguration.java","81339","95754","177093","","354186"
"2017-01-31 04:01","ClientConfiguration.java","79529","75170","154699","","309398"
"2015-10-06 10:05","ClientConfiguration.java","10595","81401","91996","","183992"
"2015-10-06 10:48","ClientConfiguration.java","10598","81630","92228","","184456"
"2013-02-08 19:08","ClientConfiguration.java","4820","42952","47772","4","95544"
"2016-02-09 08:32","ClientConfiguration.java","10715","83612","94327","","188654"
"2014-12-06 07:54","ClientConfiguration.java","9809","77100","86909","","173818"
"2016-08-01 08:04","ClientConfiguration.java","78331","53646","131977","","263954"
"2012-12-13 13:07","ClientConfiguration.java","2248","4070","6318","2","12636"
"2017-10-17 09:32","AuditorLedgerCheckerTest.java","32507","47044","79551","","159102"
"2014-05-09 14:04","CookieTest.java","11353","87725","99078","7","198156"
"2013-10-12 05:42","CookieTest.java","10205","77154","87359","6","174718"
"2016-11-30 00:02","CookieTest.java","67167","70301","137468","","274936"
"2012-11-23 11:49","CookieTest.java","4737","21989","26726","2","53452"
"2014-12-10 19:43","CookieTest.java","12282","99886","112168","","224336"
"2014-09-23 17:53","CookieTest.java","12034","98554","110588","","221176"
"2014-09-18 06:57","CookieTest.java","12016","98480","110496","","220992"
"2012-06-19 12:39","BookieRecoveryTest.java","10425","23659","34084","2","68168"
"2012-12-12 11:20","BookieRecoveryTest.java","16659","79432","96091","2","192182"
"2012-09-12 11:59","BookieRecoveryTest.java","13319","55502","68821","2","137642"
"2017-06-30 00:12","BookieRecoveryTest.java","46370","120546","166916","","333832"
"2014-07-24 01:41","BookieRecoveryTest.java","19972","139606","159578","","319156"
"2012-12-04 22:15","BookieRecoveryTest.java","16561","78282","94843","2","189686"
"2017-04-11 20:15","BookieRecoveryTest.java","45330","107745","153075","","306150"
"2017-05-15 19:52","BookieRecoveryTest.java","45709","111418","157127","","314254"
"2012-07-18 17:00","BookieRecoveryTest.java","12140","34289","46429","2","92858"
"2012-12-10 16:02","BookieRecoveryTest.java","16643","78366","95009","2","190018"
"2012-03-31 10:58","BookieRecoveryTest.java","8513","16146","24659","1","49318"
"2013-08-13 14:32","BookieRecoveryTest.java","18965","126267","145232","5","290464"
"2014-02-05 22:43","BookieRecoveryTest.java","19635","133511","153146","7","306292"
"2016-11-30 00:02","CookieTest.java","112225","28839","141064","","282128"
"2014-12-10 19:43","CookieTest.java","458","1542","2000","","4000"
"2017-07-04 06:27","FileInfo.java","46452","122836","169288","","338576"
"2012-10-26 12:51","FileInfo.java","16289","68488","84777","2","169554"
"2014-12-04 12:28","FileInfo.java","20192","149169","169361","","338722"
"2017-01-31 04:01","FileInfo.java","45367","102977","148344","","296688"
"2017-03-23 15:55","FileInfo.java","45375","103351","148726","","297452"
"2016-11-18 00:18","FileInfo.java","45332","89841","135173","","270346"
"2012-12-18 13:04","FileInfo.java","16954","83173","100127","2","200254"
"2013-05-04 14:22","FileInfo.java","18804","120424","139228","5","278456"
"2012-02-17 11:18","FileInfo.java","179","634","813","1","1626"
"2012-02-24 19:20","FileInfo.java","313","1333","1646","1","3292"
"2012-06-13 16:57","FileInfo.java","9842","22557","32399","","64798"
"2012-03-29 15:18","FileInfo.java","8511","15553","24064","1","48128"
"2017-06-01 23:58","FileInfo.java","46365","115514","161879","","323758"
"2017-07-17 23:27","FileInfo.java","46458","125949","172407","","344814"
"2017-05-16 00:31","FileInfo.java","45804","112178","157982","","315964"
"2013-10-22 16:21","FileInfo.java","19306","128927","148233","6","296466"
"2013-10-11 08:36","FileInfo.java","19128","127441","146569","6","293138"
"2017-01-31 04:01","Bookie.java","80590","71981","152571","","305142"
"2017-03-28 22:37","Bookie.java","80680","76878","157558","","315116"
"2016-01-26 22:11","Bookie.java","8940","77455","86395","","172790"
"2015-03-18 07:38","Bookie.java","8289","73552","81841","","163682"
"2015-04-21 09:17","Bookie.java","8290","73655","81945","","163890"
"2013-06-21 19:26","Bookie.java","4421","44478","48899","5","97798"
"2014-09-23 17:53","Bookie.java","7950","70156","78106","","156212"
"2017-07-04 06:27","Bookie.java","82514","92679","175193","","350386"
"2017-06-05 22:25","Bookie.java","82238","86617","168855","","337710"
"2014-02-06 09:25","Bookie.java","6871","54783","61654","7","123308"
"2014-04-29 22:07","Bookie.java","7141","58558","65699","7","131398"
"2013-12-06 07:39","Bookie.java","5899","51556","57455","6","114910"
"2014-08-02 20:02","Bookie.java","7815","67929","75744","","151488"
"2013-10-02 07:01","Bookie.java","4744","46646","51390","5","102780"
"2017-06-28 23:24","Bookie.java","82285","88617","170902","","341804"
"2017-07-07 08:19","Bookie.java","82514","94642","177156","","354312"
"2013-09-11 00:34","Bookie.java","4705","46406","51111","5","102222"
"2014-01-21 17:26","Bookie.java","6154","53548","59702","6","119404"
"2013-10-12 05:42","Bookie.java","5654","48289","53943","6","107886"
"2013-10-22 16:21","Bookie.java","5833","49235","55068","6","110136"
"2017-05-16 00:31","Bookie.java","81360","81515","162875","","325750"
"2013-07-24 16:55","Bookie.java","4524","45639","50163","5","100326"
"2014-02-05 22:43","Bookie.java","6869","54773","61642","7","123284"
"2014-08-18 23:03","Bookie.java","7828","69410","77238","","154476"
"2014-05-09 14:04","Bookie.java","7158","59216","66374","7","132748"
"2013-06-15 19:05","Bookie.java","4404","44334","48738","5","97476"
"2017-06-01 23:58","Bookie.java","82096","85026","167122","","334244"
"2017-08-02 00:49","Bookie.java","85565","113936","199501","","399002"
"2013-12-02 18:45","Bookie.java","5885","51390","57275","6","114550"
"2013-05-04 14:22","Bookie.java","4140","39541","43681","5","87362"
"2016-11-18 00:18","Bookie.java","80536","58826","139362","","278724"
"2017-03-28 22:35","Bookie.java","80662","76645","157307","","314614"
"2016-07-14 23:02","Bookie.java","79238","49638","128876","","257752"
"2017-06-05 20:30","Bookie.java","82149","85437","167586","","335172"
"2016-11-30 00:02","Bookie.java","80554","59374","139928","","279856"
"2012-12-24 05:50","Bookie.java","796","904","1700","2","3400"
"2017-03-22 22:54","Bookie.java","80664","72343","153007","","306014"
"2012-12-24 06:23","Bookie.java","870","1200","2070","2","4140"
"2017-07-28 20:12","AsyncCallback.java","49957","119850","169807","","339614"
"2013-05-06 19:32","AsyncCallback.java","12756","103391","116147","5","232294"
"2017-01-31 04:01","AsyncCallback.java","48182","94707","142889","","285778"
"2017-07-04 06:27","AsyncCallback.java","49493","114792","164285","","328570"
"2016-07-11 23:01","LedgerCreateOp.java","106677","11678","118355","","236710"
"2015-09-15 10:38","LedgerCreateOp.java","1009","1876","2885","","5770"
"2015-10-22 09:22","LedgerCreateOp.java","1095","3342","4437","","8874"
"2017-03-28 22:35","EnsemblePlacementPolicy.java","925","18475","19400","","38800"
"2017-07-28 20:12","EnsemblePlacementPolicy.java","6211","42537","48748","","97496"
"2017-06-01 23:58","BookieShell.java","3749","21726","25475","","50950"
"2017-07-07 05:11","BookieShell.java","4912","31804","36716","","73432"
"2017-01-30 23:25","BookieShell.java","12","311","323","","646"
"2017-03-28 22:35","BookieShell.java","849","11879","12728","","25456"
"2017-01-30 21:31","BookieShell.java","9","200","209","","418"
"2017-03-22 22:54","BookieShell.java","749","7475","8224","","16448"
"2013-08-21 13:19","BookKeeperAdmin.java","9361","75281","84642","5","169284"
"2017-10-17 09:32","BookKeeperAdmin.java","75883","126579","202462","","404924"
"2017-06-01 23:58","BookKeeperAdmin.java","68549","95793","164342","","328684"
"2017-04-11 20:19","BookKeeperAdmin.java","67367","88126","155493","","310986"
"2014-02-21 19:01","BookKeeperAdmin.java","11282","84663","95945","7","191890"
"2014-02-05 22:43","BookKeeperAdmin.java","11186","83404","94590","7","189180"
"2017-07-07 05:11","BookKeeperAdmin.java","68758","104917","173675","","347350"
"2013-02-26 04:12","BookKeeperAdmin.java","8537","66761","75298","4","150596"
"2016-11-09 03:05","BookKeeperAdmin.java","67157","69626","136783","","273566"
"2016-11-30 00:07","BookKeeperAdmin.java","67167","70300","137467","","274934"
"2016-09-10 21:01","BookKeeperAdmin.java","67042","65826","132868","","265736"
"2016-07-14 23:02","BookKeeperAdmin.java","66134","60848","126982","","253964"
"2016-10-13 09:27","BookKeeperAdmin.java","67154","69289","136443","","272886"
"2012-11-30 04:54","BookKeeperAdmin.java","4922","24302","29224","2","58448"
"2013-02-08 19:08","BookKeeperAdmin.java","7684","65880","73564","4","147128"
"2016-03-16 05:03","BookKeeperAdmin.java","65932","56154","122086","","244172"
"2016-03-08 07:18","BookKeeperAdmin.java","12924","107432","120356","","240712"
"2014-12-06 08:03","BookKeeperAdmin.java","12069","99508","111577","","223154"
"2014-04-24 10:43","BookKeeperAdmin.java","11301","86654","97955","7","195910"
"2012-10-05 16:24","BookKeeperAdmin.java","3265","8868","12133","2","24266"
"2014-09-06 07:51","BookKeeperAdmin.java","11928","98230","110158","","220316"
"2013-05-10 12:45","BookKeeperAdmin.java","9075","69120","78195","5","156390"
"2017-04-11 20:19","BookKeeperCloseTest.java","112647","46190","158837","","317674"
"2017-05-16 00:31","BookKeeperCloseTest.java","113802","51055","164857","","329714"
"2014-06-06 15:29","CompactionTest.java","2296","10101","12397","7","24794"
"2014-01-17 18:13","CompactionTest.java","37","393","430","6","860"
"2016-03-08 06:49","CompactionTest.java","5112","28792","33904","","67808"
"2015-01-16 15:57","CompactionTest.java","3908","23154","27062","","54124"
"2014-12-10 19:43","CompactionTest.java","3896","21337","25233","","50466"
"2015-04-21 09:55","CompactionTest.java","4012","23699","27711","","55422"
"2016-05-04 15:55","CompactionTest.java","108557","32146","140703","","281406"
"2017-03-22 22:54","CompactionTest.java","111659","57489","169148","","338296"
"2017-06-21 21:07","CompactionTest.java","113785","74034","187819","","375638"
"2014-01-22 14:35","CompactionTest.java","619","2540","3159","6","6318"
"2017-11-08 12:27","CompactionTest.java","126683","117236","243919","","487838"
"2017-05-16 00:31","CompactionTest.java","112699","67005","179704","","359408"
"2017-07-07 08:19","CompactionTest.java","114117","80396","194513","","389026"
"2017-03-23 00:48","ClientConfiguration.java","42847","104536","147383","","294766"
"2016-04-05 08:45","ClientConfiguration.java","42662","81231","123893","","247786"
"2017-03-28 22:35","ClientConfiguration.java","42843","108784","151627","","303254"
"2017-01-31 02:14","ClientConfiguration.java","42825","98705","141530","","283060"
"2017-04-15 13:58","ClientConfiguration.java","42855","109896","152751","","305502"
"2017-03-23 00:59","ClientConfiguration.java","42847","104548","147395","","294790"
"2017-05-15 19:52","ClientConfiguration.java","43215","112910","156125","","312250"
"2016-10-13 07:50","ClientConfiguration.java","42728","90521","133249","","266498"
"2017-06-21 19:58","ClientConfiguration.java","43494","118512","162006","","324012"
"2013-10-29 05:14","ClientConfiguration.java","18801","132297","151098","6","302196"
"2017-06-05 21:48","ClientConfiguration.java","43453","117083","160536","","321072"
"2017-06-21 19:50","ClientConfiguration.java","43493","118401","161894","","323788"
"2012-04-20 19:18","ClientConfiguration.java","9028","21657","30685","1","61370"
"2017-08-02 00:49","ClientConfiguration.java","44231","142560","186791","","373582"
"2017-08-01 08:34","ClientConfiguration.java","44134","139878","184012","","368024"
"2013-06-12 18:41","ClientConfiguration.java","18531","127992","146523","5","293046"
"2014-05-27 13:56","ClientConfiguration.java","19262","141839","161101","7","322202"
"2017-06-30 00:12","ClientConfiguration.java","43499","121661","165160","","330320"
"2014-09-18 06:47","ClientConfiguration.java","19628","151709","171337","","342674"
"2017-07-04 06:27","ClientConfiguration.java","43535","123658","167193","","334386"
"2012-09-12 11:59","ClientConfiguration.java","13113","59282","72395","2","144790"
"2017-01-31 04:01","ClientConfiguration.java","42841","104190","147031","","294062"
"2015-10-06 10:05","ClientConfiguration.java","19861","156375","176236","","352472"
"2015-10-06 10:48","ClientConfiguration.java","19863","156603","176466","","352932"
"2013-02-08 19:08","ClientConfiguration.java","17370","121210","138580","4","277160"
"2012-12-03 10:46","ClientConfiguration.java","16153","81861","98014","2","196028"
"2016-02-09 08:32","ClientConfiguration.java","19871","158476","178347","","356694"
"2014-12-06 07:54","ClientConfiguration.java","19640","152639","172279","","344558"
"2016-08-01 08:04","ClientConfiguration.java","42728","83751","126479","","252958"
"2012-12-13 13:07","ClientConfiguration.java","16511","84041","100552","2","201104"
"2014-06-06 15:29","CompactionTest.java","2863","13509","16372","7","32744"
"2013-10-30 16:23","CompactionTest.java","549","2522","3071","6","6142"
"2014-01-17 18:13","CompactionTest.java","718","3915","4633","6","9266"
"2016-03-08 06:49","CompactionTest.java","5589","32110","37699","","75398"
"2015-01-16 15:57","CompactionTest.java","4427","26514","30941","","61882"
"2014-12-10 19:43","CompactionTest.java","4414","24696","29110","","58220"
"2015-04-21 09:55","CompactionTest.java","4502","27030","31532","","63064"
"2016-05-04 15:55","CompactionTest.java","109017","35447","144464","","288928"
"2017-03-22 22:54","CompactionTest.java","112095","60766","172861","","345722"
"2017-06-21 21:07","CompactionTest.java","114157","77247","191404","","382808"
"2014-01-22 14:35","CompactionTest.java","1271","6033","7304","6","14608"
"2017-11-08 12:27","CompactionTest.java","126694","120088","246782","","493564"
"2017-05-16 00:31","CompactionTest.java","113097","70244","183341","","366682"
"2014-01-15 15:58","CompactionTest.java","699","3540","4239","6","8478"
"2017-07-07 08:19","CompactionTest.java","114461","83581","198042","","396084"
"2017-01-31 04:01","LedgerDescriptor.java","779","13880","14659","","29318"
"2017-05-16 00:31","LedgerDescriptor.java","2889","24754","27643","","55286"
"2016-12-21 01:48","LedgerCacheTest.java","111893","33430","145323","","290646"
"2019-02-20 11:43","LedgerCacheTest.java","140987","401201","542188","","1084376"
"2017-05-16 00:31","LedgerCacheTest.java","113453","50318","163771","","327542"
"2016-03-08 06:49","LedgerCacheTest.java","1660","7899","9559","","19118"
"2017-07-07 05:11","Auditor.java","82269","92393","174662","","349324"
"2014-02-05 22:43","Auditor.java","5551","51734","57285","7","114570"
"2013-08-21 13:19","Auditor.java","3188","43073","46261","5","92522"
"2017-05-26 16:52","Auditor.java","81138","81490","162628","","325256"
"2013-03-25 06:27","Auditor.java","2250","34864","37114","4","74228"
"2016-09-10 21:01","Auditor.java","80088","52837","132925","","265850"
"2016-11-09 03:02","Auditor.java","80206","56623","136829","","273658"
"2016-03-08 07:18","Auditor.java","7967","76440","84407","","168814"
"2014-04-24 10:43","Auditor.java","5811","55129","60940","7","121880"
"2014-06-02 11:54","Auditor.java","6022","57478","63500","7","127000"
"2014-05-06 12:30","Auditor.java","5859","55602","61461","7","122922"
"2014-05-23 18:48","Auditor.java","5880","56547","62427","7","124854"
"2017-05-15 19:52","DigestManager.java","40724","116098","156822","","313644"
"2012-07-18 17:00","DigestManager.java","12729","44543","57272","2","114544"
"2017-05-25 14:23","DigestManager.java","40783","118439","159222","","318444"
"2012-02-13 15:46","DigestManager.java","2237","11902","14139","1","28278"
"2012-05-10 14:47","DigestManager.java","10664","29913","40577","1","81154"
"2012-05-25 17:13","DigestManager.java","10978","31481","42459","1","84918"
"2017-01-31 04:01","DigestManager.java","40577","107605","148182","","296364"
"2016-11-30 00:02","CookieTest.java","112262","28932","141194","","282388"
"2014-12-10 19:43","CookieTest.java","497","1637","2134","","4268"
"2014-09-23 17:53","CookieTest.java","43","99","142","","284"
"2017-08-16 03:41","RackawareEnsemblePlacementPolicy.java","6342","26811","33153","","66306"
"2017-07-07 08:19","BookieInitializationTest.java","1234","10074","11308","","22616"
"2017-06-28 23:24","BookieInitializationTest.java","451","3495","3946","","7892"
"2017-07-28 06:39","BookieInitializationTest.java","2575","13304","15879","","31758"
"2017-08-02 00:49","BookieInitializationTest.java","6330","31413","37743","","75486"
"2013-01-14 16:59","BookieServer.java","4435","23150","27585","2","55170"
"2013-01-09 17:18","BookieServer.java","4235","21886","26121","2","52242"
"2013-02-12 11:16","BookieServer.java","5528","54829","60357","4","120714"
"2013-04-02 17:38","BookieServer.java","5837","56141","61978","5","123956"
"2017-08-16 03:37","BookieServer.java","76920","127470","204390","","408780"
"2017-08-02 00:49","BookieServer.java","75891","119808","195699","","391398"
"2013-07-03 17:39","BookieServer.java","6337","62130","68467","5","136934"
"2013-07-24 16:55","BookieServer.java","6392","63053","69445","5","138890"
"2014-02-05 22:43","BookieServer.java","8443","71893","80336","7","160672"
"2017-06-28 23:24","BookieServer.java","74280","96158","170438","","340876"
"2013-06-15 19:05","BookieServer.java","6299","61775","68074","5","136148"
"2017-06-01 23:58","BookieServer.java","74177","92653","166830","","333660"
"2017-10-17 09:32","BookieServer.java","81990","123918","205908","","411816"
"2014-08-02 20:02","BookieServer.java","9204","84864","94068","","188136"
"2013-12-06 07:39","BookieServer.java","7595","68798","76393","6","152786"
"2014-01-21 05:05","BookieServer.java","7691","69992","77683","6","155366"
"2014-07-24 01:41","ZkLedgerLayoutTest.java","4725","24052","28777","","57554"
"2015-09-15 10:38","GcLedgersTest.java","8247","74371","82618","","165236"
"2016-04-27 09:55","GcLedgersTest.java","78445","47752","126197","","252394"
"2017-03-28 22:37","GcLedgersTest.java","80079","76169","156248","","312496"
"2016-03-08 06:49","GcLedgersTest.java","8550","77971","86521","","173042"
"2017-07-04 06:27","GcLedgersTest.java","81993","92050","174043","","348086"
"2014-07-24 01:41","GcLedgersTest.java","6927","60481","67408","","134816"
"2013-04-04 11:21","GcLedgersTest.java","3159","37896","41055","5","82110"
"2013-07-29 12:30","GcLedgersTest.java","3832","44883","48715","5","97430"
"2017-05-16 00:31","GcLedgersTest.java","80826","80873","161699","","323398"
"2017-03-23 00:48","ClientConfiguration.java","110981","34065","145046","","290092"
"2016-04-05 08:45","ClientConfiguration.java","105034","4998","110032","","220064"
"2017-03-28 22:35","ClientConfiguration.java","111041","38377","149418","","298836"
"2017-01-31 02:14","ClientConfiguration.java","110815","28090","138905","","277810"
"2017-04-15 13:58","ClientConfiguration.java","111330","39766","151096","","302192"
"2017-03-23 00:59","ClientConfiguration.java","110994","34090","145084","","290168"
"2017-05-15 19:52","ClientConfiguration.java","112343","43433","155776","","311552"
"2016-10-13 07:50","ClientConfiguration.java","110530","19718","130248","","260496"
"2017-06-21 19:58","ClientConfiguration.java","113872","50285","164157","","328314"
"2017-06-05 21:48","ClientConfiguration.java","113555","48580","162135","","324270"
"2017-06-21 19:50","ClientConfiguration.java","113867","50170","164037","","328074"
"2017-08-02 00:49","ClientConfiguration.java","118555","78279","196834","","393668"
"2017-08-01 08:34","ClientConfiguration.java","117982","75121","193103","","386206"
"2017-06-30 00:12","ClientConfiguration.java","114211","53768","167979","","335958"
"2017-07-04 06:27","ClientConfiguration.java","114399","55917","170316","","340632"
"2017-01-31 04:01","ClientConfiguration.java","110842","33586","144428","","288856"
"2016-08-01 08:04","ClientConfiguration.java","105620","8038","113658","","227316"
"2017-07-04 06:27","LedgerStorage.java","48796","116799","165595","","331190"
"2017-03-28 22:37","LedgerStorage.java","47523","101559","149082","","298164"
"2016-03-08 06:49","LedgerStorage.java","16348","143715","160063","","320126"
"2017-01-31 04:01","LedgerStorage.java","47489","96718","144207","","288414"
"2016-11-18 00:18","LedgerStorage.java","47444","83572","131016","","262032"
"2012-12-18 13:04","LedgerStorage.java","10762","68600","79362","2","158724"
"2013-05-04 14:22","LedgerStorage.java","13424","106663","120087","5","240174"
"2017-05-16 00:31","LedgerStorage.java","48024","106017","154041","","308082"
"2017-06-01 08:55","CodahaleStatsLogger.java","112816","70184","183000","","366000"
"2012-12-18 12:00","TestLedgerUnderreplicationManager.java","5782","32870","38652","2","77304"
"2013-05-31 12:02","TestLedgerUnderreplicationManager.java","9263","72471","81734","5","163468"
"2013-10-12 05:42","TestLedgerUnderreplicationManager.java","10274","80287","90561","6","181122"
"2012-10-04 12:40","TestLedgerUnderreplicationManager.java","3368","10849","14217","2","28434"
"2015-07-10 22:48","TestLedgerUnderreplicationManager.java","12462","105770","118232","","236464"
"2012-12-08 11:42","TestLedgerUnderreplicationManager.java","5243","28269","33512","2","67024"
"2012-10-16 17:01","TestLedgerUnderreplicationManager.java","3486","12738","16224","2","32448"
"2016-02-23 19:16","ListLedgersTest.java","6077","39161","45238","","90476"
"2012-12-18 12:00","TestLedgerUnderreplicationManager.java","5429","36706","42135","2","84270"
"2013-05-31 12:02","TestLedgerUnderreplicationManager.java","8784","76181","84965","5","169930"
"2013-10-12 05:42","TestLedgerUnderreplicationManager.java","9770","83972","93742","6","187484"
"2012-10-04 12:40","TestLedgerUnderreplicationManager.java","3284","14954","18238","2","36476"
"2015-07-10 22:48","TestLedgerUnderreplicationManager.java","11800","109297","121097","","242194"
"2012-08-28 14:25","TestLedgerUnderreplicationManager.java","340","4529","4869","2","9738"
"2012-08-27 12:09","TestLedgerUnderreplicationManager.java","7","942","949","2","1898"
"2012-12-08 11:42","TestLedgerUnderreplicationManager.java","5085","32300","37385","2","74770"
"2012-10-16 17:01","TestLedgerUnderreplicationManager.java","3385","16826","20211","2","40422"
"2017-06-30 00:12","ReadOnlyLedgerHandle.java","4237","20684","24921","","49842"
"2014-07-24 01:41","ConcurrentLedgerTest.java","18947","146958","165905","","331810"
"2014-12-10 19:43","ConcurrentLedgerTest.java","19127","156766","175893","","351786"
"2011-11-28 19:25","ConcurrentLedgerTest.java","482","3226","3708","","7416"
"2012-03-08 19:24","ConcurrentLedgerTest.java","1949","12220","14169","1","28338"
"2012-02-15 16:11","ConcurrentLedgerTest.java","1618","10007","11625","1","23250"
"2013-10-12 05:42","ConcurrentLedgerTest.java","18238","135222","153460","6","306920"
"2014-02-05 22:43","ConcurrentLedgerTest.java","18694","140947","159641","7","319282"
"2017-05-16 00:31","ConcurrentLedgerTest.java","41044","115548","156592","","313184"
"2017-05-16 00:31","AuditorPeriodicCheckTest.java","4451","30136","34587","","69174"
"2017-11-08 12:27","CompactionTest.java","34874","59148","94022","","188044"
"2017-01-31 04:01","Bookie.java","779","13880","14659","","29318"
"2017-03-28 22:37","Bookie.java","1057","18965","20022","","40044"
"2017-07-04 06:27","Bookie.java","4948","36823","41771","","83542"
"2017-06-05 22:25","Bookie.java","4302","30391","34693","","69386"
"2017-06-28 23:24","Bookie.java","4429","32471","36900","","73800"
"2017-07-07 08:19","Bookie.java","5007","38845","43852","","87704"
"2017-05-16 00:31","Bookie.java","2889","24754","27643","","55286"
"2017-06-01 23:58","Bookie.java","3881","28521","32402","","64804"
"2017-08-02 00:49","Bookie.java","9368","59449","68817","","137634"
"2017-03-28 22:35","Bookie.java","1017","18710","19727","","39454"
"2017-06-05 20:30","Bookie.java","4049","29047","33096","","66192"
"2016-11-30 00:02","Bookie.java","111","641","752","","1504"
"2017-03-22 22:54","Bookie.java","917","14306","15223","","30446"
"2016-07-11 23:01","LedgerCreateOp.java","105742","8496","114238","","228476"
"2012-12-18 12:00","TestLedgerUnderreplicationManager.java","5605","35947","41552","2","83104"
"2013-05-31 12:02","TestLedgerUnderreplicationManager.java","8998","75460","84458","5","168916"
"2013-10-12 05:42","TestLedgerUnderreplicationManager.java","9985","83252","93237","6","186474"
"2012-10-04 12:40","TestLedgerUnderreplicationManager.java","3441","14176","17617","2","35234"
"2015-07-10 22:48","TestLedgerUnderreplicationManager.java","12088","108650","120738","","241476"
"2012-08-28 14:25","TestLedgerUnderreplicationManager.java","345","3599","3944","2","7888"
"2012-12-08 11:42","TestLedgerUnderreplicationManager.java","5248","31528","36776","2","73552"
"2012-10-16 17:01","TestLedgerUnderreplicationManager.java","3547","16053","19600","2","39200"
"2013-01-07 22:53","AuditorBookieTest.java","3697","19091","22788","2","45576"
"2012-12-18 12:00","AuditorBookieTest.java","2238","15408","17646","2","35292"
"2013-06-15 19:05","AuditorBookieTest.java","6138","59528","65666","5","131332"
"2014-02-05 22:43","AuditorBookieTest.java","8364","69728","78092","7","156184"
"2013-09-10 15:14","LedgerCreateDeleteTest.java","13753","113504","127257","5","254514"
"2017-10-17 09:32","AuditorElector.java","126023","99228","225251","","450502"
"2016-07-14 23:02","AuditorElector.java","108276","25499","133775","","267550"
"2016-09-10 21:01","AuditorElector.java","109512","30805","140317","","280634"
"2017-03-28 22:40","AuditorElector.java","111425","54674","166099","","332198"
"2014-09-06 07:58","AuditorElector.java","1542","10485","12027","","24054"
"2017-05-16 00:31","WriteEntryProcessorV3.java","2882","24876","27758","","55516"
"2017-05-15 19:52","WriteEntryProcessorV3.java","2703","24279","26982","","53964"
"2017-10-17 09:32","AuditorElector.java","125990","101333","227323","","454646"
"2016-07-14 23:02","AuditorElector.java","108468","27829","136297","","272594"
"2016-09-10 21:01","AuditorElector.java","109704","33135","142839","","285678"
"2017-03-28 22:40","AuditorElector.java","111586","56973","168559","","337118"
"2014-06-02 11:54","AuditorElector.java","410","2548","2958","7","5916"
"2014-09-06 07:58","AuditorElector.java","1846","12927","14773","","29546"
"2017-07-07 05:11","Auditor.java","65519","106474","171993","","343986"
"2014-02-05 22:43","Auditor.java","11253","88267","99520","7","199040"
"2013-08-21 13:19","Auditor.java","9450","80166","89616","5","179232"
"2012-12-18 12:00","Auditor.java","5862","34682","40544","2","81088"
"2017-05-26 16:52","Auditor.java","64769","95952","160721","","321442"
"2013-03-25 06:27","Auditor.java","8880","72325","81205","4","162410"
"2016-09-10 21:01","Auditor.java","63923","67503","131426","","262852"
"2016-11-09 03:02","Auditor.java","64034","71282","135316","","270632"
"2016-03-08 07:18","Auditor.java","12908","112212","125120","","250240"
"2013-01-04 11:32","Auditor.java","7101","37932","45033","2","90066"
"2012-10-04 12:40","Auditor.java","3481","12694","16175","2","32350"
"2014-04-24 10:43","Auditor.java","11370","91519","102889","7","205778"
"2014-06-02 11:54","Auditor.java","11523","93810","105333","7","210666"
"2014-05-06 12:30","Auditor.java","11407","91981","103388","7","206776"
"2014-05-23 18:48","Auditor.java","11416","92914","104330","7","208660"
"2017-10-03 12:31","ServerConfiguration.java","28787","18944","47731","","95462"
"2017-08-16 03:37","ServerConfiguration.java","4701","11334","16035","","32070"
"2017-11-08 12:27","ServerConfiguration.java","33453","41484","74937","","149874"
"2017-07-28 20:12","BKException.java","40782","133519","174301","","348602"
"2016-07-11 22:53","BKException.java","40226","87663","127889","","255778"
"2017-05-02 23:04","BKException.java","40280","116505","156785","","313570"
"2013-09-10 15:14","BKException.java","18866","138506","157372","5","314744"
"2014-02-21 19:01","BKException.java","19192","146237","165429","7","330858"
"2012-04-02 12:38","BKException.java","11814","31591","43405","1","86810"
"2017-08-02 00:49","BKException.java","41168","147517","188685","","377370"
"2012-12-12 11:20","BKException.java","17210","91989","109199","2","218398"
"2012-06-19 12:39","BKException.java","12679","37919","50598","2","101196"
"2011-11-16 17:05","BKException.java","2735","4433","7168","","14336"
"2015-09-15 10:38","BKException.java","19467","163677","183144","","366288"
"2017-01-31 04:01","BKException.java","40292","109661","149953","","299906"
"2011-10-27 15:41","BKException.java","147","598","745","","1490"
"2015-10-06 10:48","BKException.java","19470","164230","183700","","367400"
"2015-10-22 09:22","BKException.java","19474","165064","184538","","369076"
"2012-09-04 10:39","BKException.java","14469","66770","81239","2","162478"
"2012-12-03 17:59","BKException.java","17094","90675","107769","2","215538"
"2017-07-28 20:12","BookiesListener.java","115684","88837","204521","","409042"
"2017-07-04 06:27","FileInfo.java","46437","122366","168803","","337606"
"2012-10-26 12:51","FileInfo.java","16195","67939","84134","2","168268"
"2014-12-04 12:28","FileInfo.java","20126","148648","168774","","337548"
"2017-01-31 04:01","FileInfo.java","45328","102483","147811","","295622"
"2017-03-23 15:55","FileInfo.java","45337","102858","148195","","296390"
"2016-11-18 00:18","FileInfo.java","45293","89347","134640","","269280"
"2012-12-18 13:04","FileInfo.java","16863","82627","99490","2","198980"
"2013-05-04 14:22","FileInfo.java","18731","119896","138627","5","277254"
"2012-02-24 19:20","FileInfo.java","135","700","835","1","1670"
"2012-06-13 16:57","FileInfo.java","9731","21991","31722","","63444"
"2012-03-29 15:18","FileInfo.java","8376","14963","23339","1","46678"
"2017-06-01 23:58","FileInfo.java","46339","115033","161372","","322744"
"2017-07-17 23:27","FileInfo.java","46443","125479","171922","","343844"
"2017-05-16 00:31","FileInfo.java","45772","111691","157463","","314926"
"2013-10-22 16:21","FileInfo.java","19221","128387","147608","6","295216"
"2013-10-11 08:36","FileInfo.java","19041","126899","145940","6","291880"
"2013-01-04 11:32","ServerConfiguration.java","16668","92738","109406","2","218812"
"2014-08-02 20:02","ServerConfiguration.java","19095","153558","172653","","345306"
"2014-05-06 12:30","ServerConfiguration.java","18737","144550","163287","7","326574"
"2014-05-15 00:41","ServerConfiguration.java","18737","145464","164201","7","328402"
"2014-09-18 06:47","ServerConfiguration.java","19106","155578","174684","","349368"
"2017-07-04 06:27","ServerConfiguration.java","41212","125726","166938","","333876"
"2014-03-07 13:14","ServerConfiguration.java","18731","142185","160916","7","321832"
"2014-04-29 22:07","ServerConfiguration.java","18737","144503","163240","7","326480"
"2012-10-18 16:40","ServerConfiguration.java","15802","74605","90407","2","180814"
"2012-09-12 20:34","ServerConfiguration.java","13182","63936","77118","2","154236"
"2016-04-14 00:51","ServerConfiguration.java","40681","83933","124614","","249228"
"2015-01-16 15:57","ServerConfiguration.java","19127","158571","177698","","355396"
"2013-02-08 19:08","ServerConfiguration.java","16980","125211","142191","4","284382"
"2016-03-08 06:49","ServerConfiguration.java","19220","163098","182318","","364636"
"2016-01-26 22:11","ServerConfiguration.java","19226","162090","181316","","362632"
"2014-01-21 05:05","ServerConfiguration.java","18369","139473","157842","6","315684"
"2014-03-12 21:26","ServerConfiguration.java","18737","143993","162730","7","325460"
"2016-04-05 18:47","ServerConfiguration.java","40666","83868","124534","","249068"
"2016-04-27 09:55","ServerConfiguration.java","40682","84446","125128","","250256"
"2015-04-21 09:55","ServerConfiguration.java","19136","159021","178157","","356314"
"2015-01-12 15:18","ServerConfiguration.java","19127","157633","176760","","353520"
"2015-04-21 10:02","ServerConfiguration.java","19137","159055","178192","","356384"
"2012-02-01 12:58","ServerConfiguration.java","1243","7422","8665","1","17330"
"2013-01-14 16:59","ServerConfiguration.java","16862","94380","111242","2","222484"
"2012-11-30 04:54","ServerConfiguration.java","16039","85454","101493","2","202986"
"2017-05-15 19:52","ServerConfiguration.java","41020","115106","156126","","312252"
"2017-03-22 22:54","ServerConfiguration.java","40849","106877","147726","","295452"
"2012-12-11 18:59","ServerConfiguration.java","16209","86580","102789","2","205578"
"2017-03-23 00:48","ServerConfiguration.java","40851","106931","147782","","295564"
"2017-01-31 02:11","ServerConfiguration.java","40843","100502","141345","","282690"
"2013-02-19 16:19","ServerConfiguration.java","17732","125916","143648","4","287296"
"2013-02-19 16:15","ServerConfiguration.java","17732","125897","143629","4","287258"
"2016-04-05 08:45","ServerConfiguration.java","40664","83624","124288","","248576"
"2016-11-09 03:02","ServerConfiguration.java","40810","93297","134107","","268214"
"2016-11-30 00:02","ServerConfiguration.java","40822","93991","134813","","269626"
"2017-06-05 20:30","ServerConfiguration.java","41146","118783","159929","","319858"
"2016-09-10 20:27","ServerConfiguration.java","40722","89420","130142","","260284"
"2012-03-29 15:18","ServerConfiguration.java","9491","24663","34154","1","68308"
"2012-02-15 10:58","ServerConfiguration.java","1617","9991","11608","1","23216"
"2012-02-24 19:08","ServerConfiguration.java","1710","10856","12566","1","25132"
"2017-08-02 00:49","ServerConfiguration.java","41852","144572","186424","","372848"
"2017-10-03 12:31","ServerConfiguration.java","42611","135488","178099","","356198"
"2017-08-16 03:37","ServerConfiguration.java","42387","151740","194127","","388254"
"2013-07-20 19:59","ServerConfiguration.java","18143","132991","151134","5","302268"
"2013-12-02 18:45","ServerConfiguration.java","18351","138205","156556","6","313112"
"2012-03-08 12:13","ServerConfiguration.java","1901","12128","14029","1","28058"
"2014-05-09 14:04","ServerConfiguration.java","18737","145144","163881","7","327762"
"2017-05-26 12:38","ServerConfiguration.java","41082","117484","158566","","317132"
"2013-06-15 19:05","ServerConfiguration.java","18124","132403","150527","5","301054"
"2014-01-15 15:58","ServerConfiguration.java","18356","138554","156910","6","313820"
"2013-10-22 07:44","ServerConfiguration.java","18279","135636","153915","6","307830"
"2017-07-07 08:19","ServerConfiguration.java","41214","127691","168905","","337810"
"2017-06-28 23:24","ServerConfiguration.java","41183","121864","163047","","326094"
"2017-11-08 12:27","ServerConfiguration.java","43227","153978","197205","","394410"
"2014-01-22 14:35","ServerConfiguration.java","18490","140609","159099","6","318198"
"2013-10-12 05:42","ServerConfiguration.java","18238","135222","153460","6","306920"
"2017-07-04 06:27","Bookie.java","4491","18673","23164","","46328"
"2017-06-05 22:25","Bookie.java","3728","12124","15852","","31704"
"2017-06-28 23:24","Bookie.java","3878","14227","18105","","36210"
"2017-07-07 08:19","Bookie.java","4580","20725","25305","","50610"
"2017-05-16 00:31","Bookie.java","2236","6408","8644","","17288"
"2017-06-01 23:58","Bookie.java","3302","10249","13551","","27102"
"2017-08-02 00:49","Bookie.java","9396","41784","51180","","102360"
"2017-06-05 20:30","Bookie.java","3470","10775","14245","","28490"
"2017-06-01 23:58","BookieShell.java","3797","27907","31704","","63408"
"2017-07-07 05:11","BookieShell.java","4915","37940","42855","","85710"
"2017-01-11 07:37","BookieShell.java","83","6340","6423","","12846"
"2016-12-21 01:42","BookieShell.java","70","5969","6039","","12078"
"2017-01-11 07:34","BookieShell.java","82","6215","6297","","12594"
"2017-01-30 23:25","BookieShell.java","94","6526","6620","","13240"
"2017-03-28 22:35","BookieShell.java","931","18094","19025","","38050"
"2017-01-30 21:31","BookieShell.java","91","6415","6506","","13012"
"2017-03-22 22:54","BookieShell.java","831","13690","14521","","29042"
"2017-11-08 12:27","ServerConfiguration.java","5604","23478","29082","","58164"
"2017-06-01 23:58","BookieShell.java","3752","21430","25182","","50364"
"2017-07-07 05:11","BookieShell.java","4929","31522","36451","","72902"
"2017-03-28 22:35","BookieShell.java","839","11570","12409","","24818"
"2017-03-22 22:54","BookieShell.java","739","7166","7905","","15810"
"2017-06-01 23:58","ReplicationWorker.java","113452","65343","178795","","357590"
"2017-04-11 20:14","ReplicationWorker.java","111631","57034","168665","","337330"
"2016-03-16 04:51","ReplicationWorker.java","108048","22714","130762","","261524"
"2016-09-10 21:01","ReplicationWorker.java","109704","33135","142839","","285678"
"2017-05-26 16:52","ReplicationWorker.java","112673","63707","176380","","352760"
"2015-04-21 09:17","ReplicationWorker.java","2724","17050","19774","","39548"
"2014-09-06 07:58","ReplicationWorker.java","1846","12927","14773","","29546"
"2013-10-22 16:21","LedgerEntryPage.java","18973","140353","159326","6","318652"
"2011-11-18 11:18","LedgerEntryPage.java","3592","7221","10813","","21626"
"2017-07-04 06:27","LedgerEntryPage.java","40546","128689","169235","","338470"
"2012-05-25 17:13","LedgerEntryPage.java","12570","35414","47984","1","95968"
"2012-05-10 14:47","LedgerEntryPage.java","12253","33843","46096","1","92192"
"2017-03-28 22:35","DefaultEnsemblePlacementPolicy.java","112368","68848","181216","","362432"
"2017-07-28 20:12","DefaultEnsemblePlacementPolicy.java","115204","90460","205664","","411328"
"2016-10-13 07:50","DefaultEnsemblePlacementPolicy.java","112110","50442","162552","","325104"
"2014-02-05 22:43","DefaultEnsemblePlacementPolicy.java","3504","11905","15409","7","30818"
"2012-05-10 14:47","BookieException.java","8924","14357","23281","1","46562"
"2012-09-07 07:04","BookieException.java","13103","50610","63713","2","127426"
"2013-02-08 19:08","BookieException.java","17954","113657","131611","4","263222"
"2017-07-07 08:19","BookieException.java","47312","121261","168573","","337146"
"2017-10-03 12:31","ServerConfiguration.java","24206","7730","31936","","63872"
"2017-11-08 12:27","ServerConfiguration.java","29681","31079","60760","","121520"
"2012-12-18 12:00","BookKeeperClusterTestCase.java","337","3005","3342","2","6684"
"2017-05-15 19:52","BookKeeperClusterTestCase.java","80053","82748","162801","","325602"
"2013-01-09 17:18","BookKeeperClusterTestCase.java","2428","7491","9919","2","19838"
"2016-04-05 08:45","BookKeeperClusterTestCase.java","77915","49484","127399","","254798"
"2017-08-01 08:34","BookKeeperClusterTestCase.java","83680","112424","196104","","392208"
"2013-10-12 05:42","BookKeeperClusterTestCase.java","5813","51406","57219","6","114438"
"2014-02-05 22:43","BookKeeperClusterTestCase.java","6987","57849","64836","7","129672"
"2017-11-08 12:27","BookKeeperClusterTestCase.java","91278","130638","221916","","443832"
"2013-06-15 19:05","BookKeeperClusterTestCase.java","4630","47518","52148","5","104296"
"2014-05-09 14:04","BookKeeperClusterTestCase.java","7228","62244","69472","7","138944"
"2017-07-04 06:27","BookKeeperClusterTestCase.java","81171","94294","175465","","350930"
"2014-07-24 01:41","BookKeeperClusterTestCase.java","7650","64270","71920","","143840"
"2014-05-23 18:46","BookKeeperClusterTestCase.java","7227","62573","69800","7","139600"
"2017-06-30 00:12","BookKeeperClusterTestCase.java","81080","92242","173322","","346644"
"2014-04-24 10:43","BookKeeperClusterTestCase.java","7174","61171","68345","7","136690"
"2013-01-07 12:25","BookKeeperClusterTestCase.java","2060","6951","9011","2","18022"
"2016-04-27 09:55","BookKeeperClusterTestCase.java","77974","50347","128321","","256642"
"2013-01-03 11:06","BookKeeperClusterTestCase.java","1936","5800","7736","2","15472"
"2015-10-06 10:48","BookKeeperClusterTestCase.java","8907","78647","87554","","175108"
"2014-12-10 19:43","BookKeeperClusterTestCase.java","8284","74532","82816","","165632"
"2014-04-24 10:43","BookieAutoRecoveryTest.java","3767","14876","18643","7","37286"
"2014-05-23 18:46","BookieAutoRecoveryTest.java","3843","16301","20144","7","40288"
"2014-05-09 14:04","BookieAutoRecoveryTest.java","3837","15965","19802","7","39604"
"2014-02-05 22:43","BookieAutoRecoveryTest.java","3442","11416","14858","7","29716"
"2013-12-06 07:39","BookieThread.java","796","3818","4614","6","9228"
"2016-07-11 23:01","LedgerCreateOp.java","40464","86467","126931","","253862"
"2014-02-05 22:43","LedgerCreateOp.java","18772","142313","161085","7","322170"
"2012-01-18 15:11","LedgerCreateOp.java","1877","7387","9264","1","18528"
"2014-01-21 05:19","LedgerCreateOp.java","18492","141230","159722","6","319444"
"2012-06-19 12:39","LedgerCreateOp.java","11183","34082","45265","2","90530"
"2015-09-15 10:38","LedgerCreateOp.java","19283","161152","180435","","360870"
"2011-11-28 19:25","LedgerCreateOp.java","1137","5169","6306","","12612"
"2015-04-21 09:17","LedgerCreateOp.java","19208","160210","179418","","358836"
"2015-10-22 09:22","LedgerCreateOp.java","19296","162545","181841","","363682"
"2017-06-30 00:12","PendingWriteLacOp.java","2341","10808","13149","","26298"
"2013-01-04 11:32","ServerConfiguration.java","16657","92492","109149","2","218298"
"2014-08-02 20:02","ServerConfiguration.java","19091","153319","172410","","344820"
"2014-05-06 12:30","ServerConfiguration.java","18732","144310","163042","7","326084"
"2014-05-15 00:41","ServerConfiguration.java","18732","145224","163956","7","327912"
"2014-09-18 06:47","ServerConfiguration.java","19102","155339","174441","","348882"
"2017-07-04 06:27","ServerConfiguration.java","41434","125713","167147","","334294"
"2014-03-07 13:14","ServerConfiguration.java","18725","141944","160669","7","321338"
"2014-04-29 22:07","ServerConfiguration.java","18732","144263","162995","7","325990"
"2012-10-18 16:40","ServerConfiguration.java","15786","74354","90140","2","180280"
"2012-09-12 20:34","ServerConfiguration.java","13166","63685","76851","2","153702"
"2016-04-14 00:51","ServerConfiguration.java","40902","83919","124821","","249642"
"2015-01-16 15:57","ServerConfiguration.java","19123","158332","177455","","354910"
"2013-02-08 19:08","ServerConfiguration.java","16971","124967","141938","4","283876"
"2016-03-08 06:49","ServerConfiguration.java","19218","162861","182079","","364158"
"2016-01-26 22:11","ServerConfiguration.java","19224","161853","181077","","362154"
"2014-01-21 05:05","ServerConfiguration.java","18363","139232","157595","6","315190"
"2014-03-12 21:26","ServerConfiguration.java","18732","143753","162485","7","324970"
"2016-04-05 18:47","ServerConfiguration.java","40887","83854","124741","","249482"
"2016-04-27 09:55","ServerConfiguration.java","40903","84432","125335","","250670"
"2015-04-21 09:55","ServerConfiguration.java","19132","158782","177914","","355828"
"2015-01-12 15:18","ServerConfiguration.java","19123","157394","176517","","353034"
"2015-04-21 10:02","ServerConfiguration.java","19133","158816","177949","","355898"
"2012-02-01 12:58","ServerConfiguration.java","1218","7162","8380","1","16760"
"2013-01-14 16:59","ServerConfiguration.java","16852","94135","110987","2","221974"
"2012-11-30 04:54","ServerConfiguration.java","16027","85207","101234","2","202468"
"2017-05-15 19:52","ServerConfiguration.java","41242","115093","156335","","312670"
"2017-03-22 22:54","ServerConfiguration.java","41071","106864","147935","","295870"
"2012-12-11 18:59","ServerConfiguration.java","16197","86333","102530","2","205060"
"2017-03-23 00:48","ServerConfiguration.java","41073","106918","147991","","295982"
"2017-01-31 02:11","ServerConfiguration.java","41064","100488","141552","","283104"
"2013-02-19 16:19","ServerConfiguration.java","17723","125672","143395","4","286790"
"2013-02-19 16:15","ServerConfiguration.java","17723","125653","143376","4","286752"
"2016-04-05 08:45","ServerConfiguration.java","40885","83610","124495","","248990"
"2016-11-09 03:02","ServerConfiguration.java","41031","93283","134314","","268628"
"2016-11-30 00:02","ServerConfiguration.java","41043","93977","135020","","270040"
"2017-06-05 20:30","ServerConfiguration.java","41368","118770","160138","","320276"
"2016-09-10 20:27","ServerConfiguration.java","40943","89406","130349","","260698"
"2012-03-29 15:18","ServerConfiguration.java","9475","24412","33887","1","67774"
"2012-02-15 10:58","ServerConfiguration.java","1593","9732","11325","1","22650"
"2012-02-24 19:08","ServerConfiguration.java","1686","10597","12283","1","24566"
"2017-08-02 00:49","ServerConfiguration.java","42074","144559","186633","","373266"
"2017-10-03 12:31","ServerConfiguration.java","42834","135476","178310","","356620"
"2017-08-16 03:37","ServerConfiguration.java","42609","151727","194336","","388672"
"2013-07-20 19:59","ServerConfiguration.java","18137","132750","150887","5","301774"
"2013-12-02 18:45","ServerConfiguration.java","18345","137964","156309","6","312618"
"2012-03-08 12:13","ServerConfiguration.java","1880","11872","13752","1","27504"
"2014-05-09 14:04","ServerConfiguration.java","18732","144904","163636","7","327272"
"2017-05-26 12:38","ServerConfiguration.java","41304","117471","158775","","317550"
"2013-06-15 19:05","ServerConfiguration.java","18118","132162","150280","5","300560"
"2014-01-15 15:58","ServerConfiguration.java","18350","138313","156663","6","313326"
"2013-10-22 07:44","ServerConfiguration.java","18273","135395","153668","6","307336"
"2017-07-07 08:19","ServerConfiguration.java","41436","127678","169114","","338228"
"2017-06-28 23:24","ServerConfiguration.java","41405","121851","163256","","326512"
"2017-11-08 12:27","ServerConfiguration.java","43450","153966","197416","","394832"
"2014-01-22 14:35","ServerConfiguration.java","18484","140368","158852","6","317704"
"2013-10-12 05:42","ServerConfiguration.java","18232","134981","153213","6","306426"
"2016-07-14 23:02","IndexPersistenceMgr.java","105463","6334","111797","","223594"
"2016-11-18 00:18","IndexPersistenceMgr.java","110603","19364","129967","","259934"
"2017-05-16 00:31","IndexPersistenceMgr.java","112289","42915","155204","","310408"
"2017-10-03 12:31","IndexPersistenceMgr.java","129965","78964","208929","","417858"
"2017-07-04 06:27","IndexPersistenceMgr.java","114212","54848","169060","","338120"
"2017-01-31 04:01","IndexPersistenceMgr.java","110707","32569","143276","","286552"
"2017-07-04 06:27","FileInfo.java","46674","122038","168712","","337424"
"2012-10-26 12:51","FileInfo.java","16232","67411","83643","2","167286"
"2014-12-04 12:28","FileInfo.java","20350","148307","168657","","337314"
"2017-01-31 04:01","FileInfo.java","45571","102161","147732","","295464"
"2017-03-23 15:55","FileInfo.java","45571","102527","148098","","296196"
"2016-11-18 00:18","FileInfo.java","45533","89022","134555","","269110"
"2012-12-18 13:04","FileInfo.java","16904","82103","99007","2","198014"
"2013-05-04 14:22","FileInfo.java","18944","119544","138488","5","276976"
"2012-06-13 16:57","FileInfo.java","9767","21462","31229","","62458"
"2012-03-29 15:18","FileInfo.java","8385","14407","22792","1","45584"
"2017-06-01 23:58","FileInfo.java","46573","114702","161275","","322550"
"2017-07-17 23:27","FileInfo.java","46682","125153","171835","","343670"
"2017-05-16 00:31","FileInfo.java","46004","111358","157362","","314724"
"2013-10-22 16:21","FileInfo.java","19439","128040","147479","6","294958"
"2013-10-11 08:36","FileInfo.java","19257","126550","145807","6","291614"
"2017-07-28 20:12","BKException.java","40668","131707","172375","","344750"
"2016-07-11 22:53","BKException.java","39982","85721","125703","","251406"
"2017-05-02 23:04","BKException.java","40090","114617","154707","","309414"
"2013-09-10 15:14","BKException.java","18047","135989","154036","5","308072"
"2014-02-21 19:01","BKException.java","18534","143881","162415","7","324830"
"2012-04-02 12:38","BKException.java","9922","28001","37923","1","75846"
"2017-08-02 00:49","BKException.java","41066","145717","186783","","373566"
"2012-12-12 11:20","BKException.java","16128","89209","105337","2","210674"
"2012-06-19 12:39","BKException.java","11045","34587","45632","2","91264"
"2015-09-15 10:38","BKException.java","18960","161472","180432","","360864"
"2017-01-31 04:01","BKException.java","40097","107768","147865","","295730"
"2015-10-06 10:48","BKException.java","18964","162026","180990","","361980"
"2015-10-22 09:22","BKException.java","18973","162865","181838","","363676"
"2012-09-04 10:39","BKException.java","13311","63914","77225","2","154450"
"2012-12-03 17:59","BKException.java","15978","87861","103839","2","207678"
"2017-05-02 23:04","HierarchicalLedgerManagerFactory.java","111956","43971","155927","","311854"
"2017-03-28 22:40","HierarchicalLedgerManagerFactory.java","111394","41588","152982","","305964"
"2017-01-31 04:01","Bookie.java","6114","27105","33219","","66438"
"2017-03-28 22:37","Bookie.java","6354","32152","38506","","77012"
"2017-07-04 06:27","Bookie.java","9938","49703","59641","","119282"
"2017-06-05 22:25","Bookie.java","9317","43296","52613","","105226"
"2017-06-28 23:24","Bookie.java","9439","45371","54810","","109620"
"2017-07-07 08:19","Bookie.java","9988","51716","61704","","123408"
"2017-05-16 00:31","Bookie.java","7929","37684","45613","","91226"
"2017-06-01 23:58","Bookie.java","8899","41429","50328","","100656"
"2017-08-02 00:49","Bookie.java","14270","72241","86511","","173022"
"2016-11-18 00:18","Bookie.java","5537","13427","18964","","37928"
"2017-03-28 22:35","Bookie.java","6314","31897","38211","","76422"
"2017-06-05 20:30","Bookie.java","9067","41955","51022","","102044"
"2016-11-30 00:02","Bookie.java","5566","13986","19552","","39104"
"2017-03-22 22:54","Bookie.java","6252","27531","33783","","67566"
"2017-07-07 05:11","Auditor.java","71991","103733","175724","","351448"
"2014-02-05 22:43","Auditor.java","9175","76976","86151","7","172302"
"2013-08-21 13:19","Auditor.java","7279","68782","76061","5","152122"
"2012-12-18 12:00","Auditor.java","3466","23073","26539","2","53078"
"2017-05-26 16:52","Auditor.java","71128","93098","164226","","328452"
"2013-03-25 06:27","Auditor.java","6666","60898","67564","4","135128"
"2016-09-10 21:01","Auditor.java","70184","64551","134735","","269470"
"2016-11-09 03:02","Auditor.java","70298","68333","138631","","277262"
"2016-03-08 07:18","Auditor.java","11008","101099","112107","","224214"
"2013-01-04 11:32","Auditor.java","4805","26423","31228","2","62456"
"2014-04-24 10:43","Auditor.java","9301","80237","89538","7","179076"
"2014-06-02 11:54","Auditor.java","9460","82534","91994","7","183988"
"2014-05-06 12:30","Auditor.java","9340","80701","90041","7","180082"
"2014-05-23 18:48","Auditor.java","9351","81636","90987","7","181974"
"2012-12-13 12:33","LedgerRecoveryTest.java","16811","79825","96636","2","193272"
"2013-01-07 12:25","LedgerRecoveryTest.java","17403","85308","102711","2","205422"
"2013-06-12 18:41","LedgerRecoveryTest.java","18906","124381","143287","5","286574"
"2013-03-25 18:02","LedgerRecoveryTest.java","18718","119368","138086","4","276172"
"2014-02-05 22:43","LedgerRecoveryTest.java","19635","133511","153146","7","306292"
"2017-05-16 00:31","LedgerRecoveryTest.java","45752","111879","157631","","315262"
"2017-06-21 19:50","LedgerRecoveryTest.java","46358","117280","163638","","327276"
"2017-06-05 22:25","BookkeeperInternalCallbacks.java","1852","6494","8346","","16692"
"2017-08-02 00:49","BookkeeperInternalCallbacks.java","7739","36373","44112","","88224"
"2017-06-21 21:00","BookkeeperInternalCallbacks.java","1949","7945","9894","","19788"
"2017-06-05 22:13","BookkeeperInternalCallbacks.java","1598","5946","7544","","15088"
"2017-07-04 06:27","Bookie.java","1095","7972","9067","","18134"
"2017-06-28 23:24","Bookie.java","451","3495","3946","","7892"
"2017-07-07 08:19","Bookie.java","1234","10074","11308","","22616"
"2017-08-02 00:49","Bookie.java","6330","31413","37743","","75486"
"2017-05-15 19:52","DigestManager.java","2252","10598","12850","","25700"
"2017-05-25 14:23","DigestManager.java","2557","13185","15742","","31484"
"2012-12-13 12:33","LedgerRecoveryTest.java","16456","83752","100208","2","200416"
"2013-01-07 12:25","LedgerRecoveryTest.java","17030","89217","106247","2","212494"
"2012-02-13 15:46","LedgerRecoveryTest.java","426","4708","5134","1","10268"
"2013-06-12 18:41","LedgerRecoveryTest.java","18483","128240","146723","5","293446"
"2013-03-25 18:02","LedgerRecoveryTest.java","18281","123213","141494","4","282988"
"2014-02-05 22:43","LedgerRecoveryTest.java","19117","137275","156392","7","312784"
"2017-05-16 00:31","LedgerRecoveryTest.java","43175","113584","156759","","313518"
"2017-06-21 19:50","LedgerRecoveryTest.java","43313","118517","161830","","323660"
"2017-07-04 06:27","FileInfo.java","49927","113596","163523","","327046"
"2012-10-26 12:51","FileInfo.java","8870","48354","57224","2","114448"
"2014-12-04 12:28","FileInfo.java","15142","131404","146546","","293092"
"2017-01-31 04:01","FileInfo.java","48592","93487","142079","","284158"
"2017-03-23 15:55","FileInfo.java","48637","93898","142535","","285070"
"2016-11-18 00:18","FileInfo.java","48550","80344","128894","","257788"
"2012-12-18 13:04","FileInfo.java","9806","63310","73116","2","146232"
"2013-05-04 14:22","FileInfo.java","12681","101586","114267","5","228534"
"2017-06-01 23:58","FileInfo.java","49781","106215","155996","","311992"
"2017-07-17 23:27","FileInfo.java","50003","116779","166782","","333564"
"2017-05-16 00:31","FileInfo.java","49163","102822","151985","","303970"
"2013-10-22 16:21","FileInfo.java","13924","110830","124754","6","249508"
"2013-10-11 08:36","FileInfo.java","13633","109231","122864","6","245728"
"2017-06-30 00:12","BookKeeper.java","4207","16428","20635","","41270"
"2017-06-21 21:00","BookKeeper.java","3820","13570","17390","","34780"
"2017-07-28 20:12","BookKeeper.java","6033","24809","30842","","61684"
"2017-05-15 19:52","BookKeeper.java","2005","5759","7764","","15528"
"2017-01-31 04:01","Bookie.java","669","13240","13909","","27818"
"2017-03-28 22:37","Bookie.java","971","18349","19320","","38640"
"2017-07-04 06:27","Bookie.java","4871","36216","41087","","82174"
"2017-06-05 22:25","Bookie.java","4218","29777","33995","","67990"
"2017-06-28 23:24","Bookie.java","4344","31856","36200","","72400"
"2017-07-07 08:19","Bookie.java","4931","38239","43170","","86340"
"2017-05-16 00:31","Bookie.java","2804","24139","26943","","53886"
"2017-06-01 23:58","Bookie.java","3797","27907","31704","","63408"
"2017-08-02 00:49","Bookie.java","9311","58862","68173","","136346"
"2017-03-28 22:35","Bookie.java","931","18094","19025","","38050"
"2017-06-05 20:30","Bookie.java","3965","28433","32398","","64796"
"2017-03-22 22:54","Bookie.java","831","13690","14521","","29042"
"2017-06-01 23:58","BookieShell.java","3302","10249","13551","","27102"
"2017-07-07 05:11","BookieShell.java","4537","20399","24936","","49872"
"2017-07-04 06:27","SyncThreadTest.java","114889","84214","199103","","398206"
"2014-06-06 15:29","SyncThreadTest.java","3956","16770","20726","7","41452"
"2017-01-31 04:01","SyncThreadTest.java","112597","63148","175745","","351490"
"2016-04-14 00:51","SyncThreadTest.java","109565","37628","147193","","294386"
"2016-03-08 06:49","SyncThreadTest.java","6471","35160","41631","","83262"
"2017-03-28 22:37","SyncThreadTest.java","112697","68055","180752","","361504"
"2016-11-18 00:18","SyncThreadTest.java","112537","49987","162524","","325048"
"2017-05-16 00:31","SyncThreadTest.java","113607","72922","186529","","373058"
"2017-08-02 00:49","AbstractConfiguration.java","8670","38794","47464","","94928"
"2017-05-16 00:31","TestPerChannelBookieClient.java","2279","16512","18791","","37582"
"2017-05-15 19:52","TestPerChannelBookieClient.java","2090","15905","17995","","35990"
"2016-12-21 01:48","LedgerCacheTest.java","110674","25972","136646","","273292"
"2019-02-20 11:43","LedgerCacheTest.java","143025","397000","540025","","1080050"
"2017-05-16 00:31","LedgerCacheTest.java","112289","42915","155204","","310408"
"2014-05-23 18:46","BookieAutoRecoveryTest.java","24","354","378","7","756"
"2017-08-16 03:41","NetworkTopologyImpl.java","12047","69440","81487","","162974"
"2017-08-02 00:49","ConnectionPeer.java","9032","51481","60513","","121026"
"2017-06-01 08:55","NullStatsLogger.java","113558","50901","164459","","328918"
"2014-08-02 20:02","IndexInMemPageMgr.java","3086","19798","22884","","45768"
"2019-02-20 11:43","IndexInMemPageMgr.java","133291","413393","546684","","1093368"
"2017-06-01 23:58","IndexInMemPageMgr.java","113485","73013","186498","","372996"
"2016-04-05 08:50","IndexInMemPageMgr.java","108454","33723","142177","","284354"
"2017-07-28 20:12","BKException.java","115748","64275","180023","","360046"
"2016-07-11 22:53","BKException.java","105786","9013","114799","","229598"
"2017-05-02 23:04","BKException.java","111956","43971","155927","","311854"
"2017-08-02 00:49","BKException.java","118438","80577","199015","","398030"
"2017-01-31 04:01","BKException.java","111059","36218","147277","","294554"
"2015-10-06 10:48","BKException.java","55","605","660","","1320"
"2015-10-22 09:22","BKException.java","88","1468","1556","","3112"
"2016-02-09 08:12","FlatLedgerManager.java","8385","76751","85136","","170272"
"2013-04-04 11:21","FlatLedgerManager.java","3159","37896","41055","5","82110"
"2017-03-28 22:40","TestLedgerManager.java","111768","42264","154032","","308064"
"2014-08-02 20:02","IndexInMemPageMgr.java","3814","21834","25648","","51296"
"2019-02-20 11:43","IndexInMemPageMgr.java","133243","414653","547896","","1095792"
"2013-10-22 16:21","IndexInMemPageMgr.java","878","2186","3064","6","6128"
"2017-06-01 23:58","IndexInMemPageMgr.java","114026","74862","188888","","377776"
"2016-04-05 08:50","IndexInMemPageMgr.java","109100","35677","144777","","289554"
"2014-08-02 20:02","ServerConfiguration.java","4646","24261","28907","","57814"
"2014-05-06 12:30","ServerConfiguration.java","3828","14793","18621","7","37242"
"2014-05-15 00:41","ServerConfiguration.java","3848","15727","19575","7","39150"
"2014-09-18 06:47","ServerConfiguration.java","5082","26706","31788","","63576"
"2017-07-04 06:27","ServerConfiguration.java","114952","84618","199570","","399140"
"2014-03-07 13:14","ServerConfiguration.java","3600","12206","15806","7","31612"
"2014-04-29 22:07","ServerConfiguration.java","3825","14743","18568","7","37136"
"2016-04-14 00:51","ServerConfiguration.java","109637","38041","147678","","295356"
"2015-01-16 15:57","ServerConfiguration.java","5502","30098","35600","","71200"
"2016-03-08 06:49","ServerConfiguration.java","6543","35573","42116","","84232"
"2016-01-26 22:11","ServerConfiguration.java","6280","34296","40576","","81152"
"2014-01-21 05:05","ServerConfiguration.java","2239","8495","10734","6","21468"
"2014-03-12 21:26","ServerConfiguration.java","3729","14137","17866","7","35732"
"2016-04-05 18:47","ServerConfiguration.java","109613","37967","147580","","295160"
"2016-04-27 09:55","ServerConfiguration.java","109685","38601","148286","","296572"
"2015-04-21 09:55","ServerConfiguration.java","5559","30596","36155","","72310"
"2015-01-12 15:18","ServerConfiguration.java","5498","29156","34654","","69308"
"2015-04-21 10:02","ServerConfiguration.java","5569","30639","36208","","72416"
"2017-05-15 19:52","ServerConfiguration.java","113573","72811","186384","","372768"
"2017-03-22 22:54","ServerConfiguration.java","112751","63931","176682","","353364"
"2017-03-23 00:48","ServerConfiguration.java","112756","63988","176744","","353488"
"2017-01-31 02:11","ServerConfiguration.java","112663","57474","170137","","340274"
"2016-04-05 08:45","ServerConfiguration.java","109611","37723","147334","","294668"
"2016-11-09 03:02","ServerConfiguration.java","112613","50252","162865","","325730"
"2016-11-30 00:02","ServerConfiguration.java","112635","50956","163591","","327182"
"2017-06-05 20:30","ServerConfiguration.java","114513","77302","191815","","383630"
"2016-09-10 20:27","ServerConfiguration.java","111148","44998","156146","","312292"
"2017-08-02 00:49","ServerConfiguration.java","118067","105939","224006","","448012"
"2017-10-03 12:31","ServerConfiguration.java","125243","103272","228515","","457030"
"2017-08-16 03:37","ServerConfiguration.java","119590","114095","233685","","467370"
"2013-12-02 18:45","ServerConfiguration.java","1884","6890","8774","6","17548"
"2014-05-09 14:04","ServerConfiguration.java","3843","15402","19245","7","38490"
"2017-05-26 12:38","ServerConfiguration.java","113725","75279","189004","","378008"
"2014-01-15 15:58","ServerConfiguration.java","1973","7323","9296","6","18592"
"2013-10-22 07:44","ServerConfiguration.java","1682","4191","5873","6","11746"
"2017-07-07 08:19","ServerConfiguration.java","114943","86572","201515","","403030"
"2017-06-28 23:24","ServerConfiguration.java","114679","80512","195191","","390382"
"2017-11-08 12:27","ServerConfiguration.java","126686","122589","249275","","498550"
"2014-01-22 14:35","ServerConfiguration.java","2537","9808","12345","6","24690"
"2013-10-12 05:42","ServerConfiguration.java","1472","3608","5080","6","10160"
"2014-08-02 20:02","ServerConfiguration.java","3072","17681","20753","","41506"
"2014-05-06 12:30","ServerConfiguration.java","2117","8076","10193","7","20386"
"2014-05-15 00:41","ServerConfiguration.java","2137","9010","11147","7","22294"
"2014-09-18 06:47","ServerConfiguration.java","3515","20133","23648","","47296"
"2017-07-04 06:27","ServerConfiguration.java","114161","78821","192982","","385964"
"2014-03-07 13:14","ServerConfiguration.java","1866","5466","7332","7","14664"
"2014-04-29 22:07","ServerConfiguration.java","2114","8026","10140","7","20280"
"2016-04-14 00:51","ServerConfiguration.java","108529","31927","140456","","280912"
"2015-01-16 15:57","ServerConfiguration.java","3992","23582","27574","","55148"
"2016-03-08 06:49","ServerConfiguration.java","5185","29209","34394","","68788"
"2016-01-26 22:11","ServerConfiguration.java","4873","27883","32756","","65512"
"2014-01-21 05:05","ServerConfiguration.java","391","1641","2032","6","4064"
"2014-03-12 21:26","ServerConfiguration.java","1999","7401","9400","7","18800"
"2016-04-05 18:47","ServerConfiguration.java","108503","31851","140354","","280708"
"2016-04-27 09:55","ServerConfiguration.java","108580","32490","141070","","282140"
"2015-04-21 09:55","ServerConfiguration.java","4087","24118","28205","","56410"
"2015-01-12 15:18","ServerConfiguration.java","3983","22635","26618","","53236"
"2015-04-21 10:02","ServerConfiguration.java","4097","24161","28258","","56516"
"2017-05-15 19:52","ServerConfiguration.java","112633","66865","179498","","358996"
"2017-03-22 22:54","ServerConfiguration.java","111725","57899","169624","","339248"
"2017-03-23 00:48","ServerConfiguration.java","111730","57956","169686","","339372"
"2017-01-31 02:11","ServerConfiguration.java","111620","51425","163045","","326090"
"2016-04-05 08:45","ServerConfiguration.java","108495","31601","140096","","280192"
"2016-11-09 03:02","ServerConfiguration.java","111559","44192","155751","","311502"
"2016-11-30 00:02","ServerConfiguration.java","111584","44899","156483","","312966"
"2017-06-05 20:30","ServerConfiguration.java","113661","71444","185105","","370210"
"2016-09-10 20:27","ServerConfiguration.java","110089","38933","149022","","298044"
"2017-08-02 00:49","ServerConfiguration.java","117621","100487","218108","","436216"
"2017-10-03 12:31","ServerConfiguration.java","125063","98086","223149","","446298"
"2017-08-16 03:37","ServerConfiguration.java","119177","108676","227853","","455706"
"2014-05-09 14:04","ServerConfiguration.java","2132","8685","10817","7","21634"
"2017-05-26 12:38","ServerConfiguration.java","112812","69360","182172","","364344"
"2014-01-15 15:58","ServerConfiguration.java","112","456","568","6","1136"
"2017-07-07 08:19","ServerConfiguration.java","114157","80780","194937","","389874"
"2017-06-28 23:24","ServerConfiguration.java","113852","74679","188531","","377062"
"2017-11-08 12:27","ServerConfiguration.java","126688","117585","244273","","488546"
"2014-01-22 14:35","ServerConfiguration.java","723","2988","3711","6","7422"
"2013-10-12 05:42","SyncThread.java","1395","3190","4585","6","9170"
"2017-03-28 22:35","BookieClient.java","334","4926","5260","","10520"
"2017-01-31 04:01","BookKeeper.java","6189","27214","33403","","66806"
"2017-06-30 00:12","BookKeeper.java","9809","47647","57456","","114912"
"2016-10-13 07:50","BookKeeper.java","5395","12864","18259","","36518"
"2017-06-21 21:00","BookKeeper.java","9474","44841","54315","","108630"
"2017-03-28 22:35","BookKeeper.java","6386","32003","38389","","76778"
"2016-10-13 09:27","BookKeeper.java","5548","13003","18551","","37102"
"2017-07-28 20:12","BookKeeper.java","11279","55672","66951","","133902"
"2017-05-15 19:52","BookKeeper.java","7821","37192","45013","","90026"
"2014-02-05 22:43","TestAutoRecoveryAlongWithBookieServers.java","5084","49819","54903","7","109806"
"2017-07-04 06:27","FileInfo.java","48415","117757","166172","","332344"
"2012-10-26 12:51","FileInfo.java","10009","55166","65175","2","130350"
"2014-12-04 12:28","FileInfo.java","15407","137342","152749","","305498"
"2017-01-31 04:01","FileInfo.java","47150","97718","144868","","289736"
"2017-03-23 15:55","FileInfo.java","47164","98098","145262","","290524"
"2016-11-18 00:18","FileInfo.java","47108","84575","131683","","263366"
"2012-12-18 13:04","FileInfo.java","10879","70056","80935","2","161870"
"2013-05-04 14:22","FileInfo.java","13206","107784","120990","5","241980"
"2012-06-13 16:57","FileInfo.java","1811","7484","9295","","18590"
"2017-06-01 23:58","FileInfo.java","48286","110393","158679","","317358"
"2017-07-17 23:27","FileInfo.java","48461","120910","169371","","338742"
"2017-05-16 00:31","FileInfo.java","47675","107007","154682","","309364"
"2013-10-22 16:21","FileInfo.java","14337","116916","131253","6","262506"
"2013-10-11 08:36","FileInfo.java","14075","115346","129421","6","258842"
"2017-01-31 04:01","BookKeeper.java","857","14427","15284","","30568"
"2017-06-30 00:12","BookKeeper.java","4793","35176","39969","","79938"
"2017-06-21 21:00","BookKeeper.java","4451","32363","36814","","73628"
"2017-03-28 22:35","BookKeeper.java","1095","19257","20352","","40704"
"2017-07-28 20:12","BookKeeper.java","6326","43264","49590","","99180"
"2017-05-15 19:52","BookKeeper.java","2781","24697","27478","","54956"
"2017-03-28 22:40","FlatLedgerManagerFactory.java","60194","92755","152949","","305898"
"2015-09-15 10:38","FlatLedgerManagerFactory.java","12294","114661","126955","","253910"
"2012-09-07 07:04","FlatLedgerManagerFactory.java","1215","13036","14251","2","28502"
"2013-07-20 20:06","SyncThread.java","450","5735","6185","5","12370"
"2013-10-12 05:42","SyncThread.java","1780","8860","10640","6","21280"
"2017-06-01 23:58","LedgerMetadataImpl.java","8970","41534","50504","","101008"
"2017-07-28 20:12","LedgerMetadataImpl.java","11279","55672","66951","","133902"
"2014-08-02 20:02","Journal.java","4771","29484","34255","","68510"
"2014-03-07 13:14","Journal.java","3789","17493","21282","7","42564"
"2014-04-29 22:07","Journal.java","3970","19986","23956","7","47912"
"2013-12-06 07:39","Journal.java","2285","12541","14826","6","29652"
"2015-04-21 09:23","Journal.java","5282","35250","40532","","81064"
"2016-02-09 08:30","Journal.java","6095","39330","45425","","90850"
"2015-02-23 08:11","Journal.java","5272","35004","40276","","80552"
"2017-05-26 16:52","Journal.java","112043","78715","190758","","381516"
"2017-03-22 22:54","Journal.java","111092","67370","178462","","356924"
"2016-11-12 03:37","Journal.java","110968","53753","164721","","329442"
"2016-07-14 23:02","Journal.java","109632","44631","154263","","308526"
"2013-07-20 19:59","Journal.java","522","5620","6142","5","12284"
"2013-07-04 14:01","Journal.java","486","5347","5833","5","11666"
"2017-06-01 23:58","Journal.java","112764","80293","193057","","386114"
"2017-05-09 22:24","Journal.java","111584","74458","186042","","372084"
"2013-10-12 05:42","Journal.java","1843","9077","10920","6","21840"
"2013-10-02 06:23","Journal.java","805","7116","7921","5","15842"
"2017-05-16 00:31","Journal.java","111989","76743","188732","","377464"
"2014-08-02 20:02","Journal.java","4646","24261","28907","","57814"
"2014-03-07 13:14","Journal.java","3600","12206","15806","7","31612"
"2014-04-29 22:07","Journal.java","3825","14743","18568","7","37136"
"2013-12-06 07:39","Journal.java","1902","7060","8962","6","17924"
"2015-04-21 09:23","Journal.java","5539","30409","35948","","71896"
"2016-02-09 08:30","Journal.java","6366","34503","40869","","81738"
"2015-02-23 08:11","Journal.java","5527","30161","35688","","71376"
"2017-05-26 16:52","Journal.java","113726","75300","189026","","378052"
"2017-03-22 22:54","Journal.java","112751","63931","176682","","353364"
"2016-11-12 03:37","Journal.java","112614","50301","162915","","325830"
"2016-07-14 23:02","Journal.java","109938","39839","149777","","299554"
"2017-06-01 23:58","Journal.java","114452","76883","191335","","382670"
"2017-05-09 22:24","Journal.java","113245","71021","184266","","368532"
"2013-10-12 05:42","Journal.java","1472","3608","5080","6","10160"
"2013-10-02 06:23","Journal.java","381","1594","1975","5","3950"
"2017-05-16 00:31","Journal.java","113672","73328","187000","","374000"
"2017-06-01 23:58","ReadEntryProcessorV3.java","115213","58029","173242","","346484"
"2017-05-16 00:31","ReadEntryProcessorV3.java","114344","54385","168729","","337458"
"2017-05-15 19:52","ReadEntryProcessorV3.java","114187","53810","167997","","335994"
"2016-11-12 03:35","ReadEntryProcessorV3.java","112787","30834","143621","","287242"
"2017-06-05 22:25","ReadEntryProcessorV3.java","115521","59786","175307","","350614"
"2017-05-16 00:31","IndexPersistenceMgr.java","2479","11243","13722","","27444"
"2017-10-03 12:31","IndexPersistenceMgr.java","32313","59450","91763","","183526"
"2017-07-04 06:27","IndexPersistenceMgr.java","4684","23458","28142","","56284"
"2017-10-17 09:32","AuditorElector.java","130957","95219","226176","","452352"
"2016-07-14 23:02","AuditorElector.java","107464","15744","123208","","246416"
"2016-09-10 21:01","AuditorElector.java","110885","23235","134120","","268240"
"2017-03-28 22:40","AuditorElector.java","112889","47195","160084","","320168"
"2017-07-28 20:12","ReadLastConfirmedAndEntryOp.java","1802","6396","8198","","16396"
"2017-05-26 16:52","CodahaleMetricsProvider.java","2874","20392","23266","","46532"
"2013-05-04 14:22","GarbageCollectorThread.java","12776","103510","116286","5","232572"
"2013-09-11 00:34","GarbageCollectorThread.java","13066","110100","123166","5","246332"
"2014-01-15 15:58","GarbageCollectorThread.java","14014","115196","129210","6","258420"
"2013-10-22 07:44","GarbageCollectorThread.java","13880","112221","126101","6","252202"
"2017-05-09 23:06","GarbageCollectorThread.java","48417","102023","150440","","300880"
"2014-01-21 17:26","GarbageCollectorThread.java","14107","116834","130941","6","261882"
"2013-10-02 06:23","GarbageCollectorThread.java","13066","110111","123177","5","246354"
"2017-11-08 12:27","GarbageCollectorThread.java","52892","144627","197519","","395038"
"2012-12-24 05:50","GarbageCollectorThread.java","10317","65758","76075","2","152150"
"2017-03-28 22:39","GarbageCollectorThread.java","48209","99759","147968","","295936"
"2017-01-30 23:25","GarbageCollectorThread.java","48110","88695","136805","","273610"
"2016-05-04 15:55","GarbageCollectorThread.java","47919","72690","120609","","241218"
"2012-07-23 23:39","GarbageCollectorThread.java","4345","15923","20268","2","40536"
"2016-03-08 06:49","GarbageCollectorThread.java","15792","140654","156446","","312892"
"2016-02-24 00:44","GarbageCollectorThread.java","15784","140294","156078","","312156"
"2015-04-21 09:55","GarbageCollectorThread.java","15348","136217","151565","","303130"
"2013-10-30 16:23","GarbageCollectorThread.java","13995","114309","128304","6","256608"
"2016-11-09 08:49","ZeroBuffer.java","111511","46278","157789","","315578"
"2017-06-01 23:58","ReplicationWorker.java","115005","55815","170820","","341640"
"2017-04-11 20:14","ReplicationWorker.java","112938","47260","160198","","320396"
"2016-03-16 04:51","ReplicationWorker.java","106943","10528","117471","","234942"
"2016-09-10 21:01","ReplicationWorker.java","110885","23235","134120","","268240"
"2017-05-26 16:52","ReplicationWorker.java","114198","54151","168349","","336698"
"2015-04-21 09:17","ReplicationWorker.java","966","4211","5177","","10354"
"2017-03-28 22:40","TestLedgerManager.java","111215","53979","165194","","330388"
"2015-07-10 22:48","TestLedgerManager.java","2416","14684","17100","","34200"
"2016-12-21 01:48","LedgerCacheTest.java","111396","45316","156712","","313424"
"2019-02-20 11:43","LedgerCacheTest.java","135130","407727","542857","","1085714"
"2017-05-16 00:31","LedgerCacheTest.java","112644","61892","174536","","349072"
"2014-07-24 01:41","LedgerCacheTest.java","834","3589","4423","","8846"
"2014-12-10 19:43","LedgerCacheTest.java","2653","15036","17689","","35378"
"2016-03-08 06:49","LedgerCacheTest.java","3999","22621","26620","","53240"
"2016-12-21 01:48","LedgerCacheTest.java","79032","68211","147243","","294486"
"2013-02-12 06:00","LedgerCacheTest.java","3069","41263","44332","4","88664"
"2013-01-07 03:48","LedgerCacheTest.java","2145","8247","10392","2","20784"
"2012-12-24 05:50","LedgerCacheTest.java","1287","5747","7034","2","14068"
"2012-12-24 06:23","LedgerCacheTest.java","1361","6043","7404","2","14808"
"2019-02-20 11:43","LedgerCacheTest.java","96036","423892","519928","","1039856"
"2013-08-12 19:01","LedgerCacheTest.java","4870","50460","55330","5","110660"
"2013-10-12 05:42","LedgerCacheTest.java","5881","52868","58749","6","117498"
"2017-05-16 00:31","LedgerCacheTest.java","79806","84313","164119","","328238"
"2013-12-02 18:45","LedgerCacheTest.java","6106","55963","62069","6","124138"
"2014-07-24 01:41","LedgerCacheTest.java","7632","65646","73278","","146556"
"2014-12-10 19:43","LedgerCacheTest.java","8257","75899","84156","","168312"
"2016-03-08 06:49","LedgerCacheTest.java","9064","82945","92009","","184018"
"2014-03-12 21:26","LedgerCacheTest.java","7165","62424","69589","7","139178"
"2014-04-29 22:07","JournalChannel.java","209","2521","2730","7","5460"
"2017-07-07 08:19","CreateNewLogTest.java","4946","31822","36768","","73536"
"2017-06-01 23:58","GetBookieInfoProcessorV3.java","3302","10249","13551","","27102"
"2017-07-07 08:19","GetBookieInfoProcessorV3.java","4580","20725","25305","","50610"
"2012-05-25 17:13","BookieJournalTest.java","9668","20298","29966","1","59932"
"2012-07-05 14:45","BookieJournalTest.java","10631","29726","40357","2","80714"
"2014-04-29 22:07","BookieJournalTest.java","19710","136891","156601","7","313202"
"2014-12-10 19:43","BookieJournalTest.java","20218","149272","169490","","338980"
"2017-05-15 19:52","BookieJournalTest.java","45729","111230","156959","","313918"
"2012-03-13 07:31","BookieJournalTest.java","1006","4949","5955","1","11910"
"2012-03-29 15:18","BookieJournalTest.java","8376","14963","23339","1","46678"
"2017-05-16 00:31","BookieJournalTest.java","45772","111691","157463","","314926"
"2013-10-11 08:36","BookieJournalTest.java","19041","126899","145940","6","291880"
"2013-10-12 05:42","BookieJournalTest.java","19102","127501","146603","6","293206"
"2016-04-05 08:45","BookieClient.java","40190","86779","126969","","253938"
"2017-03-28 22:35","BookieClient.java","40277","114238","154515","","309030"
"2013-10-29 05:14","BookieClient.java","18980","140496","159476","6","318952"
"2014-02-05 22:43","BookieClient.java","19159","145041","164200","7","328400"
"2011-11-18 11:18","BookieClient.java","3592","7221","10813","","21626"
"2017-01-31 04:01","BookieClient.java","40292","109661","149953","","299906"
"2014-04-24 10:43","BookieAutoRecoveryTest.java","422","3557","3979","7","7958"
"2014-05-23 18:46","BookieAutoRecoveryTest.java","524","5008","5532","7","11064"
"2014-05-09 14:04","BookieAutoRecoveryTest.java","510","4664","5174","7","10348"
"2015-03-12 08:21","AuditorPeriodicCheckTest.java","6716","69308","76024","","152048"
"2014-04-24 14:44","AuditorPeriodicCheckTest.java","5496","53994","59490","7","118980"
"2013-05-31 12:02","AuditorPeriodicCheckTest.java","2361","35648","38009","5","76018"
"2013-10-11 08:36","AuditorPeriodicCheckTest.java","3666","43217","46883","6","93766"
"2014-02-05 22:43","AuditorPeriodicCheckTest.java","5201","50562","55763","7","111526"
"2017-05-16 00:31","AuditorPeriodicCheckTest.java","81347","78959","160306","","320612"
"2014-07-25 00:34","AuditorPeriodicCheckTest.java","6210","63151","69361","","138722"
"2016-09-10 21:01","AuditorPeriodicCheckTest.java","80338","52265","132603","","265206"
"2014-03-07 13:14","LogMark.java","3789","17493","21282","7","42564"
"2016-09-10 21:01","UpdateLedgerOpTest.java","110237","19737","129974","","259948"
"2012-12-03 15:04","InMemoryMetaStore.java","945","3490","4435","2","8870"
"2012-12-12 18:26","LedgerDirsManager.java","1998","14474","16472","2","32944"
"2013-01-09 17:18","LedgerDirsManager.java","4235","21886","26121","2","52242"
"2017-06-05 20:30","LedgerDirsManager.java","74230","93064","167294","","334588"
"2017-01-30 23:25","LedgerDirsManager.java","72735","73533","146268","","292536"
"2017-03-28 22:35","LedgerDirsManager.java","72824","84353","157177","","314354"
"2013-12-02 18:45","LedgerDirsManager.java","7581","68632","76213","6","152426"
"2014-01-15 15:58","LedgerDirsManager.java","7660","69055","76715","6","153430"
"2017-06-28 23:24","LedgerDirsManager.java","74280","96158","170438","","340876"
"2017-07-07 08:19","LedgerDirsManager.java","74455","102129","176584","","353168"
"2014-01-21 17:26","LedgerDirsManager.java","7840","70780","78620","6","157240"
"2013-10-02 07:01","LedgerDirsManager.java","6555","64003","70558","5","141116"
"2014-08-02 20:02","LedgerDirsManager.java","9204","84864","94068","","188136"
"2017-06-01 23:58","BookieShell.java","3757","21543","25300","","50600"
"2017-07-07 05:11","BookieShell.java","4921","31622","36543","","73086"
"2017-03-28 22:35","BookieShell.java","844","11683","12527","","25054"
"2017-03-22 22:54","BookieShell.java","744","7279","8023","","16046"
"2017-10-17 09:32","BookKeeperAdmin.java","130983","95377","226360","","452720"
"2017-06-01 23:58","BookKeeperAdmin.java","115037","55979","171016","","342032"
"2017-04-11 20:19","BookKeeperAdmin.java","113016","47473","160489","","320978"
"2017-07-07 05:11","BookKeeperAdmin.java","115982","65839","181821","","363642"
"2016-11-09 03:05","BookKeeperAdmin.java","112551","28718","141269","","282538"
"2016-11-30 00:07","BookKeeperAdmin.java","112610","29441","142051","","284102"
"2016-09-10 21:01","BookKeeperAdmin.java","110924","23406","134330","","268660"
"2016-07-14 23:02","BookKeeperAdmin.java","107503","15915","123418","","246836"
"2016-10-13 09:27","BookKeeperAdmin.java","112517","28350","140867","","281734"
"2016-03-16 05:03","BookKeeperAdmin.java","107001","10921","117922","","235844"
"2016-03-08 07:18","BookKeeperAdmin.java","2593","10799","13392","","26784"
"2014-12-06 08:03","BookKeeperAdmin.java","493","1630","2123","","4246"
"2016-10-13 07:50","NodeBase.java","112110","50442","162552","","325104"
"2014-07-24 01:41","TestEntryLog.java","3366","14393","17759","","35518"
"2014-12-10 19:43","TestEntryLog.java","4587","25242","29829","","59658"
"2016-02-24 00:44","TestEntryLog.java","5665","32207","37872","","75744"
"2014-03-12 21:26","TestEntryLog.java","2716","10988","13704","7","27408"
"2017-05-16 00:31","TestEntryLog.java","113176","70696","183872","","367744"
"2017-07-07 08:19","TestEntryLog.java","114509","84002","198511","","397022"
"2014-07-24 01:41","ConcurrentLedgerTest.java","20313","138053","158366","","316732"
"2014-12-10 19:43","ConcurrentLedgerTest.java","20582","147950","168532","","337064"
"2013-10-12 05:42","ConcurrentLedgerTest.java","19368","126081","145449","6","290898"
"2014-02-05 22:43","ConcurrentLedgerTest.java","19957","131939","151896","7","303792"
"2017-05-16 00:31","ConcurrentLedgerTest.java","46287","110520","156807","","313614"
"2014-12-10 19:43","UpgradeTest.java","4693","25889","30582","","61164"
"2017-05-15 19:52","UpgradeTest.java","113128","70771","183899","","367798"
"2013-10-12 05:42","UpgradeTest.java","214","755","969","6","1938"
"2014-12-10 19:43","UpgradeTest.java","4587","25242","29829","","59658"
"2017-05-15 19:52","UpgradeTest.java","113068","70170","183238","","366476"
"2014-01-21 05:05","BookieRequestHandler.java","3224","16224","19448","6","38896"
"2013-09-11 00:34","BookieRequestHandler.java","1522","9468","10990","5","21980"
"2017-08-02 00:49","BookieRequestHandler.java","116036","110652","226688","","453376"
"2017-05-15 19:52","BookieRequestHandler.java","111646","77628","189274","","378548"
"2013-05-04 14:22","GarbageCollectorThread.java","13317","105813","119130","5","238260"
"2013-09-11 00:34","GarbageCollectorThread.java","13605","112401","126006","5","252012"
"2014-01-15 15:58","GarbageCollectorThread.java","14547","117491","132038","6","264076"
"2013-10-22 07:44","GarbageCollectorThread.java","14413","114516","128929","6","257858"
"2017-05-09 23:06","GarbageCollectorThread.java","47892","103260","151152","","302304"
"2014-01-21 17:26","GarbageCollectorThread.java","14640","119129","133769","6","267538"
"2013-10-02 06:23","GarbageCollectorThread.java","13605","112412","126017","5","252034"
"2017-11-08 12:27","GarbageCollectorThread.java","51974","145471","197445","","394890"
"2012-12-24 05:50","GarbageCollectorThread.java","10949","68152","79101","2","158202"
"2017-03-28 22:39","GarbageCollectorThread.java","47684","100996","148680","","297360"
"2017-01-30 23:25","GarbageCollectorThread.java","47586","89933","137519","","275038"
"2016-05-04 15:55","GarbageCollectorThread.java","47410","73943","121353","","242706"
"2012-07-23 23:39","GarbageCollectorThread.java","5114","18454","23568","2","47136"
"2016-03-08 06:49","GarbageCollectorThread.java","16299","142923","159222","","318444"
"2016-02-24 00:44","GarbageCollectorThread.java","16288","142560","158848","","317696"
"2015-04-21 09:55","GarbageCollectorThread.java","15854","138485","154339","","308678"
"2012-05-17 19:07","GarbageCollectorThread.java","787","2549","3336","1","6672"
"2013-10-30 16:23","GarbageCollectorThread.java","14528","116604","131132","6","262264"
"2017-05-16 00:31","LedgerDescriptorImpl.java","2479","11243","13722","","27444"
"2017-07-04 06:27","LedgerDescriptorImpl.java","4684","23458","28142","","56284"
"2017-06-05 22:25","LedgerDescriptorImpl.java","3944","16932","20876","","41752"
"2017-07-07 08:19","TestEntryLog.java","2510","14483","16993","","33986"
"2017-10-17 09:32","AuditorElector.java","79842","125168","205010","","410020"
"2013-08-21 13:19","AuditorElector.java","7447","67997","75444","5","150888"
"2016-07-14 23:02","AuditorElector.java","69892","59236","129128","","258256"
"2016-09-10 21:01","AuditorElector.java","70812","64226","135038","","270076"
"2013-03-05 18:45","AuditorElector.java","6581","59440","66021","4","132042"
"2012-12-18 12:00","AuditorElector.java","3572","22226","25798","2","51596"
"2012-12-14 11:18","AuditorElector.java","3315","21350","24665","2","49330"
"2012-12-08 11:18","AuditorElector.java","3006","17598","20604","2","41208"
"2017-03-28 22:40","AuditorElector.java","71123","86493","157616","","315232"
"2014-06-02 11:54","AuditorElector.java","9632","81753","91385","7","182770"
"2014-04-24 10:43","AuditorElector.java","9473","79456","88929","7","177858"
"2014-09-06 07:58","AuditorElector.java","10140","91204","101344","","202688"
"2013-01-04 11:32","AuditorElector.java","4920","25585","30505","2","61010"
"2017-05-04 20:58","AbstractZkLedgerManager.java","48536","99547","148083","","296166"
"2013-07-29 12:30","AbstractZkLedgerManager.java","12462","106359","118821","5","237642"
"2017-06-01 23:58","AbstractZkLedgerManager.java","49427","105095","154522","","309044"
"2017-06-12 17:20","AbstractZkLedgerManager.java","49448","106893","156341","","312682"
"2012-12-24 05:50","AbstractZkLedgerManager.java","9710","62556","72266","2","144532"
"2013-03-25 06:27","AbstractZkLedgerManager.java","11968","99041","111009","4","222018"
"2012-08-28 14:25","AbstractZkLedgerManager.java","4701","30061","34762","2","69524"
"2017-03-28 22:40","AbstractZkLedgerManager.java","48290","97454","145744","","291488"
"2016-02-09 08:23","AbstractZkLedgerManager.java","15327","136542","151869","","303738"
"2015-09-15 10:38","AbstractZkLedgerManager.java","15234","134204","149438","","298876"
"2012-12-08 11:18","AbstractZkLedgerManager.java","8777","57163","65940","2","131880"
"2016-02-23 19:16","AbstractZkLedgerManager.java","15331","136884","152215","","304430"
"2014-05-12 08:10","AbstractZkLedgerManager.java","14183","119297","133480","7","266960"
"2014-01-17 18:13","AbstractZkLedgerManager.java","13555","112498","126053","6","252106"
"2012-12-13 12:33","LedgerRecoveryTest.java","15996","91066","107062","2","214124"
"2013-01-07 12:25","LedgerRecoveryTest.java","16325","96286","112611","2","225222"
"2011-11-17 11:16","LedgerRecoveryTest.java","1003","3394","4397","","8794"
"2012-02-13 15:46","LedgerRecoveryTest.java","2828","14884","17712","1","35424"
"2012-01-17 16:52","LedgerRecoveryTest.java","2597","10371","12968","1","25936"
"2013-06-12 18:41","LedgerRecoveryTest.java","17655","135186","152841","5","305682"
"2013-03-25 18:02","LedgerRecoveryTest.java","17493","130199","147692","4","295384"
"2014-02-05 22:43","LedgerRecoveryTest.java","18053","143985","162038","7","324076"
"2017-05-16 00:31","LedgerRecoveryTest.java","39739","117922","157661","","315322"
"2017-06-21 19:50","LedgerRecoveryTest.java","39849","122827","162676","","325352"
"2017-05-15 19:52","LedgerHandle.java","80990","78794","159784","","319568"
"2017-05-02 22:07","LedgerHandle.java","80427","75877","156304","","312608"
"2017-03-23 15:55","LedgerHandle.java","80314","70138","150452","","300904"
"2016-09-10 21:01","LedgerHandle.java","80070","52607","132677","","265354"
"2016-07-11 23:01","LedgerHandle.java","78813","47246","126059","","252118"
"2013-04-26 18:38","LedgerHandle.java","2370","35478","37848","5","75696"
"2013-10-14 18:32","LedgerHandle.java","4330","45125","49455","6","98910"
"2014-02-05 22:43","LedgerHandle.java","5529","51500","57029","7","114058"
"2014-02-21 19:01","LedgerHandle.java","5663","52797","58460","7","116920"
"2017-05-17 08:57","LedgerHandle.java","81085","79366","160451","","320902"
"2017-05-25 14:23","LedgerHandle.java","81117","81203","162320","","324640"
"2017-06-21 19:50","LedgerHandle.java","82002","85019","167021","","334042"
"2017-06-21 21:00","LedgerHandle.java","82007","85807","167814","","335628"
"2017-06-01 23:58","LedgerHandle.java","81817","82814","164631","","329262"
"2014-01-21 05:19","LedgerHandle.java","4661","49829","54490","6","108980"
"2014-09-18 06:47","LedgerHandle.java","6586","66776","73362","","146724"
"2014-12-09 19:57","LedgerHandle.java","6704","67987","74691","","149382"
"2017-07-04 06:27","LedgerHandle.java","82287","90519","172806","","345612"
"2017-06-30 00:12","LedgerHandle.java","82184","88455","170639","","341278"
"2014-05-30 14:01","LedgerHandle.java","5908","56976","62884","7","125768"
"2014-05-30 15:07","LedgerHandle.java","5928","57035","62963","7","125926"
"2014-01-17 18:13","LedgerHandle.java","4587","48859","53446","6","106892"
"2016-02-09 08:32","LedgerHandle.java","7801","74515","82316","","164632"
"2016-03-16 05:03","LedgerHandle.java","78622","42597","121219","","242438"
"2015-10-22 09:22","LedgerHandle.java","7687","73366","81053","","162106"
"2015-10-06 10:05","LedgerHandle.java","7657","72280","79937","","159874"
"2017-01-31 04:01","LedgerHandle.java","80233","69691","149924","","299848"
"2015-04-21 09:39","LedgerHandle.java","7009","70461","77470","","154940"
"2015-10-06 11:12","LedgerHandle.java","7660","72523","80183","","160366"
"2014-12-05 14:10","LedgerHandle.java","6663","67497","74160","","148320"
"2013-01-04 11:32","ServerConfiguration.java","17513","83356","100869","2","201738"
"2014-08-02 20:02","ServerConfiguration.java","20517","144753","165270","","330540"
"2014-05-06 12:30","ServerConfiguration.java","20108","135694","155802","7","311604"
"2014-05-15 00:41","ServerConfiguration.java","20108","136608","156716","7","313432"
"2014-09-18 06:47","ServerConfiguration.java","20528","146773","167301","","334602"
"2017-07-04 06:27","ServerConfiguration.java","47009","121296","168305","","336610"
"2014-03-07 13:14","ServerConfiguration.java","20072","133299","153371","7","306742"
"2014-04-29 22:07","ServerConfiguration.java","20108","135647","155755","7","311510"
"2012-10-18 16:40","ServerConfiguration.java","16175","64751","80926","2","161852"
"2012-09-12 20:34","ServerConfiguration.java","13372","53899","67271","2","134542"
"2016-04-14 00:51","ServerConfiguration.java","45689","78714","124403","","248806"
"2015-01-16 15:57","ServerConfiguration.java","20640","149857","170497","","340994"
"2013-02-08 19:08","ServerConfiguration.java","18014","116018","134032","4","268064"
"2016-03-08 06:49","ServerConfiguration.java","20886","154537","175423","","350846"
"2016-01-26 22:11","ServerConfiguration.java","20875","153512","174387","","348774"
"2014-01-21 05:05","ServerConfiguration.java","19635","130512","150147","6","300294"
"2014-03-12 21:26","ServerConfiguration.java","20081","135110","155191","7","310382"
"2016-04-05 18:47","ServerConfiguration.java","45674","78649","124323","","248646"
"2016-04-27 09:55","ServerConfiguration.java","45690","79227","124917","","249834"
"2015-04-21 09:55","ServerConfiguration.java","20659","150317","170976","","341952"
"2015-01-12 15:18","ServerConfiguration.java","20639","148918","169557","","339114"
"2015-04-21 10:02","ServerConfiguration.java","20660","150351","171011","","342022"
"2013-01-14 16:59","ServerConfiguration.java","17886","85177","103063","2","206126"
"2012-11-30 04:54","ServerConfiguration.java","16559","75747","92306","2","184612"
"2017-05-15 19:52","ServerConfiguration.java","46294","110153","156447","","312894"
"2017-03-22 22:54","ServerConfiguration.java","45856","101657","147513","","295026"
"2012-12-11 18:59","ServerConfiguration.java","16768","76912","93680","2","187360"
"2017-03-23 00:48","ServerConfiguration.java","45859","101712","147571","","295142"
"2017-01-31 02:11","ServerConfiguration.java","45835","95267","141102","","282204"
"2013-02-19 16:19","ServerConfiguration.java","18801","116758","135559","4","271118"
"2013-02-19 16:15","ServerConfiguration.java","18801","116739","135540","4","271080"
"2016-04-05 08:45","ServerConfiguration.java","45672","78405","124077","","248154"
"2016-11-09 03:02","ServerConfiguration.java","45819","88079","133898","","267796"
"2016-11-30 00:02","ServerConfiguration.java","45814","88756","134570","","269140"
"2017-06-05 20:30","ServerConfiguration.java","46903","114313","161216","","322432"
"2016-09-10 20:27","ServerConfiguration.java","45744","84215","129959","","259918"
"2012-03-29 15:18","ServerConfiguration.java","8239","13184","21423","1","42846"
"2017-08-02 00:49","ServerConfiguration.java","47751","140244","187995","","375990"
"2017-10-03 12:31","ServerConfiguration.java","48998","131648","180646","","361292"
"2017-08-16 03:37","ServerConfiguration.java","48575","147701","196276","","392552"
"2013-07-20 19:59","ServerConfiguration.java","19257","123878","143135","5","286270"
"2013-12-02 18:45","ServerConfiguration.java","19590","129217","148807","6","297614"
"2014-05-09 14:04","ServerConfiguration.java","20108","136288","156396","7","312792"
"2017-05-26 12:38","ServerConfiguration.java","46374","112549","158923","","317846"
"2013-06-15 19:05","ServerConfiguration.java","19221","123273","142494","5","284988"
"2014-01-15 15:58","ServerConfiguration.java","19608","129579","149187","6","298374"
"2013-10-22 07:44","ServerConfiguration.java","19501","126631","146132","6","292264"
"2017-07-07 08:19","ServerConfiguration.java","47003","123253","170256","","340512"
"2017-06-28 23:24","ServerConfiguration.java","46952","117406","164358","","328716"
"2017-11-08 12:27","ServerConfiguration.java","49703","150227","199930","","399860"
"2014-01-22 14:35","ServerConfiguration.java","19789","131681","151470","6","302940"
"2013-10-12 05:42","ServerConfiguration.java","19426","126183","145609","6","291218"
"2014-07-24 01:41","ConcurrentLedgerTest.java","19965","139587","159552","","319104"
"2014-12-10 19:43","ConcurrentLedgerTest.java","20198","149448","169646","","339292"
"2012-03-08 19:24","ConcurrentLedgerTest.java","529","2411","2940","1","5880"
"2013-10-12 05:42","ConcurrentLedgerTest.java","19095","127690","146785","6","293570"
"2014-02-05 22:43","ConcurrentLedgerTest.java","19626","133490","153116","7","306232"
"2017-05-16 00:31","ConcurrentLedgerTest.java","45746","111861","157607","","315214"
"2014-02-05 22:43","LedgerRecoveryTest.java","3504","11905","15409","7","30818"
"2017-05-16 00:31","LedgerRecoveryTest.java","113265","73917","187182","","374364"
"2017-06-21 19:50","LedgerRecoveryTest.java","114241","79688","193929","","387858"
"2015-04-21 09:17","OpStatsLogger.java","4074","25340","29414","","58828"
"2012-05-25 17:13","ReadLastConfirmedOp.java","9682","20520","30202","1","60404"
"2017-06-30 00:12","ReadLastConfirmedOp.java","46370","120546","166916","","333832"
"2012-08-27 14:43","ReadLastConfirmedOp.java","13037","48378","61415","2","122830"
"2012-09-14 15:42","ReadLastConfirmedOp.java","13593","55912","69505","2","139010"
"2017-05-15 19:52","ReadLastConfirmedOp.java","45709","111418","157127","","314254"
"2012-04-02 12:38","ReadLastConfirmedOp.java","8537","16308","24845","1","49690"
"2017-06-01 23:58","ReadLastConfirmedOp.java","46313","115215","161528","","323056"
"2014-02-21 19:01","ReadLastConfirmedOp.java","19675","134714","154389","7","308778"
"2017-07-04 06:27","LedgerStorage.java","113249","88013","201262","","402524"
"2017-03-28 22:37","LedgerStorage.java","111109","71906","183015","","366030"
"2016-03-08 06:49","LedgerStorage.java","6272","40400","46672","","93344"
"2017-01-31 04:01","LedgerStorage.java","111011","67001","178012","","356024"
"2016-11-18 00:18","LedgerStorage.java","110963","53852","164815","","329630"
"2017-05-16 00:31","LedgerStorage.java","111989","76743","188732","","377464"
"2017-06-01 23:58","ReplicationWorker.java","72391","94265","166656","","333312"
"2017-04-11 20:14","ReplicationWorker.java","71157","86543","157700","","315400"
"2014-02-05 22:43","ReplicationWorker.java","9346","76194","85540","7","171080"
"2013-10-02 06:23","ReplicationWorker.java","7529","68185","75714","5","151428"
"2016-03-16 04:51","ReplicationWorker.java","69663","54312","123975","","247950"
"2016-09-10 21:01","ReplicationWorker.java","70812","64226","135038","","270076"
"2017-05-26 16:52","ReplicationWorker.java","71756","92773","164529","","329058"
"2012-12-18 12:00","ReplicationWorker.java","3572","22226","25798","2","51596"
"2015-04-21 09:17","ReplicationWorker.java","10521","94830","105351","","210702"
"2013-01-03 11:06","ReplicationWorker.java","4885","24735","29620","2","59240"
"2013-12-06 07:39","ReplicationWorker.java","8587","73188","81775","6","163550"
"2014-04-24 10:43","ReplicationWorker.java","9473","79456","88929","7","177858"
"2014-09-06 07:58","ReplicationWorker.java","10140","91204","101344","","202688"
"2017-03-23 00:48","ClientConfiguration.java","112395","41085","153480","","306960"
"2016-04-05 08:45","ClientConfiguration.java","106653","12223","118876","","237752"
"2017-03-28 22:35","ClientConfiguration.java","112447","45389","157836","","315672"
"2017-01-31 02:14","ClientConfiguration.java","112260","35141","147401","","294802"
"2017-04-15 13:58","ClientConfiguration.java","112707","46749","159456","","318912"
"2017-03-23 00:59","ClientConfiguration.java","112402","41104","153506","","307012"
"2017-05-15 19:52","ClientConfiguration.java","113655","50351","164006","","328012"
"2016-10-13 07:50","ClientConfiguration.java","112007","26801","138808","","277616"
"2017-06-21 19:58","ClientConfiguration.java","115114","57133","172247","","344494"
"2017-06-05 21:48","ClientConfiguration.java","114814","55445","170259","","340518"
"2017-06-21 19:50","ClientConfiguration.java","115109","57018","172127","","344254"
"2017-08-02 00:49","ClientConfiguration.java","119423","84753","204176","","408352"
"2017-08-01 08:34","ClientConfiguration.java","118858","81603","200461","","400922"
"2017-06-30 00:12","ClientConfiguration.java","115446","60609","176055","","352110"
"2017-07-04 06:27","ClientConfiguration.java","115611","62735","178346","","356692"
"2017-01-31 04:01","ClientConfiguration.java","112262","40612","152874","","305748"
"2015-10-06 10:05","ClientConfiguration.java","1593","5108","6701","","13402"
"2015-10-06 10:48","ClientConfiguration.java","1599","5340","6939","","13878"
"2016-02-09 08:32","ClientConfiguration.java","1787","7393","9180","","18360"
"2016-08-01 08:04","ClientConfiguration.java","107118","15142","122260","","244520"
"2017-05-15 19:52","BookKeeperClusterTestCase.java","80990","78794","159784","","319568"
"2013-01-09 17:18","BookKeeperClusterTestCase.java","422","594","1016","2","2032"
"2016-04-05 08:45","BookKeeperClusterTestCase.java","78615","45293","123908","","247816"
"2017-08-01 08:34","BookKeeperClusterTestCase.java","84841","108694","193535","","387070"
"2013-10-12 05:42","BookKeeperClusterTestCase.java","4239","44941","49180","6","98360"
"2014-02-05 22:43","BookKeeperClusterTestCase.java","5529","51500","57029","7","114058"
"2017-11-08 12:27","BookKeeperClusterTestCase.java","93260","127729","220989","","441978"
"2013-06-15 19:05","BookKeeperClusterTestCase.java","2931","40928","43859","5","87718"
"2014-05-09 14:04","BookKeeperClusterTestCase.java","5852","55977","61829","7","123658"
"2017-07-04 06:27","BookKeeperClusterTestCase.java","82287","90519","172806","","345612"
"2014-07-24 01:41","BookKeeperClusterTestCase.java","6314","58043","64357","","128714"
"2014-05-23 18:46","BookKeeperClusterTestCase.java","5858","56313","62171","7","124342"
"2017-06-30 00:12","BookKeeperClusterTestCase.java","82184","88455","170639","","341278"
"2014-04-24 10:43","BookKeeperClusterTestCase.java","5789","54895","60684","7","121368"
"2016-04-27 09:55","BookKeeperClusterTestCase.java","78685","46167","124852","","249704"
"2015-10-06 10:48","BookKeeperClusterTestCase.java","7660","72509","80169","","160338"
"2014-12-10 19:43","BookKeeperClusterTestCase.java","6964","68321","75285","","150570"
"2012-05-25 17:13","ReadLastConfirmedOp.java","1469","4536","6005","1","12010"
"2017-06-30 00:12","ReadLastConfirmedOp.java","48697","115102","163799","","327598"
"2012-08-27 14:43","ReadLastConfirmedOp.java","6623","34193","40816","2","81632"
"2012-09-14 15:42","ReadLastConfirmedOp.java","7293","41841","49134","2","98268"
"2017-05-15 19:52","ReadLastConfirmedOp.java","47971","105909","153880","","307760"
"2017-06-01 23:58","ReadLastConfirmedOp.java","48634","109765","158399","","316798"
"2014-02-21 19:01","ReadLastConfirmedOp.java","15209","122477","137686","7","275372"
"2019-02-20 11:43","IndexInMemPageMgr.java","51322","371896","423218","","846436"
"2017-06-01 23:58","MSLedgerManagerFactory.java","113520","64074","177594","","355188"
"2015-09-15 10:38","MSLedgerManagerFactory.java","3534","17390","20924","","41848"
"2017-03-28 22:40","MSLedgerManagerFactory.java","111633","55683","167316","","334632"
"2017-03-28 22:40","AbstractConfiguration.java","314","5009","5323","","10646"
"2017-08-02 00:49","AbstractConfiguration.java","9191","45831","55022","","110044"
"2017-05-02 23:04","AbstractConfiguration.java","1021","7537","8558","","17116"
"2017-05-15 19:52","SlowBookieTest.java","112690","65672","178362","","356724"
"2014-02-05 22:43","SlowBookieTest.java","1266","2415","3681","7","7362"
"2017-07-28 20:12","MacDigestManager.java","3971","18516","22487","","44974"
"2017-07-28 20:12","BKException.java","6172","29540","35712","","71424"
"2017-05-02 23:04","BKException.java","1187","8043","9230","","18460"
"2017-08-02 00:49","BKException.java","9319","46299","55618","","111236"
"2012-12-24 05:50","LedgerCacheImpl.java","3110","17238","20348","2","40696"
"2016-11-18 00:18","LedgerCacheImpl.java","73894","66204","140098","","280196"
"2012-12-18 13:04","LedgerCacheImpl.java","2483","16503","18986","2","37972"
"2017-05-16 00:31","LedgerCacheImpl.java","74698","88873","163571","","327142"
"2013-10-11 08:36","LedgerCacheImpl.java","7349","63463","70812","6","141624"
"2017-06-01 23:58","LedgerCacheImpl.java","75384","92334","167718","","335436"
"2014-08-02 20:02","LedgerCacheImpl.java","9326","83460","92786","","185572"
"2017-07-04 06:27","LedgerCacheImpl.java","75679","99864","175543","","351086"
"2017-01-31 04:01","LedgerCacheImpl.java","73947","79358","153305","","306610"
"2017-07-28 20:12","BKException.java","41035","133321","174356","","348712"
"2016-07-11 22:53","BKException.java","40438","87424","127862","","255724"
"2017-05-02 23:04","BKException.java","40496","116270","156766","","313532"
"2013-09-10 15:14","BKException.java","18930","138119","157049","5","314098"
"2014-02-21 19:01","BKException.java","19292","145886","165178","7","330356"
"2012-04-02 12:38","BKException.java","11728","31054","42782","1","85564"
"2017-08-02 00:49","BKException.java","41431","147329","188760","","377520"
"2012-12-12 11:20","BKException.java","17226","91554","108780","2","217560"
"2012-06-19 12:39","BKException.java","12623","37412","50035","2","100070"
"2011-11-16 17:05","BKException.java","2605","3852","6457","","12914"
"2015-09-15 10:38","BKException.java","19678","163437","183115","","366230"
"2017-01-31 04:01","BKException.java","40508","109426","149934","","299868"
"2015-10-06 10:48","BKException.java","19681","163990","183671","","367342"
"2015-10-22 09:22","BKException.java","19685","164824","184509","","369018"
"2012-09-04 10:39","BKException.java","14478","66328","80806","2","161612"
"2012-12-03 17:59","BKException.java","17110","90240","107350","2","214700"
"2013-06-12 18:41","LedgerRecoveryTest.java","693","5518","6211","5","12422"
"2014-02-05 22:43","LedgerRecoveryTest.java","3809","17035","20844","7","41688"
"2017-05-16 00:31","LedgerRecoveryTest.java","112084","77561","189645","","379290"
"2017-06-21 19:50","LedgerRecoveryTest.java","113053","83325","196378","","392756"
"2012-12-03 06:23","BookKeeperTest.java","5669","44757","50426","2","100852"
"2016-02-09 08:39","BookKeeperTest.java","12597","125124","137721","","275442"
"2015-10-16 07:00","BookKeeperTest.java","12505","123136","135641","","271282"
"2016-04-08 19:43","BookKeeperTest.java","53325","66029","119354","","238708"
"2017-01-31 04:01","BookKeeperTest.java","54001","89215","143216","","286432"
"2014-07-24 01:41","BookKeeperTest.java","11656","109141","120797","","241594"
"2017-05-15 19:52","BookKeeperTest.java","54557","98117","152674","","305348"
"2017-05-02 22:07","BookKeeperTest.java","54114","95320","149434","","298868"
"2013-05-06 19:32","BookKeeperTest.java","9310","88634","97944","5","195888"
"2013-01-10 19:13","BookKeeperTest.java","7761","54127","61888","2","123776"
"2012-05-25 17:13","BookieJournalTest.java","1654","5697","7351","1","14702"
"2012-07-05 14:45","BookieJournalTest.java","3986","16494","20480","2","40960"
"2014-04-29 22:07","BookieJournalTest.java","14912","125506","140418","7","280836"
"2014-12-10 19:43","BookieJournalTest.java","15580","138047","153627","","307254"
"2017-05-15 19:52","BookieJournalTest.java","47623","106537","154160","","308320"
"2017-05-16 00:31","BookieJournalTest.java","47675","107007","154682","","309364"
"2013-10-11 08:36","BookieJournalTest.java","14075","115346","129421","6","258842"
"2013-10-12 05:42","BookieJournalTest.java","14164","115976","130140","6","260280"
"2014-07-24 01:41","TestFencing.java","1183","6941","8124","","16248"
"2017-03-28 22:40","FlatLedgerManagerFactory.java","48290","97454","145744","","291488"
"2015-09-15 10:38","FlatLedgerManagerFactory.java","15234","134204","149438","","298876"
"2012-08-14 11:40","FlatLedgerManagerFactory.java","3878","20481","24359","2","48718"
"2012-09-07 07:04","FlatLedgerManagerFactory.java","4844","33268","38112","2","76224"
"2017-05-16 00:31","TestPerChannelBookieClient.java","8327","39871","48198","","96396"
"2017-01-31 02:14","TestPerChannelBookieClient.java","6577","23888","30465","","60930"
"2017-05-15 19:52","TestPerChannelBookieClient.java","8150","39276","47426","","94852"
"2016-07-14 23:02","FileSystemUpgrade.java","107158","15408","122566","","245132"
"2017-03-22 22:54","FileSystemUpgrade.java","112426","41955","154381","","308762"
"2017-07-28 20:12","BKException.java","115728","63705","179433","","358866"
"2016-07-11 22:53","BKException.java","105743","8420","114163","","228326"
"2017-05-02 23:04","BKException.java","111921","43386","155307","","310614"
"2017-08-02 00:49","BKException.java","118418","80007","198425","","396850"
"2017-01-31 04:01","BKException.java","111024","35633","146657","","293314"
"2015-10-22 09:22","BKException.java","33","863","896","","1792"
"2017-07-28 20:12","BKException.java","115780","62927","178707","","357414"
"2016-07-11 22:53","BKException.java","105716","7563","113279","","226558"
"2017-05-02 23:04","BKException.java","111940","42575","154515","","309030"
"2017-08-02 00:49","BKException.java","118470","79229","197699","","395398"
"2017-01-31 04:01","BKException.java","111033","34812","145845","","291690"
"2017-06-21 19:58","BookieClientTest.java","113395","64793","178188","","356376"
"2014-07-25 00:34","BookieClientTest.java","622","6444","7066","","14132"
"2017-03-28 22:35","BookieClientTest.java","111107","53428","164535","","329070"
"2016-12-17 02:39","BookieClientTest.java","110950","41554","152504","","305008"
"2017-05-15 19:52","BookieClientTest.java","112131","58206","170337","","340674"
"2014-12-10 19:43","BookieClientTest.java","1949","11577","13526","","27052"
"2015-10-06 10:05","BookieClientTest.java","2948","15842","18790","","37580"
"2017-05-15 19:52","LedgerHandle.java","66051","93161","159212","","318424"
"2017-05-02 22:07","LedgerHandle.java","65590","90346","155936","","311872"
"2017-03-23 15:55","LedgerHandle.java","65515","84645","150160","","300320"
"2012-12-28 12:32","LedgerHandle.java","6764","34267","41031","2","82062"
"2016-09-10 21:01","LedgerHandle.java","65314","67157","132471","","264942"
"2016-07-11 23:01","LedgerHandle.java","64576","62315","126891","","253782"
"2013-04-26 18:38","LedgerHandle.java","8969","71383","80352","5","160704"
"2013-10-14 18:32","LedgerHandle.java","10369","80470","90839","6","181678"
"2014-02-05 22:43","LedgerHandle.java","11259","86536","97795","7","195590"
"2014-02-21 19:01","LedgerHandle.java","11354","87794","99148","7","198296"
"2017-05-17 08:57","LedgerHandle.java","66126","93713","159839","","319678"
"2017-05-25 14:23","LedgerHandle.java","66158","95550","161708","","323416"
"2017-06-21 19:50","LedgerHandle.java","66792","99115","165907","","331814"
"2017-06-21 21:00","LedgerHandle.java","66795","99901","166696","","333392"
"2017-06-01 23:58","LedgerHandle.java","66745","97048","163793","","327586"
"2012-09-12 11:59","LedgerHandle.java","649","4233","4882","2","9764"
"2014-01-21 05:19","LedgerHandle.java","10652","85126","95778","6","191556"
"2014-09-18 06:47","LedgerHandle.java","12028","101524","113552","","227104"
"2014-12-09 19:57","LedgerHandle.java","12096","102685","114781","","229562"
"2017-07-04 06:27","LedgerHandle.java","66961","104499","171460","","342920"
"2017-06-30 00:12","LedgerHandle.java","66873","102450","169323","","338646"
"2014-05-30 14:01","LedgerHandle.java","11460","91834","103294","7","206588"
"2014-05-30 15:07","LedgerHandle.java","11480","91893","103373","7","206746"
"2014-01-17 18:13","LedgerHandle.java","10585","84163","94748","6","189496"
"2013-01-07 12:25","LedgerHandle.java","7139","36445","43584","2","87168"
"2012-09-14 11:53","LedgerHandle.java","876","4695","5571","2","11142"
"2016-02-09 08:32","LedgerHandle.java","12808","108828","121636","","243272"
"2016-03-16 05:03","LedgerHandle.java","64432","57713","122145","","244290"
"2015-10-22 09:22","LedgerHandle.java","12725","107710","120435","","240870"
"2015-10-06 10:05","LedgerHandle.java","12712","106641","119353","","238706"
"2017-01-31 04:01","LedgerHandle.java","65466","84230","149696","","299392"
"2015-04-21 09:39","LedgerHandle.java","12324","105082","117406","","234812"
"2015-10-06 11:12","LedgerHandle.java","12713","106882","119595","","239190"
"2014-12-05 14:10","LedgerHandle.java","12078","102218","114296","","228592"
"2017-03-23 00:54","TestDiskChecker.java","72826","80116","152942","","305884"
"2014-01-15 15:58","TestDiskChecker.java","7660","69055","76715","6","153430"
"2014-12-10 19:43","TestDiskChecker.java","9619","88455","98074","","196148"
"2017-05-15 19:52","BookKeeperTest.java","1577","3931","5508","","11016"
"2017-07-04 06:27","SyncThreadTest.java","2419","12429","14848","","29696"
"2017-05-15 19:52","DigestManager.java","40437","118152","158589","","317178"
"2012-07-18 17:00","DigestManager.java","13966","48121","62087","2","124174"
"2017-05-25 14:23","DigestManager.java","40482","120479","160961","","321922"
"2012-02-13 15:46","DigestManager.java","4625","16631","21256","1","42512"
"2012-05-10 14:47","DigestManager.java","12253","33843","46096","1","92192"
"2012-05-25 17:13","DigestManager.java","12570","35414","47984","1","95968"
"2011-11-17 11:16","DigestManager.java","2969","5310","8279","","16558"
"2017-01-31 04:01","DigestManager.java","40292","109661","149953","","299906"
"2017-03-23 00:48","ClientConfiguration.java","6259","26925","33184","","66368"
"2017-03-28 22:35","ClientConfiguration.java","6316","31234","37550","","75100"
"2017-01-31 02:14","ClientConfiguration.java","6056","20913","26969","","53938"
"2017-04-15 13:58","ClientConfiguration.java","6630","32648","39278","","78556"
"2017-03-23 00:59","ClientConfiguration.java","6272","26950","33222","","66444"
"2017-05-15 19:52","ClientConfiguration.java","7752","36424","44176","","88352"
"2016-10-13 07:50","ClientConfiguration.java","5310","12080","17390","","34780"
"2017-06-21 19:58","ClientConfiguration.java","9397","43392","52789","","105578"
"2017-06-05 21:48","ClientConfiguration.java","9076","41683","50759","","101518"
"2017-06-21 19:50","ClientConfiguration.java","9391","43276","52667","","105334"
"2017-08-02 00:49","ClientConfiguration.java","14280","71586","85866","","171732"
"2017-08-01 08:34","ClientConfiguration.java","13592","68313","81905","","163810"
"2017-06-30 00:12","ClientConfiguration.java","9741","46880","56621","","113242"
"2017-07-04 06:27","ClientConfiguration.java","9941","49041","58982","","117964"
"2017-01-31 04:01","ClientConfiguration.java","6116","26442","32558","","65116"
"2013-01-14 16:59","BookieServer.java","16980","95786","112766","2","225532"
"2013-01-09 17:18","BookieServer.java","16891","94633","111524","2","223048"
"2013-02-12 11:16","BookieServer.java","17834","127226","145060","4","290120"
"2013-04-02 17:38","BookieServer.java","18020","128415","146435","5","292870"
"2017-08-16 03:37","BookieServer.java","42067","152708","194775","","389550"
"2017-08-02 00:49","BookieServer.java","41569","145577","187146","","374292"
"2011-11-18 11:18","BookieServer.java","717","2005","2722","","5444"
"2012-02-15 16:11","BookieServer.java","2238","11915","14153","1","28306"
"2012-03-08 19:24","BookieServer.java","2557","14116","16673","1","33346"
"2013-07-03 17:39","BookieServer.java","18229","134113","152342","5","304684"
"2013-07-24 16:55","BookieServer.java","18246","134998","153244","5","306488"
"2014-02-05 22:43","BookieServer.java","18772","142313","161085","7","322170"
"2017-06-28 23:24","BookieServer.java","40885","122854","163739","","327478"
"2013-06-15 19:05","BookieServer.java","18226","133793","152019","5","304038"
"2017-06-01 23:58","BookieServer.java","40847","119414","160261","","320522"
"2017-10-17 09:32","BookieServer.java","42558","144577","187135","","374270"
"2014-08-02 20:02","BookieServer.java","19165","154916","174081","","348162"
"2012-05-09 09:43","BookieServer.java","10411","29319","39730","1","79460"
"2013-12-06 07:39","BookieServer.java","18438","139732","158170","6","316340"
"2012-07-23 23:39","BookieServer.java","12759","44641","57400","2","114800"
"2012-07-09 04:09","BookieServer.java","11390","40363","51753","2","103506"
"2012-10-18 16:40","BookieServer.java","15934","76025","91959","2","183918"
"2012-02-01 12:58","BookieServer.java","1881","9348","11229","1","22458"
"2014-01-21 05:05","BookieServer.java","18453","140845","159298","6","318596"
"2014-08-02 20:02","ServerConfiguration.java","1394","9450","10844","","21688"
"2014-05-15 00:41","ServerConfiguration.java","16","336","352","7","704"
"2014-09-18 06:47","ServerConfiguration.java","1975","12040","14015","","28030"
"2017-07-04 06:27","ServerConfiguration.java","114172","72279","186451","","372902"
"2016-04-14 00:51","ServerConfiguration.java","108106","24951","133057","","266114"
"2015-01-16 15:57","ServerConfiguration.java","2626","15663","18289","","36578"
"2016-03-08 06:49","ServerConfiguration.java","3966","21437","25403","","50806"
"2016-01-26 22:11","ServerConfiguration.java","3624","20081","23705","","47410"
"2016-04-05 18:47","ServerConfiguration.java","108080","24875","132955","","265910"
"2016-04-27 09:55","ServerConfiguration.java","108159","25516","133675","","267350"
"2015-04-21 09:55","ServerConfiguration.java","2761","16239","19000","","38000"
"2015-01-12 15:18","ServerConfiguration.java","2618","14717","17335","","34670"
"2015-04-21 10:02","ServerConfiguration.java","2774","16285","19059","","38118"
"2017-05-15 19:52","ServerConfiguration.java","112502","60181","172683","","345366"
"2017-03-22 22:54","ServerConfiguration.java","111482","51103","162585","","325170"
"2017-03-23 00:48","ServerConfiguration.java","111483","51156","162639","","325278"
"2017-01-31 02:11","ServerConfiguration.java","111374","44626","156000","","312000"
"2016-04-05 08:45","ServerConfiguration.java","108070","24623","132693","","265386"
"2016-11-09 03:02","ServerConfiguration.java","111279","37359","148638","","297276"
"2016-11-30 00:02","ServerConfiguration.java","111328","38090","149418","","298836"
"2017-06-05 20:30","ServerConfiguration.java","113591","64821","178412","","356824"
"2016-09-10 20:27","ServerConfiguration.java","109689","31980","141669","","283338"
"2017-08-02 00:49","ServerConfiguration.java","117826","94139","211965","","423930"
"2017-10-03 12:31","ServerConfiguration.java","125505","91975","217480","","434960"
"2017-08-16 03:37","ServerConfiguration.java","119432","102378","221810","","443620"
"2017-05-26 12:38","ServerConfiguration.java","112698","62693","175391","","350782"
"2017-07-07 08:19","ServerConfiguration.java","114199","74269","188468","","376936"
"2017-06-28 23:24","ServerConfiguration.java","113786","68060","181846","","363692"
"2017-11-08 12:27","ServerConfiguration.java","127418","111762","239180","","478360"
"2017-05-15 19:52","BookKeeperClusterTestCase.java","8075","38397","46472","","92944"
"2017-08-01 08:34","BookKeeperClusterTestCase.java","13904","70275","84179","","168358"
"2017-11-08 12:27","BookKeeperClusterTestCase.java","29494","96481","125975","","251950"
"2017-07-04 06:27","BookKeeperClusterTestCase.java","10260","51010","61270","","122540"
"2017-06-30 00:12","BookKeeperClusterTestCase.java","10060","48849","58909","","117818"
"2017-05-15 19:52","LedgerHandle.java","42545","113887","156432","","312864"
"2017-05-02 22:07","LedgerHandle.java","42188","111176","153364","","306728"
"2017-03-23 15:55","LedgerHandle.java","42181","105543","147724","","295448"
"2012-12-28 12:32","LedgerHandle.java","17334","89069","106403","2","212806"
"2016-09-10 21:01","LedgerHandle.java","42054","88129","130183","","260366"
"2016-07-11 23:01","LedgerHandle.java","42045","84016","126061","","252122"
"2012-02-13 15:46","LedgerHandle.java","1210","6843","8053","1","16106"
"2012-01-17 16:52","LedgerHandle.java","790","2141","2931","1","5862"
"2012-02-01 16:19","LedgerHandle.java","867","3311","4178","1","8356"
"2012-02-13 11:19","LedgerHandle.java","1083","6636","7719","1","15438"
"2012-03-31 10:58","LedgerHandle.java","9341","22607","31948","1","63896"
"2011-11-29 23:55","LedgerHandle.java","438","483","921","","1842"
"2013-04-26 18:38","LedgerHandle.java","18699","125345","144044","5","288088"
"2013-10-14 18:32","LedgerHandle.java","19077","133410","152487","6","304974"
"2014-02-05 22:43","LedgerHandle.java","19520","139029","158549","7","317098"
"2014-02-21 19:01","LedgerHandle.java","19558","140230","159788","7","319576"
"2017-05-17 08:57","LedgerHandle.java","42577","114396","156973","","313946"
"2017-05-25 14:23","LedgerHandle.java","42604","116228","158832","","317664"
"2017-06-21 19:50","LedgerHandle.java","42707","119262","161969","","323938"
"2017-06-21 21:00","LedgerHandle.java","42709","120047","162756","","325512"
"2017-06-01 23:58","LedgerHandle.java","42667","117202","159869","","319738"
"2012-06-29 18:43","LedgerHandle.java","11188","35590","46778","2","93556"
"2012-05-25 17:13","LedgerHandle.java","10336","26807","37143","1","74286"
"2012-05-10 14:47","LedgerHandle.java","9997","25214","35211","1","70422"
"2012-09-12 11:59","LedgerHandle.java","13619","61435","75054","2","150108"
"2012-06-19 12:39","LedgerHandle.java","10996","29863","40859","2","81718"
"2014-01-21 05:19","LedgerHandle.java","19229","137935","157164","6","314328"
"2012-06-27 15:35","LedgerHandle.java","11177","35249","46426","2","92852"
"2014-09-18 06:47","LedgerHandle.java","19971","153699","173670","","347340"
"2014-12-09 19:57","LedgerHandle.java","19978","154799","174777","","349554"
"2017-07-04 06:27","LedgerHandle.java","42745","124515","167260","","334520"
"2017-06-30 00:12","LedgerHandle.java","42713","122522","165235","","330470"
"2014-05-30 14:01","LedgerHandle.java","19599","144205","163804","7","327608"
"2014-05-30 15:07","LedgerHandle.java","19601","144246","163847","7","327694"
"2014-01-17 18:13","LedgerHandle.java","19187","136997","156184","6","312368"
"2013-01-07 12:25","LedgerHandle.java","17465","91003","108468","2","216936"
"2012-08-28 10:51","LedgerHandle.java","13477","57709","71186","2","142372"
"2012-09-14 11:53","LedgerHandle.java","13697","61748","75445","2","150890"
"2016-02-09 08:32","LedgerHandle.java","20195","160447","180642","","361284"
"2016-03-16 05:03","LedgerHandle.java","41999","79512","121511","","243022"
"2015-10-22 09:22","LedgerHandle.java","20196","159413","179609","","359218"
"2015-10-06 10:05","LedgerHandle.java","20185","158346","178531","","357062"
"2017-01-31 04:01","LedgerHandle.java","42173","105169","147342","","294684"
"2015-04-21 09:39","LedgerHandle.java","20000","156990","176990","","353980"
"2015-10-06 11:12","LedgerHandle.java","20187","158588","178775","","357550"
"2014-12-05 14:10","LedgerHandle.java","19973","154345","174318","","348636"
"2017-08-16 03:37","package-info.java","11464","60546","72010","","144020"
"2017-07-28 20:12","package-info.java","5908","34745","40653","","81306"
"2017-06-01 23:58","SASLClientProviderFactory.java","1148","2055","3203","","6406"
"2016-11-18 00:18","InterleavedLedgerStorage.java","111817","24571","136388","","272776"
"2017-05-16 00:31","InterleavedLedgerStorage.java","113474","48093","161567","","323134"
"2017-07-04 06:27","InterleavedLedgerStorage.java","115326","59955","175281","","350562"
"2017-01-31 04:01","InterleavedLedgerStorage.java","111895","37750","149645","","299290"
"2016-03-08 06:49","InterleavedLedgerStorage.java","1555","5548","7103","","14206"
"2017-03-28 22:37","InterleavedLedgerStorage.java","112128","42790","154918","","309836"
"2017-07-07 08:19","BookieInitializationTest.java","2743","15134","17877","","35754"
"2017-06-28 23:24","BookieInitializationTest.java","2009","8604","10613","","21226"
"2017-07-28 06:39","BookieInitializationTest.java","4033","18313","22346","","44692"
"2017-08-02 00:49","BookieInitializationTest.java","7739","36373","44112","","88224"
"2017-06-05 20:30","BookieInitializationTest.java","1582","5133","6715","","13430"
"2014-08-02 20:02","Journal.java","4622","24474","29096","","58192"
"2014-03-07 13:14","Journal.java","3619","12462","16081","7","32162"
"2014-04-29 22:07","Journal.java","3801","14956","18757","7","37514"
"2013-12-06 07:39","Journal.java","1926","7321","9247","6","18494"
"2015-04-21 09:23","Journal.java","5515","30622","36137","","72274"
"2016-02-09 08:30","Journal.java","6342","34716","41058","","82116"
"2015-02-23 08:11","Journal.java","5503","30374","35877","","71754"
"2017-05-26 16:52","Journal.java","113659","75470","189129","","378258"
"2017-03-22 22:54","Journal.java","112684","64101","176785","","353570"
"2016-11-12 03:37","Journal.java","112547","50471","163018","","326036"
"2016-07-14 23:02","Journal.java","109871","40009","149880","","299760"
"2013-07-20 19:59","Journal.java","36","273","309","5","618"
"2017-06-01 23:58","Journal.java","114385","77053","191438","","382876"
"2017-05-09 22:24","Journal.java","113178","71191","184369","","368738"
"2013-10-12 05:42","Journal.java","1476","3849","5325","6","10650"
"2013-10-02 06:23","Journal.java","417","1867","2284","5","4568"
"2017-05-16 00:31","Journal.java","113605","73498","187103","","374206"
"2017-05-15 19:52","LedgerHandle.java","36237","119603","155840","","311680"
"2017-05-02 22:07","LedgerHandle.java","36100","117112","153212","","306424"
"2017-03-23 15:55","LedgerHandle.java","36105","111491","147596","","295192"
"2012-12-28 12:32","LedgerHandle.java","14795","98554","113349","2","226698"
"2016-09-10 21:01","LedgerHandle.java","36097","94196","130293","","260586"
"2016-07-11 23:01","LedgerHandle.java","36093","90088","126181","","252362"
"2012-02-13 15:46","LedgerHandle.java","8767","26424","35191","1","70382"
"2012-01-17 16:52","LedgerHandle.java","8590","21965","30555","1","61110"
"2012-02-01 16:19","LedgerHandle.java","8628","23096","31724","1","63448"
"2012-02-13 11:19","LedgerHandle.java","8669","26246","34915","1","69830"
"2012-03-31 10:58","LedgerHandle.java","9727","35017","44744","1","89488"
"2011-11-29 23:55","LedgerHandle.java","8374","20443","28817","","57634"
"2013-04-26 18:38","LedgerHandle.java","15947","134617","150564","5","301128"
"2013-10-14 18:32","LedgerHandle.java","16118","142475","158593","6","317186"
"2014-02-05 22:43","LedgerHandle.java","16319","147852","164171","7","328342"
"2014-02-21 19:01","LedgerHandle.java","16349","149045","165394","7","330788"
"2017-05-17 08:57","LedgerHandle.java","36270","120113","156383","","312766"
"2017-05-25 14:23","LedgerHandle.java","36269","121917","158186","","316372"
"2017-06-21 19:50","LedgerHandle.java","36294","124873","161167","","322334"
"2017-06-21 21:00","LedgerHandle.java","36287","125649","161936","","323872"
"2017-06-01 23:58","LedgerHandle.java","36268","122827","159095","","318190"
"2012-06-29 18:43","LedgerHandle.java","10468","46894","57362","2","114724"
"2012-05-25 17:13","LedgerHandle.java","10350","38845","49195","1","98390"
"2012-05-10 14:47","LedgerHandle.java","10056","37297","47353","1","94706"
"2012-09-12 11:59","LedgerHandle.java","12038","71878","83916","2","167832"
"2012-06-19 12:39","LedgerHandle.java","10435","41326","51761","2","103522"
"2014-01-21 05:19","LedgerHandle.java","16202","146932","163134","6","326268"
"2012-06-27 15:35","LedgerHandle.java","10469","46565","57034","2","114068"
"2014-09-18 06:47","LedgerHandle.java","16556","162308","178864","","357728"
"2014-12-09 19:57","LedgerHandle.java","16543","163388","179931","","359862"
"2017-07-04 06:27","LedgerHandle.java","36287","130081","166368","","332736"
"2017-06-30 00:12","LedgerHandle.java","36287","128120","164407","","328814"
"2014-05-30 14:01","LedgerHandle.java","16378","153008","169386","7","338772"
"2014-05-30 15:07","LedgerHandle.java","16378","153047","169425","7","338850"
"2014-01-17 18:13","LedgerHandle.java","16183","146017","162200","6","324400"
"2013-01-07 12:25","LedgerHandle.java","14881","100443","115324","2","230648"
"2012-08-28 10:51","LedgerHandle.java","11954","68210","80164","2","160328"
"2011-11-28 19:25","LedgerHandle.java","8079","20103","28182","","56364"
"2012-09-14 11:53","LedgerHandle.java","12085","72160","84245","2","168490"
"2016-02-09 08:32","LedgerHandle.java","16577","168853","185430","","370860"
"2011-11-16 17:05","LedgerHandle.java","7101","14450","21551","","43102"
"2011-09-05 19:38","LedgerHandle.java","4941","10592","15533","","31066"
"2016-03-16 05:03","LedgerHandle.java","36091","85628","121719","","243438"
"2015-10-22 09:22","LedgerHandle.java","16597","167838","184435","","368870"
"2015-10-06 10:05","LedgerHandle.java","16593","166778","183371","","366742"
"2017-01-31 04:01","LedgerHandle.java","36109","111129","147238","","294476"
"2011-10-27 18:26","LedgerHandle.java","5871","12000","17871","","35742"
"2015-04-21 09:39","LedgerHandle.java","16556","165570","182126","","364252"
"2011-10-18 10:42","LedgerHandle.java","4965","10846","15811","","31622"
"2015-10-06 11:12","LedgerHandle.java","16596","167021","183617","","367234"
"2014-12-05 14:10","LedgerHandle.java","16558","162954","179512","","359024"
"2011-11-17 11:16","LedgerHandle.java","7312","15304","22616","","45232"
"2017-07-28 20:12","BKException.java","69026","109462","178488","","356976"
"2016-07-11 22:53","BKException.java","66043","61179","127222","","254444"
"2017-05-02 23:04","BKException.java","67326","91250","158576","","317152"
"2013-09-10 15:14","BKException.java","9473","76812","86285","5","172570"
"2014-02-21 19:01","BKException.java","11347","86091","97438","7","194876"
"2017-08-02 00:49","BKException.java","69827","123875","193702","","387404"
"2012-12-12 11:20","BKException.java","5302","27780","33082","2","66164"
"2015-09-15 10:38","BKException.java","12703","104612","117315","","234630"
"2017-01-31 04:01","BKException.java","66940","84008","150948","","301896"
"2015-10-06 10:48","BKException.java","12706","105165","117871","","235742"
"2015-10-22 09:22","BKException.java","12718","106007","118725","","237450"
"2012-12-03 17:59","BKException.java","5057","26337","31394","2","62788"
"2017-05-02 23:04","HierarchicalLedgerManagerFactory.java","765","2586","3351","","6702"
"2014-07-24 01:41","TestFencing.java","18947","146958","165905","","331810"
"2012-06-19 12:39","TestFencing.java","10733","32344","43077","2","86154"
"2012-12-18 13:04","TestFencing.java","16368","90717","107085","2","214170"
"2014-02-05 22:43","TestFencing.java","18694","140947","159641","7","319282"
"2012-03-31 10:58","TestFencing.java","9542","25552","35094","1","70188"
"2013-08-23 18:48","TestFencing.java","18168","134132","152300","5","304600"
"2012-01-11 15:46","TestFencing.java","1182","5222","6404","1","12808"
"2012-03-13 07:31","TestFencing.java","2379","14907","17286","1","34572"
"2011-11-29 18:45","TestFencing.java","522","3432","3954","","7908"
"2012-04-02 12:38","TestFencing.java","9557","25705","35262","1","70524"
"2016-07-14 23:02","FileSystemUpgrade.java","47645","74433","122078","","244156"
"2017-03-22 22:54","FileSystemUpgrade.java","47795","95862","143657","","287314"
"2013-02-08 19:08","FileSystemUpgrade.java","11785","102055","113840","4","227680"
"2012-12-08 11:18","FileSystemUpgrade.java","9906","61942","71848","2","143696"
"2012-09-07 07:26","FileSystemUpgrade.java","6135","38244","44379","2","88758"
"2014-09-18 06:57","FileSystemUpgrade.java","15390","133928","149318","","298636"
"2017-05-16 00:31","WriteEntryProcessorV3.java","263","681","944","","1888"
"2013-01-14 16:59","BookieServer.java","18363","89702","108065","2","216130"
"2013-01-09 17:18","BookieServer.java","18270","88545","106815","2","213630"
"2013-02-12 11:16","BookieServer.java","19273","121198","140471","4","280942"
"2013-04-02 17:38","BookieServer.java","19479","122407","141886","5","283772"
"2017-08-16 03:37","BookieServer.java","46531","149705","196236","","392472"
"2017-08-02 00:49","BookieServer.java","45748","142289","188037","","376074"
"2012-02-15 16:11","BookieServer.java","1430","3640","5070","1","10140"
"2012-03-08 19:24","BookieServer.java","1907","5999","7906","1","15812"
"2013-07-03 17:39","BookieServer.java","19692","128109","147801","5","295602"
"2013-07-24 16:55","BookieServer.java","19709","128994","148703","5","297406"
"2014-02-05 22:43","BookieServer.java","20344","136418","156762","7","313524"
"2017-06-28 23:24","BookieServer.java","45020","119522","164542","","329084"
"2013-06-15 19:05","BookieServer.java","19686","127786","147472","5","294944"
"2017-06-01 23:58","BookieServer.java","44971","116071","161042","","322084"
"2017-10-17 09:32","BookieServer.java","47283","141835","189118","","378236"
"2014-08-02 20:02","BookieServer.java","20780","149064","169844","","339688"
"2012-05-09 09:43","BookieServer.java","10179","21620","31799","1","63598"
"2013-12-06 07:39","BookieServer.java","19965","133792","153757","6","307514"
"2012-07-23 23:39","BookieServer.java","13318","37733","51051","2","102102"
"2012-07-09 04:09","BookieServer.java","11778","33284","45062","2","90124"
"2012-10-18 16:40","BookieServer.java","17011","69635","86646","2","173292"
"2014-01-21 05:05","BookieServer.java","19994","134919","154913","6","309826"
"2017-03-28 22:40","FlatLedgerManagerFactory.java","67349","88089","155438","","310876"
"2015-09-15 10:38","FlatLedgerManagerFactory.java","12707","103253","115960","","231920"
"2016-12-21 01:48","LedgerCacheTest.java","73931","72778","146709","","293418"
"2013-02-12 06:00","LedgerCacheTest.java","4730","52592","57322","4","114644"
"2013-01-07 03:48","LedgerCacheTest.java","3877","19647","23524","2","47048"
"2012-12-24 05:50","LedgerCacheTest.java","3110","17238","20348","2","40696"
"2012-12-24 06:23","LedgerCacheTest.java","3175","17525","20700","2","41400"
"2019-02-20 11:43","LedgerCacheTest.java","88952","426476","515428","","1030856"
"2013-08-12 19:01","LedgerCacheTest.java","6470","61728","68198","5","136396"
"2013-10-12 05:42","LedgerCacheTest.java","7475","64130","71605","6","143210"
"2017-05-16 00:31","LedgerCacheTest.java","74698","88873","163571","","327142"
"2013-12-02 18:45","LedgerCacheTest.java","7699","67224","74923","6","149846"
"2014-07-24 01:41","LedgerCacheTest.java","9140","76822","85962","","171924"
"2014-12-10 19:43","LedgerCacheTest.java","9756","87066","96822","","193644"
"2016-03-08 06:49","LedgerCacheTest.java","10515","94064","104579","","209158"
"2014-03-12 21:26","LedgerCacheTest.java","8694","73621","82315","7","164630"
"2012-12-08 11:18","LedgerCacheTest.java","1868","11536","13404","2","26808"
"2017-06-01 23:58","EntryLogger.java","81833","83042","164875","","329750"
"2014-01-21 17:26","EntryLogger.java","4778","50451","55229","6","110458"
"2013-10-02 06:23","EntryLogger.java","3294","43285","46579","5","93158"
"2014-01-22 14:35","EntryLogger.java","4906","50955","55861","6","111722"
"2017-11-08 12:27","EntryLogger.java","93243","127924","221167","","442334"
"2013-10-22 07:44","EntryLogger.java","4384","45671","50055","6","100110"
"2013-05-04 14:22","EntryLogger.java","2688","36368","39056","5","78112"
"2017-01-31 02:11","EntryLogger.java","80239","63828","144067","","288134"
"2017-03-23 00:48","EntryLogger.java","80329","70339","150668","","301336"
"2016-07-14 23:02","EntryLogger.java","78895","47574","126469","","252938"
"2016-02-24 00:44","EntryLogger.java","7941","75397","83338","","166676"
"2015-04-21 10:02","EntryLogger.java","7038","70886","77924","","155848"
"2015-04-21 09:44","EntryLogger.java","7040","70704","77744","","155488"
"2017-05-15 19:52","BookKeeperClusterTestCase.java","80666","79497","160163","","320326"
"2013-01-09 17:18","BookKeeperClusterTestCase.java","511","1710","2221","2","4442"
"2016-04-05 08:45","BookKeeperClusterTestCase.java","78296","46001","124297","","248594"
"2017-08-01 08:34","BookKeeperClusterTestCase.java","84494","109374","193868","","387736"
"2013-10-12 05:42","BookKeeperClusterTestCase.java","4188","45917","50105","6","100210"
"2014-02-05 22:43","BookKeeperClusterTestCase.java","5425","52423","57848","7","115696"
"2017-11-08 12:27","BookKeeperClusterTestCase.java","92894","128390","221284","","442568"
"2013-06-15 19:05","BookKeeperClusterTestCase.java","2922","41946","44868","5","89736"
"2014-05-09 14:04","BookKeeperClusterTestCase.java","5743","56895","62638","7","125276"
"2017-07-04 06:27","BookKeeperClusterTestCase.java","81930","91189","173119","","346238"
"2014-07-24 01:41","BookKeeperClusterTestCase.java","6205","58961","65166","","130332"
"2014-05-23 18:46","BookKeeperClusterTestCase.java","5749","57231","62980","7","125960"
"2017-06-30 00:12","BookKeeperClusterTestCase.java","81827","89125","170952","","341904"
"2014-04-24 10:43","BookKeeperClusterTestCase.java","5685","55818","61503","7","123006"
"2013-01-07 12:25","BookKeeperClusterTestCase.java","139","1166","1305","2","2610"
"2016-04-27 09:55","BookKeeperClusterTestCase.java","78366","46875","125241","","250482"
"2015-10-06 10:48","BookKeeperClusterTestCase.java","7540","73416","80956","","161912"
"2014-12-10 19:43","BookKeeperClusterTestCase.java","6851","69235","76086","","152172"
"2016-02-09 08:39","BookKeeperTest.java","6107","39310","45417","","90834"
"2015-10-16 07:00","BookKeeperTest.java","5980","37287","43267","","86534"
"2016-04-08 19:43","BookKeeperTest.java","109330","42710","152040","","304080"
"2017-01-31 04:01","BookKeeperTest.java","111020","66910","177930","","355860"
"2014-07-24 01:41","BookKeeperTest.java","4471","22632","27103","","54206"
"2017-05-15 19:52","BookKeeperTest.java","111899","76135","188034","","376068"
"2017-05-02 22:07","BookKeeperTest.java","111219","73101","184320","","368640"
"2017-07-04 06:27","LedgerStorage.java","2419","12429","14848","","29696"
"2016-11-09 08:44","LedgerHandleAdv.java","110902","21458","132360","","264720"
"2016-07-26 00:22","LedgerHandleAdv.java","105815","8605","114420","","228840"
"2016-10-13 09:27","LedgerHandleAdv.java","110867","21076","131943","","263886"
"2017-05-25 14:23","LedgerHandleAdv.java","112755","47162","159917","","319834"
"2017-06-01 23:58","LedgerHandleAdv.java","113607","48925","162532","","325064"
"2014-07-24 01:41","TestFencing.java","15496","127497","142993","","285986"
"2012-06-19 12:39","TestFencing.java","2455","8056","10511","2","21022"
"2012-12-18 13:04","TestFencing.java","10919","69258","80177","2","160354"
"2014-02-05 22:43","TestFencing.java","15124","121367","136491","7","272982"
"2013-08-23 18:48","TestFencing.java","13739","113693","127432","5","254864"
"2012-04-02 12:38","TestFencing.java","52","190","242","1","484"
"2016-03-16 04:51","AutoRecoveryMain.java","108066","23980","132046","","264092"
"2014-04-24 10:43","AutoRecoveryMain.java","77","1325","1402","7","2804"
"2014-09-06 07:58","AutoRecoveryMain.java","1893","14222","16115","","32230"
"2016-03-16 04:51","AutoRecoveryMain.java","108048","22714","130762","","261524"
"2014-09-06 07:58","AutoRecoveryMain.java","1846","12927","14773","","29546"
"2017-07-04 06:27","ServerConfiguration.java","2346","10458","12804","","25608"
"2017-06-05 20:30","ServerConfiguration.java","1253","2488","3741","","7482"
"2017-08-02 00:49","ServerConfiguration.java","7461","33779","41240","","82480"
"2017-10-03 12:31","ServerConfiguration.java","32531","49006","81537","","163074"
"2017-08-16 03:37","ServerConfiguration.java","9921","42872","52793","","105586"
"2017-07-07 08:19","ServerConfiguration.java","2437","12512","14949","","29898"
"2017-06-28 23:24","ServerConfiguration.java","1688","5967","7655","","15310"
"2017-11-08 12:27","ServerConfiguration.java","36652","71001","107653","","215306"
"2014-06-06 15:29","CompactionTest.java","15140","129280","144420","7","288840"
"2013-10-30 16:23","CompactionTest.java","14532","119999","134531","6","269062"
"2014-01-17 18:13","CompactionTest.java","14576","121267","135843","6","271686"
"2016-03-08 06:49","CompactionTest.java","16094","146109","162203","","324406"
"2015-01-16 15:57","CompactionTest.java","15742","141323","157065","","314130"
"2014-12-10 19:43","CompactionTest.java","15740","139516","155256","","310512"
"2015-04-21 09:55","CompactionTest.java","15761","141783","157544","","315088"
"2016-05-04 15:55","CompactionTest.java","46303","76227","122530","","245060"
"2017-03-22 22:54","CompactionTest.java","46497","98662","145159","","290318"
"2012-11-26 16:42","CompactionTest.java","11326","64724","76050","2","152100"
"2017-06-21 21:07","CompactionTest.java","47610","114194","161804","","323608"
"2014-01-22 14:35","CompactionTest.java","14731","122987","137718","6","275436"
"2017-11-08 12:27","CompactionTest.java","50530","147418","197948","","395896"
"2017-05-16 00:31","CompactionTest.java","46985","107626","154611","","309222"
"2014-01-15 15:58","CompactionTest.java","14550","120885","135435","6","270870"
"2013-10-22 07:44","CompactionTest.java","14444","117938","132382","6","264764"
"2017-07-07 08:19","CompactionTest.java","47679","120293","167972","","335944"
"2013-05-04 14:22","CompactionTest.java","13938","109825","123763","5","247526"
"2014-07-24 01:41","ConfigurationTest.java","18947","146958","165905","","331810"
"2012-05-09 10:17","ConfigurationTest.java","9935","27584","37519","1","75038"
"2016-07-31 07:53","ConfigurationTest.java","40719","85568","126287","","252574"
"2012-12-20 06:48","BookieFailureTest.java","9142","61888","71030","2","142060"
"2012-08-13 11:38","BookieFailureTest.java","3864","18742","22606","2","45212"
"2014-07-24 01:41","BookieFailureTest.java","14466","120866","135332","","270664"
"2017-08-16 03:37","package-info.java","6220","26465","32685","","65370"
"2017-05-15 19:52","LedgerHandle.java","67754","91045","158799","","317598"
"2017-05-02 22:07","LedgerHandle.java","67280","88217","155497","","310994"
"2017-03-23 15:55","LedgerHandle.java","67162","82473","149635","","299270"
"2012-12-28 12:32","LedgerHandle.java","6370","30054","36424","2","72848"
"2016-09-10 21:01","LedgerHandle.java","66924","64948","131872","","263744"
"2016-07-11 23:01","LedgerHandle.java","65944","59864","125808","","251616"
"2013-04-26 18:38","LedgerHandle.java","8631","67226","75857","5","151714"
"2013-10-14 18:32","LedgerHandle.java","10048","76330","86378","6","172756"
"2014-02-05 22:43","LedgerHandle.java","10975","82433","93408","7","186816"
"2014-02-21 19:01","LedgerHandle.java","11079","83700","94779","7","189558"
"2017-05-17 08:57","LedgerHandle.java","67829","91597","159426","","318852"
"2017-05-25 14:23","LedgerHandle.java","67861","93434","161295","","322590"
"2017-06-21 19:50","LedgerHandle.java","68503","97007","165510","","331020"
"2017-06-21 21:00","LedgerHandle.java","68506","97793","166299","","332598"
"2017-06-01 23:58","LedgerHandle.java","68454","94938","163392","","326784"
"2014-01-21 05:19","LedgerHandle.java","10340","80995","91335","6","182670"
"2014-09-18 06:47","LedgerHandle.java","11783","97460","109243","","218486"
"2014-12-09 19:57","LedgerHandle.java","11900","98670","110570","","221140"
"2017-07-04 06:27","LedgerHandle.java","68695","102414","171109","","342218"
"2017-06-30 00:12","LedgerHandle.java","68607","100365","168972","","337944"
"2014-05-30 14:01","LedgerHandle.java","11190","87745","98935","7","197870"
"2014-05-30 15:07","LedgerHandle.java","11210","87804","99014","7","198028"
"2014-01-17 18:13","LedgerHandle.java","10272","80031","90303","6","180606"
"2013-01-07 12:25","LedgerHandle.java","6769","32256","39025","2","78050"
"2016-02-09 08:32","LedgerHandle.java","12657","104858","117515","","235030"
"2016-03-16 05:03","LedgerHandle.java","65788","55250","121038","","242076"
"2015-10-22 09:22","LedgerHandle.java","12574","103740","116314","","232628"
"2015-10-06 10:05","LedgerHandle.java","12548","102658","115206","","230412"
"2017-01-31 04:01","LedgerHandle.java","67084","82029","149113","","298226"
"2015-04-21 09:39","LedgerHandle.java","12143","101082","113225","","226450"
"2015-10-06 11:12","LedgerHandle.java","12551","102901","115452","","230904"
"2014-12-05 14:10","LedgerHandle.java","11858","98179","110037","","220074"
"2017-05-15 19:52","LedgerHandle.java","112343","43433","155776","","311552"
"2017-05-02 22:07","LedgerHandle.java","111347","40083","151430","","302860"
"2017-03-23 15:55","LedgerHandle.java","110997","34107","145104","","290208"
"2016-09-10 21:01","LedgerHandle.java","109033","14856","123889","","247778"
"2016-07-11 23:01","LedgerHandle.java","105538","7257","112795","","225590"
"2017-05-17 08:57","LedgerHandle.java","112526","44093","156619","","313238"
"2017-05-25 14:23","LedgerHandle.java","112577","45949","158526","","317052"
"2017-06-21 19:50","LedgerHandle.java","113867","50170","164037","","328074"
"2017-06-21 21:00","LedgerHandle.java","113881","50967","164848","","329696"
"2017-06-01 23:58","LedgerHandle.java","113429","47712","161141","","322282"
"2017-07-04 06:27","LedgerHandle.java","114399","55917","170316","","340632"
"2017-06-30 00:12","LedgerHandle.java","114211","53768","167979","","335958"
"2016-03-16 05:03","LedgerHandle.java","104948","2209","107157","","214314"
"2017-01-31 04:01","LedgerHandle.java","110842","33586","144428","","288856"
"2014-02-05 22:43","TestReadTimeout.java","1712","6078","7790","7","15580"
"2017-06-30 00:12","ReadLastConfirmedOp.java","925","6199","7124","","14248"
"2017-05-15 19:52","LedgerHandle.java","40249","116266","156515","","313030"
"2017-05-02 22:07","LedgerHandle.java","40090","113753","153843","","307686"
"2017-03-23 15:55","LedgerHandle.java","40090","108127","148217","","296434"
"2012-12-28 12:32","LedgerHandle.java","16474","92884","109358","2","218716"
"2016-09-10 21:01","LedgerHandle.java","39989","90739","130728","","261456"
"2016-07-11 23:01","LedgerHandle.java","39984","86630","126614","","253228"
"2012-02-13 15:46","LedgerHandle.java","2421","12729","15150","1","30300"
"2012-01-17 16:52","LedgerHandle.java","2040","8066","10106","1","20212"
"2012-02-01 16:19","LedgerHandle.java","2105","9224","11329","1","22658"
"2012-02-13 11:19","LedgerHandle.java","2295","12523","14818","1","29636"
"2012-03-31 10:58","LedgerHandle.java","9907","27848","37755","1","75510"
"2011-11-29 23:55","LedgerHandle.java","1725","6445","8170","","16340"
"2013-04-26 18:38","LedgerHandle.java","17799","129120","146919","5","293838"
"2013-10-14 18:32","LedgerHandle.java","18113","137121","155234","6","310468"
"2014-02-05 22:43","LedgerHandle.java","18498","142682","161180","7","322360"
"2014-02-21 19:01","LedgerHandle.java","18534","143881","162415","7","324830"
"2017-05-17 08:57","LedgerHandle.java","40277","116771","157048","","314096"
"2017-05-25 14:23","LedgerHandle.java","40301","118600","158901","","317802"
"2017-06-21 19:50","LedgerHandle.java","40392","121622","162014","","324028"
"2017-06-21 21:00","LedgerHandle.java","40395","122408","162803","","325606"
"2017-06-01 23:58","LedgerHandle.java","40364","119574","159938","","319876"
"2012-06-29 18:43","LedgerHandle.java","11237","40314","51551","2","103102"
"2012-05-25 17:13","LedgerHandle.java","10849","31995","42844","1","85688"
"2012-05-10 14:47","LedgerHandle.java","10538","30430","40968","1","81936"
"2012-09-12 11:59","LedgerHandle.java","13408","65899","79307","2","158614"
"2012-06-19 12:39","LedgerHandle.java","11045","34587","45632","2","91264"
"2014-01-21 05:19","LedgerHandle.java","18235","141616","159851","6","319702"
"2012-06-27 15:35","LedgerHandle.java","11226","39973","51199","2","102398"
"2014-09-18 06:47","LedgerHandle.java","18896","157299","176195","","352390"
"2014-12-09 19:57","LedgerHandle.java","18903","158399","177302","","354604"
"2017-07-04 06:27","LedgerHandle.java","40429","126874","167303","","334606"
"2017-06-30 00:12","LedgerHandle.java","40399","124883","165282","","330564"
"2014-05-30 14:01","LedgerHandle.java","18568","147849","166417","7","332834"
"2014-05-30 15:07","LedgerHandle.java","18569","147889","166458","7","332916"
"2014-01-17 18:13","LedgerHandle.java","18195","140680","158875","6","317750"
"2013-01-07 12:25","LedgerHandle.java","16595","94808","111403","2","222806"
"2012-08-28 10:51","LedgerHandle.java","13295","62202","75497","2","150994"
"2011-11-28 19:25","LedgerHandle.java","1347","6022","7369","","14738"
"2012-09-14 11:53","LedgerHandle.java","13468","66194","79662","2","159324"
"2016-02-09 08:32","LedgerHandle.java","18973","163900","182873","","365746"
"2016-03-16 05:03","LedgerHandle.java","39948","82136","122084","","244168"
"2015-10-22 09:22","LedgerHandle.java","18973","162865","181838","","363676"
"2015-10-06 10:05","LedgerHandle.java","18962","161798","180760","","361520"
"2017-01-31 04:01","LedgerHandle.java","40097","107768","147865","","295730"
"2015-04-21 09:39","LedgerHandle.java","18924","160589","179513","","359026"
"2015-10-06 11:12","LedgerHandle.java","18964","162040","181004","","362008"
"2014-12-05 14:10","LedgerHandle.java","18898","157945","176843","","353686"
"2011-11-17 11:16","LedgerHandle.java","254","897","1151","","2302"
"2016-03-16 04:51","AutoRecoveryMain.java","106943","10528","117471","","234942"
"2017-08-02 00:49","BookieRequestHandler.java","7739","36373","44112","","88224"
"2013-08-21 13:19","BookKeeperAdmin.java","8962","82207","91169","5","182338"
"2017-10-17 09:32","BookKeeperAdmin.java","71366","129387","200753","","401506"
"2017-06-01 23:58","BookKeeperAdmin.java","64676","99245","163921","","327842"
"2017-04-11 20:19","BookKeeperAdmin.java","63514","91598","155112","","310224"
"2014-02-21 19:01","BookKeeperAdmin.java","10780","91486","102266","7","204532"
"2014-02-05 22:43","BookKeeperAdmin.java","10685","90228","100913","7","201826"
"2017-07-07 05:11","BookKeeperAdmin.java","64849","108333","173182","","346364"
"2013-02-26 04:12","BookKeeperAdmin.java","8194","73743","81937","4","163874"
"2016-11-09 03:05","BookKeeperAdmin.java","63363","73157","136520","","273040"
"2016-11-30 00:07","BookKeeperAdmin.java","63367","73825","137192","","274384"
"2016-09-10 21:01","BookKeeperAdmin.java","63274","69383","132657","","265314"
"2016-07-14 23:02","BookKeeperAdmin.java","62594","64633","127227","","254454"
"2016-10-13 09:27","BookKeeperAdmin.java","63363","72823","136186","","272372"
"2012-11-30 04:54","BookKeeperAdmin.java","4926","31631","36557","2","73114"
"2013-02-08 19:08","BookKeeperAdmin.java","7341","72862","80203","4","160406"
"2016-03-16 05:03","BookKeeperAdmin.java","62399","59946","122345","","244690"
"2016-03-08 07:18","BookKeeperAdmin.java","12272","114105","126377","","252754"
"2014-12-06 08:03","BookKeeperAdmin.java","11451","106215","117666","","235332"
"2012-09-03 18:54","BookKeeperAdmin.java","426","6285","6711","2","13422"
"2014-04-24 10:43","BookKeeperAdmin.java","10802","93480","104282","7","208564"
"2012-10-05 16:24","BookKeeperAdmin.java","3417","16345","19762","2","39524"
"2012-09-07 07:04","BookKeeperAdmin.java","597","7922","8519","2","17038"
"2014-09-06 07:51","BookKeeperAdmin.java","11366","104993","116359","","232718"
"2013-05-10 12:45","BookKeeperAdmin.java","8710","76080","84790","5","169580"
"2012-08-24 22:44","BookKeeperAdmin.java","31","923","954","2","1908"
"2014-08-02 20:02","ServerConfiguration.java","4633","24817","29450","","58900"
"2014-05-06 12:30","ServerConfiguration.java","3822","15356","19178","7","38356"
"2014-05-15 00:41","ServerConfiguration.java","3842","16290","20132","7","40264"
"2014-09-18 06:47","ServerConfiguration.java","5069","27262","32331","","64662"
"2017-07-04 06:27","ServerConfiguration.java","114840","85075","199915","","399830"
"2014-03-07 13:14","ServerConfiguration.java","3637","12812","16449","7","32898"
"2014-04-29 22:07","ServerConfiguration.java","3819","15306","19125","7","38250"
"2016-04-14 00:51","ServerConfiguration.java","109560","38533","148093","","296186"
"2015-01-16 15:57","ServerConfiguration.java","5470","30635","36105","","72210"
"2016-03-08 06:49","ServerConfiguration.java","6509","36108","42617","","85234"
"2016-01-26 22:11","ServerConfiguration.java","6246","34831","41077","","82154"
"2014-01-21 05:05","ServerConfiguration.java","2302","9127","11429","6","22858"
"2014-03-12 21:26","ServerConfiguration.java","3723","14700","18423","7","36846"
"2016-04-05 18:47","ServerConfiguration.java","109536","38459","147995","","295990"
"2016-04-27 09:55","ServerConfiguration.java","109609","39094","148703","","297406"
"2015-04-21 09:55","ServerConfiguration.java","5527","31133","36660","","73320"
"2015-01-12 15:18","ServerConfiguration.java","5466","29693","35159","","70318"
"2015-04-21 10:02","ServerConfiguration.java","5537","31176","36713","","73426"
"2017-05-15 19:52","ServerConfiguration.java","113469","73276","186745","","373490"
"2017-03-22 22:54","ServerConfiguration.java","112671","64420","177091","","354182"
"2017-03-23 00:48","ServerConfiguration.java","112676","64477","177153","","354306"
"2017-01-31 02:11","ServerConfiguration.java","112583","57963","170546","","341092"
"2016-04-05 08:45","ServerConfiguration.java","109534","38215","147749","","295498"
"2016-11-09 03:02","ServerConfiguration.java","112533","50741","163274","","326548"
"2016-11-30 00:02","ServerConfiguration.java","112555","51445","164000","","328000"
"2017-06-05 20:30","ServerConfiguration.java","114404","77762","192166","","384332"
"2016-09-10 20:27","ServerConfiguration.java","111072","45491","156563","","313126"
"2017-08-02 00:49","ServerConfiguration.java","117951","106392","224343","","448686"
"2017-10-03 12:31","ServerConfiguration.java","125104","103702","228806","","457612"
"2017-08-16 03:37","ServerConfiguration.java","119476","114550","234026","","468052"
"2013-07-20 19:59","ServerConfiguration.java","97","666","763","5","1526"
"2013-12-02 18:45","ServerConfiguration.java","1956","7531","9487","6","18974"
"2014-05-09 14:04","ServerConfiguration.java","3837","15965","19802","7","39604"
"2017-05-26 12:38","ServerConfiguration.java","113621","75744","189365","","378730"
"2014-01-15 15:58","ServerConfiguration.java","2036","7955","9991","6","19982"
"2013-10-22 07:44","ServerConfiguration.java","1756","4834","6590","6","13180"
"2017-07-07 08:19","ServerConfiguration.java","114830","87028","201858","","403716"
"2017-06-28 23:24","ServerConfiguration.java","114567","80969","195536","","391072"
"2017-11-08 12:27","ServerConfiguration.java","126535","123007","249542","","499084"
"2014-01-22 14:35","ServerConfiguration.java","2594","10434","13028","6","26056"
"2013-10-12 05:42","ServerConfiguration.java","1526","4231","5757","6","11514"
"2017-03-28 22:35","DefaultEnsemblePlacementPolicy.java","1240","19388","20628","","41256"
"2017-07-28 20:12","DefaultEnsemblePlacementPolicy.java","6467","43391","49858","","99716"
"2017-06-01 23:58","SaslServerState.java","1148","2055","3203","","6406"
"2014-07-24 01:41","TestFencing.java","4075","16122","20197","","40394"
"2014-02-05 22:43","TestFencing.java","3121","9410","12531","7","25062"
"2017-05-16 00:31","LedgerRecoveryTest.java","111999","64250","176249","","352498"
"2017-06-21 19:50","LedgerRecoveryTest.java","113101","70147","183248","","366496"
"2017-05-15 19:52","LedgerHandle.java","40437","118152","158589","","317178"
"2017-05-02 22:07","LedgerHandle.java","40280","115641","155921","","311842"
"2017-03-23 15:55","LedgerHandle.java","40287","110022","150309","","300618"
"2012-12-28 12:32","LedgerHandle.java","17530","95638","113168","2","226336"
"2016-09-10 21:01","LedgerHandle.java","40232","92680","132912","","265824"
"2016-07-11 23:01","LedgerHandle.java","40227","88571","128798","","257596"
"2012-02-13 15:46","LedgerHandle.java","4625","16631","21256","1","42512"
"2012-01-17 16:52","LedgerHandle.java","4405","12129","16534","1","33068"
"2012-02-01 16:19","LedgerHandle.java","4463","13280","17743","1","35486"
"2012-02-13 11:19","LedgerHandle.java","4520","16446","20966","1","41932"
"2012-03-31 10:58","LedgerHandle.java","11840","31479","43319","1","86638"
"2011-11-29 23:55","LedgerHandle.java","4157","10575","14732","","29464"
"2013-04-26 18:38","LedgerHandle.java","18736","131755","150491","5","300982"
"2013-10-14 18:32","LedgerHandle.java","18919","139625","158544","6","317088"
"2014-02-05 22:43","LedgerHandle.java","19159","145041","164200","7","328400"
"2014-02-21 19:01","LedgerHandle.java","19192","146237","165429","7","330858"
"2017-05-17 08:57","LedgerHandle.java","40463","118655","159118","","318236"
"2017-05-25 14:23","LedgerHandle.java","40482","120479","160961","","321922"
"2017-06-21 19:50","LedgerHandle.java","40534","123462","163996","","327992"
"2017-06-21 21:00","LedgerHandle.java","40535","124246","164781","","329562"
"2017-06-01 23:58","LedgerHandle.java","40516","121424","161940","","323880"
"2012-06-29 18:43","LedgerHandle.java","12818","43593","56411","2","112822"
"2012-05-25 17:13","LedgerHandle.java","12570","35414","47984","1","95968"
"2012-05-10 14:47","LedgerHandle.java","12253","33843","46096","1","92192"
"2012-09-12 11:59","LedgerHandle.java","14547","68736","83283","2","166566"
"2012-06-19 12:39","LedgerHandle.java","12679","37919","50598","2","101196"
"2014-01-21 05:19","LedgerHandle.java","19001","144080","163081","6","326162"
"2012-06-27 15:35","LedgerHandle.java","12821","43266","56087","2","112174"
"2014-09-18 06:47","LedgerHandle.java","19403","159504","178907","","357814"
"2014-12-09 19:57","LedgerHandle.java","19410","160604","180014","","360028"
"2017-07-04 06:27","LedgerHandle.java","40546","128689","169235","","338470"
"2017-06-30 00:12","LedgerHandle.java","40530","126712","167242","","334484"
"2014-05-30 14:01","LedgerHandle.java","19218","150197","169415","7","338830"
"2014-05-30 15:07","LedgerHandle.java","19220","150238","169458","7","338916"
"2014-01-17 18:13","LedgerHandle.java","18986","143169","162155","6","324310"
"2013-01-07 12:25","LedgerHandle.java","17622","97533","115155","2","230310"
"2012-08-28 10:51","LedgerHandle.java","14454","65059","79513","2","159026"
"2011-11-28 19:25","LedgerHandle.java","3825","10198","14023","","28046"
"2012-09-14 11:53","LedgerHandle.java","14606","69030","83636","2","167272"
"2016-02-09 08:32","LedgerHandle.java","19474","166099","185573","","371146"
"2011-11-16 17:05","LedgerHandle.java","2735","4433","7168","","14336"
"2016-03-16 05:03","LedgerHandle.java","40192","84078","124270","","248540"
"2015-10-22 09:22","LedgerHandle.java","19474","165064","184538","","369076"
"2015-10-06 10:05","LedgerHandle.java","19469","164003","183472","","366944"
"2017-01-31 04:01","LedgerHandle.java","40292","109661","149953","","299906"
"2011-10-27 18:26","LedgerHandle.java","1168","1646","2814","","5628"
"2015-04-21 09:39","LedgerHandle.java","19431","162794","182225","","364450"
"2011-10-18 10:42","LedgerHandle.java","45","275","320","","640"
"2015-10-06 11:12","LedgerHandle.java","19470","164244","183714","","367428"
"2014-12-05 14:10","LedgerHandle.java","19405","160150","179555","","359110"
"2011-11-17 11:16","LedgerHandle.java","2969","5310","8279","","16558"
"2017-06-05 22:25","BookieRequestProcessor.java","1852","6494","8346","","16692"
"2017-07-04 06:27","BookieRequestProcessor.java","2652","13080","15732","","31464"
"2017-08-02 00:49","BookieRequestProcessor.java","7739","36373","44112","","88224"
"2016-08-01 08:04","LedgerOpenOp.java","53491","68379","121870","","243740"
"2015-10-06 10:05","LedgerOpenOp.java","12504","122883","135387","","270774"
"2015-04-21 09:17","LedgerOpenOp.java","12138","121326","133464","","266928"
"2014-01-21 05:19","LedgerOpenOp.java","10756","101680","112436","6","224872"
"2014-02-21 19:01","LedgerOpenOp.java","11311","104201","115512","7","231024"
"2017-05-16 00:31","BookieProtocol.java","48744","104033","152777","","305554"
"2017-06-01 21:20","BookieProtocol.java","49385","107001","156386","","312772"
"2013-03-18 00:31","BookieProtocol.java","12440","101542","113982","4","227964"
"2016-04-05 08:45","BookieProtocol.java","47948","71693","119641","","239282"
"2013-02-12 11:16","BookieProtocol.java","12317","101206","113523","4","227046"
"2017-05-15 19:52","BookieProtocol.java","48676","103547","152223","","304446"
"2012-10-18 16:40","BookieProtocol.java","8847","48435","57282","2","114564"
"2017-06-05 22:25","BookieProtocol.java","49377","108890","158267","","316534"
"2017-05-15 19:52","LedgerHandle.java","7492","41321","48813","","97626"
"2017-05-02 22:07","LedgerHandle.java","6494","37969","44463","","88926"
"2017-03-23 15:55","LedgerHandle.java","6237","32086","38323","","76646"
"2016-09-10 21:01","LedgerHandle.java","4250","12812","17062","","34124"
"2016-07-11 23:01","LedgerHandle.java","744","5202","5946","","11892"
"2017-05-17 08:57","LedgerHandle.java","7688","41994","49682","","99364"
"2017-05-25 14:23","LedgerHandle.java","7739","43850","51589","","103178"
"2017-06-21 19:50","LedgerHandle.java","9097","48139","57236","","114472"
"2017-06-21 21:00","LedgerHandle.java","9112","48937","58049","","116098"
"2017-06-01 23:58","LedgerHandle.java","8607","45629","54236","","108472"
"2017-07-04 06:27","LedgerHandle.java","9640","53897","63537","","127074"
"2017-06-30 00:12","LedgerHandle.java","9445","51741","61186","","122372"
"2017-01-31 04:01","LedgerHandle.java","6081","31564","37645","","75290"
"2016-12-21 01:48","SortedLedgerStorage.java","110674","25972","136646","","273292"
"2017-05-12 16:39","SortedLedgerStorage.java","111555","40953","152508","","305016"
"2017-05-16 00:31","SortedLedgerStorage.java","112289","42915","155204","","310408"
"2017-03-22 22:54","Cookie.java","112381","40935","153316","","306632"
"2016-11-30 00:02","Cookie.java","112205","27900","140105","","280210"
"2016-02-09 08:39","BookKeeperTest.java","7518","73679","81197","","162394"
"2015-10-16 07:00","BookKeeperTest.java","7393","71658","79051","","158102"
"2016-04-08 19:43","BookKeeperTest.java","78895","45233","124128","","248256"
"2017-01-31 04:01","BookKeeperTest.java","80502","69350","149852","","299704"
"2014-07-24 01:41","BookKeeperTest.java","6027","57146","63173","","126346"
"2017-05-15 19:52","BookKeeperTest.java","81261","78455","159716","","319432"
"2017-05-02 22:07","BookKeeperTest.java","80695","75535","156230","","312460"
"2013-05-06 19:32","BookKeeperTest.java","2147","35105","37252","5","74504"
"2016-04-14 00:51","ReadOnlyBookieTest.java","29","70","99","","198"
"2017-06-21 19:50","LedgerRecoveryTest.java","1681","6476","8157","","16314"
"2017-05-15 19:52","NetworkLessBookieTest.java","4280","29668","33948","","67896"
"2014-07-24 01:41","ConditionalSetTest.java","18947","146958","165905","","331810"
"2014-07-24 01:41","AsyncLedgerOpsTest.java","14466","120866","135332","","270664"
"2014-07-24 01:41","TestEntryLog.java","19400","144191","163591","","327182"
"2012-05-09 10:39","TestEntryLog.java","9214","23669","32883","1","65766"
"2014-12-10 19:43","TestEntryLog.java","19584","154003","173587","","347174"
"2016-02-24 00:44","TestEntryLog.java","19786","160092","179878","","359756"
"2014-03-12 21:26","TestEntryLog.java","19157","141193","160350","7","320700"
"2012-10-18 16:40","TestEntryLog.java","15916","71499","87415","2","174830"
"2013-10-12 05:42","TestEntryLog.java","18621","132385","151006","6","302012"
"2017-05-16 00:31","TestEntryLog.java","42326","113610","155936","","311872"
"2017-07-07 08:19","TestEntryLog.java","42495","125752","168247","","336494"
"2012-03-08 12:13","TestEntryLog.java","1022","8029","9051","1","18102"
"2012-03-13 07:31","TestEntryLog.java","1534","10842","12376","1","24752"
"2012-03-16 10:41","TestEntryLog.java","7947","18699","26646","1","53292"
"2012-03-21 06:13","TestEntryLog.java","8543","19778","28321","1","56642"
"2017-05-15 19:52","LedgerHandle.java","112523","44648","157171","","314342"
"2017-05-02 22:07","LedgerHandle.java","111535","41306","152841","","305682"
"2017-03-23 15:55","LedgerHandle.java","111187","35332","146519","","293038"
"2016-09-10 21:01","LedgerHandle.java","109237","16095","125332","","250664"
"2016-07-11 23:01","LedgerHandle.java","105742","8496","114238","","228476"
"2017-05-17 08:57","LedgerHandle.java","112706","45308","158014","","316028"
"2017-05-25 14:23","LedgerHandle.java","112755","47162","159917","","319834"
"2017-06-21 19:50","LedgerHandle.java","114042","51380","165422","","330844"
"2017-06-21 21:00","LedgerHandle.java","114056","52177","166233","","332466"
"2017-06-01 23:58","LedgerHandle.java","113607","48925","162532","","325064"
"2017-07-04 06:27","LedgerHandle.java","114570","57123","171693","","343386"
"2017-06-30 00:12","LedgerHandle.java","114384","54976","169360","","338720"
"2016-02-09 08:32","LedgerHandle.java","226","1261","1487","","2974"
"2016-03-16 05:03","LedgerHandle.java","105170","3466","108636","","217272"
"2017-01-31 04:01","LedgerHandle.java","111033","34812","145845","","291690"
"2017-05-15 19:52","TestRegionAwareEnsemblePlacementPolicy.java","2924","24826","27750","","55500"
"2017-08-16 03:41","TestRegionAwareEnsemblePlacementPolicy.java","12047","69440","81487","","162974"
"2014-08-02 20:02","ServerConfiguration.java","2987","17252","20239","","40478"
"2014-05-06 12:30","ServerConfiguration.java","2015","7630","9645","7","19290"
"2014-05-15 00:41","ServerConfiguration.java","2035","8564","10599","7","21198"
"2014-09-18 06:47","ServerConfiguration.java","3431","19705","23136","","46272"
"2017-07-04 06:27","ServerConfiguration.java","114118","78434","192552","","385104"
"2014-03-07 13:14","ServerConfiguration.java","1764","5020","6784","7","13568"
"2014-04-29 22:07","ServerConfiguration.java","2012","7580","9592","7","19184"
"2016-04-14 00:51","ServerConfiguration.java","108454","31508","139962","","279924"
"2015-01-16 15:57","ServerConfiguration.java","3908","23154","27062","","54124"
"2016-03-08 06:49","ServerConfiguration.java","5112","28792","33904","","67808"
"2016-01-26 22:11","ServerConfiguration.java","4798","27464","32262","","64524"
"2014-01-21 05:05","ServerConfiguration.java","278","1184","1462","6","2924"
"2014-03-12 21:26","ServerConfiguration.java","1897","6955","8852","7","17704"
"2016-04-05 18:47","ServerConfiguration.java","108428","31432","139860","","279720"
"2016-04-27 09:55","ServerConfiguration.java","108505","32071","140576","","281152"
"2015-04-21 09:55","ServerConfiguration.java","4012","23699","27711","","55422"
"2015-01-12 15:18","ServerConfiguration.java","3900","22208","26108","","52216"
"2015-04-21 10:02","ServerConfiguration.java","4022","23742","27764","","55528"
"2017-05-15 19:52","ServerConfiguration.java","112576","66464","179040","","358080"
"2017-03-22 22:54","ServerConfiguration.java","111659","57489","169148","","338296"
"2017-03-23 00:48","ServerConfiguration.java","111664","57546","169210","","338420"
"2017-01-31 02:11","ServerConfiguration.java","111553","51014","162567","","325134"
"2016-04-05 08:45","ServerConfiguration.java","108420","31182","139602","","279204"
"2016-11-09 03:02","ServerConfiguration.java","111492","43781","155273","","310546"
"2016-11-30 00:02","ServerConfiguration.java","111517","44488","156005","","312010"
"2017-06-05 20:30","ServerConfiguration.java","113614","71053","184667","","369334"
"2016-09-10 20:27","ServerConfiguration.java","110022","38522","148544","","297088"
"2017-08-02 00:49","ServerConfiguration.java","117591","100113","217704","","435408"
"2017-10-03 12:31","ServerConfiguration.java","125047","97726","222773","","445546"
"2017-08-16 03:37","ServerConfiguration.java","119147","108302","227449","","454898"
"2014-05-09 14:04","ServerConfiguration.java","2030","8239","10269","7","20538"
"2017-05-26 12:38","ServerConfiguration.java","112754","68958","181712","","363424"
"2017-07-07 08:19","ServerConfiguration.java","114117","80396","194513","","389026"
"2017-06-28 23:24","ServerConfiguration.java","113807","74290","188097","","376194"
"2017-11-08 12:27","ServerConfiguration.java","126683","117236","243919","","487838"
"2014-01-22 14:35","ServerConfiguration.java","619","2540","3159","6","6318"
"2017-07-28 20:12","BookKeeperClientStats.java","2449","12258","14707","","29414"
"2014-08-02 20:02","ServerConfiguration.java","3526","20632","24158","","48316"
"2014-05-06 12:30","ServerConfiguration.java","2650","11106","13756","7","27512"
"2014-05-15 00:41","ServerConfiguration.java","2670","12040","14710","7","29420"
"2014-09-18 06:47","ServerConfiguration.java","3967","23082","27049","","54098"
"2017-07-04 06:27","ServerConfiguration.java","114472","81629","196101","","392202"
"2014-03-07 13:14","ServerConfiguration.java","2401","8498","10899","7","21798"
"2014-04-29 22:07","ServerConfiguration.java","2647","11056","13703","7","27406"
"2016-04-14 00:51","ServerConfiguration.java","108919","34814","143733","","287466"
"2015-01-16 15:57","ServerConfiguration.java","4427","26514","30941","","61882"
"2016-03-08 06:49","ServerConfiguration.java","5589","32110","37699","","75398"
"2016-01-26 22:11","ServerConfiguration.java","5287","30794","36081","","72162"
"2014-01-21 05:05","ServerConfiguration.java","959","4706","5665","6","11330"
"2014-03-12 21:26","ServerConfiguration.java","2532","10431","12963","7","25926"
"2016-04-05 18:47","ServerConfiguration.java","108893","34738","143631","","287262"
"2016-04-27 09:55","ServerConfiguration.java","108970","35377","144347","","288694"
"2015-04-21 09:55","ServerConfiguration.java","4502","27030","31532","","63064"
"2015-01-12 15:18","ServerConfiguration.java","4418","25567","29985","","59970"
"2015-04-21 10:02","ServerConfiguration.java","4512","27073","31585","","63170"
"2017-05-15 19:52","ServerConfiguration.java","112980","69709","182689","","365378"
"2017-03-22 22:54","ServerConfiguration.java","112095","60766","172861","","345722"
"2017-03-23 00:48","ServerConfiguration.java","112100","60823","172923","","345846"
"2017-01-31 02:11","ServerConfiguration.java","111999","54301","166300","","332600"
"2016-04-05 08:45","ServerConfiguration.java","108885","34488","143373","","286746"
"2016-11-09 03:02","ServerConfiguration.java","111945","47075","159020","","318040"
"2016-11-30 00:02","ServerConfiguration.java","111970","47782","159752","","319504"
"2017-06-05 20:30","ServerConfiguration.java","113986","74266","188252","","376504"
"2016-09-10 20:27","ServerConfiguration.java","110475","41816","152291","","304582"
"2017-08-02 00:49","ServerConfiguration.java","117735","103098","220833","","441666"
"2017-10-03 12:31","ServerConfiguration.java","125070","100590","225660","","451320"
"2017-08-16 03:37","ServerConfiguration.java","119273","111269","230542","","461084"
"2013-12-02 18:45","ServerConfiguration.java","587","3084","3671","6","7342"
"2014-05-09 14:04","ServerConfiguration.java","2665","11715","14380","7","28760"
"2017-05-26 12:38","ServerConfiguration.java","113152","72197","185349","","370698"
"2014-01-15 15:58","ServerConfiguration.java","699","3540","4239","6","8478"
"2017-07-07 08:19","ServerConfiguration.java","114461","83581","198042","","396084"
"2017-06-28 23:24","ServerConfiguration.java","114177","77501","191678","","383356"
"2017-11-08 12:27","ServerConfiguration.java","126694","120088","246782","","493564"
"2014-01-22 14:35","ServerConfiguration.java","1271","6033","7304","6","14608"
"2017-05-15 19:52","LedgerHandle.java","112499","45680","158179","","316358"
"2017-05-02 22:07","LedgerHandle.java","111531","42358","153889","","307778"
"2017-03-23 15:55","LedgerHandle.java","111183","36384","147567","","295134"
"2016-09-10 21:01","LedgerHandle.java","109261","17175","126436","","252872"
"2016-07-11 23:01","LedgerHandle.java","105767","9577","115344","","230688"
"2017-05-17 08:57","LedgerHandle.java","112682","46340","159022","","318044"
"2017-05-25 14:23","LedgerHandle.java","112717","48180","160897","","321794"
"2017-06-21 19:50","LedgerHandle.java","114001","52395","166396","","332792"
"2017-06-21 21:00","LedgerHandle.java","114015","53192","167207","","334414"
"2017-06-01 23:58","LedgerHandle.java","113567","49941","163508","","327016"
"2017-07-04 06:27","LedgerHandle.java","114520","58129","172649","","345298"
"2017-06-30 00:12","LedgerHandle.java","114336","55984","170320","","340640"
"2016-02-09 08:32","LedgerHandle.java","266","2357","2623","","5246"
"2016-03-16 05:03","LedgerHandle.java","105210","4562","109772","","219544"
"2015-10-22 09:22","LedgerHandle.java","40","1096","1136","","2272"
"2017-01-31 04:01","LedgerHandle.java","111029","35864","146893","","293786"
"2013-10-02 06:40","MSLedgerManagerFactory.java","5076","50071","55147","5","110294"
"2017-06-01 23:58","MSLedgerManagerFactory.java","80951","87080","168031","","336062"
"2013-04-04 11:21","MSLedgerManagerFactory.java","4266","42310","46576","5","93152"
"2012-12-24 05:50","MSLedgerManagerFactory.java","1326","4633","5959","2","11918"
"2015-09-15 10:38","MSLedgerManagerFactory.java","9012","78443","87455","","174910"
"2017-03-28 22:40","MSLedgerManagerFactory.java","79621","79246","158867","","317734"
"2014-01-17 18:13","MSLedgerManagerFactory.java","6279","55683","61962","6","123924"
"2014-05-12 08:10","MSLedgerManagerFactory.java","7354","62929","70283","7","140566"
"2016-03-16 04:51","AutoRecoveryMain.java","69663","54312","123975","","247950"
"2013-10-02 06:23","AutoRecoveryMain.java","7529","68185","75714","5","151428"
"2013-01-14 16:59","AutoRecoveryMain.java","5500","27613","33113","2","66226"
"2012-12-18 12:00","AutoRecoveryMain.java","3572","22226","25798","2","51596"
"2012-10-26 16:25","AutoRecoveryMain.java","1768","7252","9020","2","18040"
"2014-03-10 03:14","AutoRecoveryMain.java","9470","78205","87675","7","175350"
"2014-04-24 10:43","AutoRecoveryMain.java","9473","79456","88929","7","177858"
"2014-09-06 07:58","AutoRecoveryMain.java","10140","91204","101344","","202688"
"2013-12-06 07:39","AutoRecoveryMain.java","8587","73188","81775","6","163550"
"2014-07-24 01:41","TestFencing.java","19370","143341","162711","","325422"
"2012-06-19 12:39","TestFencing.java","10414","27985","38399","2","76798"
"2012-12-18 13:04","TestFencing.java","16468","86777","103245","2","206490"
"2014-02-05 22:43","TestFencing.java","19074","137287","156361","7","312722"
"2012-03-31 10:58","TestFencing.java","8652","20622","29274","1","58548"
"2013-08-23 18:48","TestFencing.java","18500","130424","148924","5","297848"
"2012-03-13 07:31","TestFencing.java","1393","9881","11274","1","22548"
"2012-04-02 12:38","TestFencing.java","8667","20775","29442","1","58884"
"2017-07-07 05:11","Auditor.java","114166","74972","189138","","378276"
"2017-05-26 16:52","Auditor.java","112673","63707","176380","","352760"
"2016-09-10 21:01","Auditor.java","109704","33135","142839","","285678"
"2016-11-09 03:02","Auditor.java","111278","38377","149655","","299310"
"2016-03-08 07:18","Auditor.java","4028","23183","27211","","54422"
"2014-06-02 11:54","Auditor.java","410","2548","2958","7","5916"
"2014-05-06 12:30","Auditor.java","74","499","573","7","1146"
"2014-05-23 18:48","Auditor.java","111","1460","1571","7","3142"
"2017-07-07 05:11","Auditor.java","114055","72723","186778","","373556"
"2017-05-26 16:52","Auditor.java","112540","61436","173976","","347952"
"2016-09-10 21:01","Auditor.java","109512","30805","140317","","280634"
"2016-11-09 03:02","Auditor.java","111106","36067","147173","","294346"
"2016-03-08 07:18","Auditor.java","3826","20843","24669","","49338"
"2017-07-07 05:11","Auditor.java","114130","74511","188641","","377282"
"2017-05-26 16:52","Auditor.java","112637","63246","175883","","351766"
"2016-09-10 21:01","Auditor.java","109651","32657","142308","","284616"
"2016-11-09 03:02","Auditor.java","111225","37899","149124","","298248"
"2016-03-08 07:18","Auditor.java","3975","22705","26680","","53360"
"2014-06-02 11:54","Auditor.java","344","2057","2401","7","4802"
"2014-05-23 18:48","Auditor.java","40","964","1004","7","2008"
"2017-07-07 05:11","BookKeeperConstants.java","10295","52725","63020","","126040"
"2016-10-13 07:50","BookKeeperConstants.java","5656","14076","19732","","39464"
"2017-06-30 00:12","BookKeeperConstants.java","10060","48849","58909","","117818"
"2017-10-17 09:32","AuditorElector.java","72072","127564","199636","","399272"
"2013-08-21 13:19","AuditorElector.java","9450","80166","89616","5","179232"
"2016-07-14 23:02","AuditorElector.java","63236","62746","125982","","251964"
"2016-09-10 21:01","AuditorElector.java","63923","67503","131426","","262852"
"2013-03-05 18:45","AuditorElector.java","8659","71684","80343","4","160686"
"2012-12-18 12:00","AuditorElector.java","5862","34682","40544","2","81088"
"2012-12-14 11:18","AuditorElector.java","5624","33825","39449","2","78898"
"2012-12-08 11:18","AuditorElector.java","5322","30080","35402","2","70804"
"2017-03-28 22:40","AuditorElector.java","64186","89722","153908","","307816"
"2014-06-02 11:54","AuditorElector.java","11523","93810","105333","7","210666"
"2014-04-24 10:43","AuditorElector.java","11370","91519","102889","7","205778"
"2014-09-06 07:58","AuditorElector.java","12005","103235","115240","","230480"
"2012-10-04 18:31","AuditorElector.java","3494","13660","17154","2","34308"
"2013-01-04 11:32","AuditorElector.java","7101","37932","45033","2","90066"
"2013-02-08 19:08","MacDigestManager.java","17429","120472","137901","4","275802"
"2017-07-28 20:12","MacDigestManager.java","44316","128236","172552","","345104"
"2017-05-15 19:52","MacDigestManager.java","43342","112240","155582","","311164"
"2017-05-17 08:57","MacDigestManager.java","43384","112759","156143","","312286"
"2017-08-16 03:41","RegionAwareEnsemblePlacementPolicy.java","11890","69298","81188","","162376"
"2017-03-28 22:35","RegionAwareEnsemblePlacementPolicy.java","1079","19242","20321","","40642"
"2017-07-28 20:12","RegionAwareEnsemblePlacementPolicy.java","6310","43249","49559","","99118"
"2017-08-16 03:41","RegionAwareEnsemblePlacementPolicy.java","11924","51169","63093","","126186"
"2017-07-28 20:12","RegionAwareEnsemblePlacementPolicy.java","6033","24809","30842","","61684"
"2013-03-25 06:27","TestSpeculativeRead.java","4017","40780","44797","4","89594"
"2012-12-28 12:32","TestSpeculativeRead.java","1504","4062","5566","2","11132"
"2014-02-05 22:43","TestSpeculativeRead.java","7026","57358","64384","7","128768"
"2013-10-29 05:14","TestSpeculativeRead.java","6040","52006","58046","6","116092"
"2017-06-01 22:39","TestSpeculativeRead.java","80908","85881","166789","","333578"
"2014-07-24 01:41","TestSpeculativeRead.java","7691","63781","71472","","142944"
"2013-03-25 06:27","TestLedgerManager.java","11968","99041","111009","4","222018"
"2012-11-23 11:49","TestLedgerManager.java","8549","54225","62774","2","125548"
"2012-12-10 10:58","TestLedgerManager.java","8826","57205","66031","2","132062"
"2017-03-28 22:40","TestLedgerManager.java","48290","97454","145744","","291488"
"2015-07-10 22:48","TestLedgerManager.java","15034","133702","148736","","297472"
"2014-07-24 01:41","TestLedgerManager.java","14466","120866","135332","","270664"
"2017-07-04 06:27","LedgerCache.java","82514","92679","175193","","350386"
"2017-05-16 00:31","LedgerCache.java","81360","81515","162875","","325750"
"2016-11-18 00:18","LedgerCache.java","80536","58826","139362","","278724"
"2017-05-15 19:52","LedgerHandle.java","2252","10598","12850","","25700"
"2017-05-02 22:07","LedgerHandle.java","734","6726","7460","","14920"
"2017-03-23 15:55","LedgerHandle.java","201","567","768","","1536"
"2017-05-17 08:57","LedgerHandle.java","2503","11326","13829","","27658"
"2017-05-25 14:23","LedgerHandle.java","2557","13185","15742","","31484"
"2017-06-21 19:50","LedgerHandle.java","4020","17579","21599","","43198"
"2017-06-21 21:00","LedgerHandle.java","4036","18378","22414","","44828"
"2017-06-01 23:58","LedgerHandle.java","3520","15059","18579","","37158"
"2017-07-04 06:27","LedgerHandle.java","4684","23458","28142","","56284"
"2017-06-30 00:12","LedgerHandle.java","4415","21228","25643","","51286"
"2017-03-22 22:54","UpdateCookieCmdTest.java","112407","41518","153925","","307850"
"2017-05-15 19:52","TryReadLastConfirmedOp.java","112424","59160","171584","","343168"
"2017-05-15 19:52","LedgerHandle.java","40265","117502","157767","","315534"
"2017-05-02 22:07","LedgerHandle.java","40108","114991","155099","","310198"
"2017-03-23 15:55","LedgerHandle.java","40114","109371","149485","","298970"
"2012-12-28 12:32","LedgerHandle.java","17053","94683","111736","2","223472"
"2016-09-10 21:01","LedgerHandle.java","40023","91993","132016","","264032"
"2016-07-11 23:01","LedgerHandle.java","40018","87884","127902","","255804"
"2012-02-13 15:46","LedgerHandle.java","3724","15252","18976","1","37952"
"2012-01-17 16:52","LedgerHandle.java","3493","10739","14232","1","28464"
"2012-02-01 16:19","LedgerHandle.java","3556","11895","15451","1","30902"
"2012-02-13 11:19","LedgerHandle.java","3613","15061","18674","1","37348"
"2012-03-31 10:58","LedgerHandle.java","11072","30233","41305","1","82610"
"2011-11-29 23:55","LedgerHandle.java","3227","9167","12394","","24788"
"2013-04-26 18:38","LedgerHandle.java","18302","130843","149145","5","298290"
"2013-10-14 18:32","LedgerHandle.java","18545","138773","157318","6","314636"
"2014-02-05 22:43","LedgerHandle.java","18838","144242","163080","7","326160"
"2014-02-21 19:01","LedgerHandle.java","18870","145437","164307","7","328614"
"2017-05-17 08:57","LedgerHandle.java","40293","118007","158300","","316600"
"2017-05-25 14:23","LedgerHandle.java","40312","119831","160143","","320286"
"2017-06-21 19:50","LedgerHandle.java","40395","122845","163240","","326480"
"2017-06-21 21:00","LedgerHandle.java","40396","123629","164025","","328050"
"2017-06-01 23:58","LedgerHandle.java","40373","120803","161176","","322352"
"2012-06-29 18:43","LedgerHandle.java","12128","42425","54553","2","109106"
"2012-05-25 17:13","LedgerHandle.java","11812","34178","45990","1","91980"
"2012-05-10 14:47","LedgerHandle.java","11494","32606","44100","1","88200"
"2012-09-12 11:59","LedgerHandle.java","14056","67767","81823","2","163646"
"2012-06-19 12:39","LedgerHandle.java","11948","36710","48658","2","97316"
"2014-01-21 05:19","LedgerHandle.java","18635","143236","161871","6","323742"
"2012-06-27 15:35","LedgerHandle.java","12121","42088","54209","2","108418"
"2014-09-18 06:47","LedgerHandle.java","19195","158818","178013","","356026"
"2014-12-09 19:57","LedgerHandle.java","19202","159918","179120","","358240"
"2017-07-04 06:27","LedgerHandle.java","40417","128082","168499","","336998"
"2017-06-30 00:12","LedgerHandle.java","40391","126095","166486","","332972"
"2014-05-30 14:01","LedgerHandle.java","18904","149405","168309","7","336618"
"2014-05-30 15:07","LedgerHandle.java","18906","149446","168352","7","336704"
"2014-01-17 18:13","LedgerHandle.java","18612","142317","160929","6","321858"
"2013-01-07 12:25","LedgerHandle.java","17147","96580","113727","2","227454"
"2012-08-28 10:51","LedgerHandle.java","13949","64076","78025","2","156050"
"2011-11-28 19:25","LedgerHandle.java","2895","8790","11685","","23370"
"2012-09-14 11:53","LedgerHandle.java","14115","68061","82176","2","164352"
"2016-02-09 08:32","LedgerHandle.java","19267","165414","184681","","369362"
"2011-11-16 17:05","LedgerHandle.java","1661","2881","4542","","9084"
"2016-03-16 05:03","LedgerHandle.java","39982","83390","123372","","246744"
"2015-10-22 09:22","LedgerHandle.java","19267","164379","183646","","367292"
"2015-10-06 10:05","LedgerHandle.java","19261","163317","182578","","365156"
"2017-01-31 04:01","LedgerHandle.java","40119","109010","149129","","298258"
"2015-04-21 09:39","LedgerHandle.java","19223","162108","181331","","362662"
"2015-10-06 11:12","LedgerHandle.java","19262","163558","182820","","365640"
"2014-12-05 14:10","LedgerHandle.java","19197","159464","178661","","357322"
"2011-11-17 11:16","LedgerHandle.java","1903","3766","5669","","11338"
"2014-07-24 01:41","TestFencing.java","20388","135871","156259","","312518"
"2012-06-19 12:39","TestFencing.java","10184","19267","29451","2","58902"
"2012-12-18 13:04","TestFencing.java","16899","78720","95619","2","191238"
"2014-02-05 22:43","TestFencing.java","20024","129749","149773","7","299546"
"2012-03-31 10:58","TestFencing.java","7952","11434","19386","1","38772"
"2013-08-23 18:48","TestFencing.java","19237","122673","141910","5","283820"
"2012-04-02 12:38","TestFencing.java","7994","11614","19608","1","39216"
"2017-05-15 19:52","BenchBookie.java","7750","37087","44837","","89674"
"2017-07-07 05:11","Auditor.java","114224","73681","187905","","375810"
"2017-05-26 16:52","Auditor.java","112725","62410","175135","","350270"
"2016-09-10 21:01","Auditor.java","109728","31810","141538","","283076"
"2016-11-09 03:02","Auditor.java","111302","37052","148354","","296708"
"2016-03-08 07:18","Auditor.java","4055","21861","25916","","51832"
"2014-06-02 11:54","Auditor.java","305","1094","1399","7","2798"
"2016-12-21 01:48","SortedLedgerStorage.java","111396","45316","156712","","313424"
"2017-05-12 16:39","SortedLedgerStorage.java","112112","60132","172244","","344488"
"2017-05-16 00:31","SortedLedgerStorage.java","112644","61892","174536","","349072"
"2014-08-02 20:02","SortedLedgerStorage.java","1466","10673","12139","","24278"
"2016-03-08 06:49","SortedLedgerStorage.java","3999","22621","26620","","53240"
"2015-04-21 10:02","SortedLedgerStorage.java","2814","17476","20290","","40580"
"2017-08-02 00:49","ServerConfiguration.java","5256","21499","26755","","53510"
"2017-10-03 12:31","ServerConfiguration.java","30487","36887","67374","","134748"
"2017-08-16 03:37","ServerConfiguration.java","7759","30635","38394","","76788"
"2017-11-08 12:27","ServerConfiguration.java","34874","59148","94022","","188044"
"2017-05-15 19:52","PendingReadLacOp.java","2252","10598","12850","","25700"
"2017-06-01 23:58","PendingReadLacOp.java","3520","15059","18579","","37158"
"2017-06-30 00:12","PendingReadLacOp.java","4415","21228","25643","","51286"
"2017-07-04 06:27","ServerConfiguration.java","663","4496","5159","","10318"
"2017-08-02 00:49","ServerConfiguration.java","5929","27968","33897","","67794"
"2017-10-03 12:31","ServerConfiguration.java","31102","43298","74400","","148800"
"2017-08-16 03:37","ServerConfiguration.java","8421","37093","45514","","91028"
"2017-07-07 08:19","ServerConfiguration.java","803","6599","7402","","14804"
"2017-11-08 12:27","ServerConfiguration.java","35405","65475","100880","","201760"
"2017-05-26 16:52","Journal.java","1455","5253","6708","","13416"
"2017-06-01 23:58","Journal.java","2470","7125","9595","","19190"
"2017-05-16 00:31","Journal.java","1357","3237","4594","","9188"
"2017-06-30 00:12","ReadLastConfirmedOp.java","113438","72575","186013","","372026"
"2017-05-15 19:52","ReadLastConfirmedOp.java","111919","62589","174508","","349016"
"2017-06-01 23:58","ReadLastConfirmedOp.java","112883","66746","179629","","359258"
"2017-03-28 22:35","DefaultEnsemblePlacementPolicy.java","110928","59007","169935","","339870"
"2017-07-28 20:12","DefaultEnsemblePlacementPolicy.java","114467","81322","195789","","391578"
"2016-10-13 07:50","DefaultEnsemblePlacementPolicy.java","110618","40549","151167","","302334"
"2014-07-24 01:41","TestEntryLog.java","20372","138156","158528","","317056"
"2012-05-09 10:39","TestEntryLog.java","8918","16366","25284","1","50568"
"2014-12-10 19:43","TestEntryLog.java","20639","148051","168690","","337380"
"2016-02-24 00:44","TestEntryLog.java","20880","154179","175059","","350118"
"2014-03-12 21:26","TestEntryLog.java","20081","135110","155191","7","310382"
"2012-10-18 16:40","TestEntryLog.java","16175","64751","80926","2","161852"
"2013-10-12 05:42","TestEntryLog.java","19426","126183","145609","6","291218"
"2017-05-16 00:31","TestEntryLog.java","46334","110611","156945","","313890"
"2017-07-07 08:19","TestEntryLog.java","47003","123253","170256","","340512"
"2012-03-13 07:31","TestEntryLog.java","610","2911","3521","1","7042"
"2012-03-16 10:41","TestEntryLog.java","7134","10879","18013","1","36026"
"2012-03-21 06:13","TestEntryLog.java","8096","12324","20420","1","40840"
"2017-05-15 19:52","LedgerHandle.java","113304","47656","160960","","321920"
"2017-05-02 22:07","LedgerHandle.java","112371","44369","156740","","313480"
"2017-03-23 15:55","LedgerHandle.java","112052","38424","150476","","300952"
"2016-09-10 21:01","LedgerHandle.java","110163","19248","129411","","258822"
"2016-07-11 23:01","LedgerHandle.java","106669","11650","118319","","236638"
"2017-05-17 08:57","LedgerHandle.java","113486","48315","161801","","323602"
"2017-05-25 14:23","LedgerHandle.java","113521","50155","163676","","327352"
"2017-06-21 19:50","LedgerHandle.java","114793","54358","169151","","338302"
"2017-06-21 21:00","LedgerHandle.java","114807","55155","169962","","339924"
"2017-06-01 23:58","LedgerHandle.java","114361","51906","166267","","332534"
"2017-07-04 06:27","LedgerHandle.java","115318","60098","175416","","350832"
"2017-06-30 00:12","LedgerHandle.java","115137","57956","173093","","346186"
"2016-02-09 08:32","LedgerHandle.java","1302","4564","5866","","11732"
"2016-03-16 05:03","LedgerHandle.java","106147","6670","112817","","225634"
"2015-10-22 09:22","LedgerHandle.java","1081","3308","4389","","8778"
"2015-10-06 10:05","LedgerHandle.java","1042","2213","3255","","6510"
"2017-01-31 04:01","LedgerHandle.java","111902","37908","149810","","299620"
"2015-10-06 11:12","LedgerHandle.java","1049","2460","3509","","7018"
"2014-07-24 01:41","TestEntryLog.java","20388","135871","156259","","312518"
"2012-05-09 10:39","TestEntryLog.java","8589","13736","22325","1","44650"
"2014-12-10 19:43","TestEntryLog.java","20772","145883","166655","","333310"
"2016-02-24 00:44","TestEntryLog.java","21118","152116","173234","","346468"
"2014-03-12 21:26","TestEntryLog.java","20090","132818","152908","7","305816"
"2012-10-18 16:40","TestEntryLog.java","15989","62264","78253","2","156506"
"2013-10-12 05:42","TestEntryLog.java","19402","123858","143260","6","286520"
"2017-05-16 00:31","TestEntryLog.java","46620","108596","155216","","310432"
"2017-07-07 08:19","TestEntryLog.java","47312","121261","168573","","337146"
"2012-03-16 10:41","TestEntryLog.java","6720","8164","14884","1","29768"
"2012-03-21 06:13","TestEntryLog.java","7687","9614","17301","1","34602"
"2019-02-20 11:43","IndexInMemPageMgr.java","40206","395039","435245","","870490"
"2017-06-01 23:58","IndexInMemPageMgr.java","9283","43542","52825","","105650"
"2014-08-02 20:02","ServerConfiguration.java","2659","15003","17662","","35324"
"2014-05-06 12:30","ServerConfiguration.java","1419","5113","6532","7","13064"
"2014-05-15 00:41","ServerConfiguration.java","1447","6055","7502","7","15004"
"2014-09-18 06:47","ServerConfiguration.java","3225","17578","20803","","41606"
"2017-07-04 06:27","ServerConfiguration.java","114094","76489","190583","","381166"
"2014-03-07 13:14","ServerConfiguration.java","1168","2503","3671","7","7342"
"2014-04-29 22:07","ServerConfiguration.java","1416","5063","6479","7","12958"
"2016-04-14 00:51","ServerConfiguration.java","108377","29510","137887","","275774"
"2015-01-16 15:57","ServerConfiguration.java","3711","21036","24747","","49494"
"2016-03-08 06:49","ServerConfiguration.java","4990","26749","31739","","63478"
"2016-01-26 22:11","ServerConfiguration.java","4672","25417","30089","","60178"
"2014-03-12 21:26","ServerConfiguration.java","1301","4438","5739","7","11478"
"2016-04-05 18:47","ServerConfiguration.java","108351","29434","137785","","275570"
"2016-04-27 09:55","ServerConfiguration.java","108428","30073","138501","","277002"
"2015-04-21 09:55","ServerConfiguration.java","3842","21608","25450","","50900"
"2015-01-12 15:18","ServerConfiguration.java","3703","20090","23793","","47586"
"2015-04-21 10:02","ServerConfiguration.java","3854","21653","25507","","51014"
"2017-05-15 19:52","ServerConfiguration.java","112534","64501","177035","","354070"
"2017-03-22 22:54","ServerConfiguration.java","111601","55510","167111","","334222"
"2017-03-23 00:48","ServerConfiguration.java","111605","55566","167171","","334342"
"2017-01-31 02:11","ServerConfiguration.java","111495","49035","160530","","321060"
"2016-04-05 08:45","ServerConfiguration.java","108343","29184","137527","","275054"
"2016-11-09 03:02","ServerConfiguration.java","111415","41783","153198","","306396"
"2016-11-30 00:02","ServerConfiguration.java","111455","42505","153960","","307920"
"2017-06-05 20:30","ServerConfiguration.java","113595","69113","182708","","365416"
"2016-09-10 20:27","ServerConfiguration.java","109947","36526","146473","","292946"
"2017-08-02 00:49","ServerConfiguration.java","117621","98222","215843","","431686"
"2017-10-03 12:31","ServerConfiguration.java","125102","95860","220962","","441924"
"2017-08-16 03:37","ServerConfiguration.java","119177","106411","225588","","451176"
"2014-05-09 14:04","ServerConfiguration.java","1434","5722","7156","7","14312"
"2017-05-26 12:38","ServerConfiguration.java","112713","66996","179709","","359418"
"2017-07-07 08:19","ServerConfiguration.java","114093","78451","192544","","385088"
"2017-06-28 23:24","ServerConfiguration.java","113788","72350","186138","","372276"
"2017-11-08 12:27","ServerConfiguration.java","126878","115510","242388","","484776"
"2014-08-02 20:02","Journal.java","3699","21178","24877","","49754"
"2014-03-07 13:14","Journal.java","2585","9055","11640","7","23280"
"2014-04-29 22:07","Journal.java","2831","11613","14444","7","28888"
"2013-12-06 07:39","Journal.java","796","3818","4614","6","9228"
"2015-04-21 09:23","Journal.java","4637","27371","32008","","64016"
"2016-02-09 08:30","Journal.java","5538","31539","37077","","74154"
"2015-02-23 08:11","Journal.java","4619","27117","31736","","63472"
"2017-05-26 16:52","Journal.java","113230","72668","185898","","371796"
"2017-03-22 22:54","Journal.java","112187","61231","173418","","346836"
"2016-11-12 03:37","Journal.java","112038","47589","159627","","319254"
"2016-07-14 23:02","Journal.java","109358","37123","146481","","292962"
"2017-06-01 23:58","Journal.java","113967","74262","188229","","376458"
"2017-05-09 22:24","Journal.java","112705","68345","181050","","362100"
"2017-05-16 00:31","Journal.java","113176","70696","183872","","367744"
"2014-07-24 01:41","TestFencing.java","19815","144916","164731","","329462"
"2012-06-19 12:39","TestFencing.java","10981","29682","40663","2","81326"
"2012-12-18 13:04","TestFencing.java","16950","88389","105339","2","210678"
"2014-02-05 22:43","TestFencing.java","19529","138872","158401","7","316802"
"2012-03-31 10:58","TestFencing.java","9317","22417","31734","1","63468"
"2013-08-23 18:48","TestFencing.java","18958","132012","150970","5","301940"
"2012-01-11 15:46","TestFencing.java","733","1863","2596","1","5192"
"2012-03-13 07:31","TestFencing.java","2064","11682","13746","1","27492"
"2012-04-02 12:38","TestFencing.java","9332","22570","31902","1","63804"
"2017-06-01 23:58","ReplicationWorker.java","64953","98630","163583","","327166"
"2017-04-11 20:14","ReplicationWorker.java","63790","90979","154769","","309538"
"2014-02-05 22:43","ReplicationWorker.java","10911","89562","100473","7","200946"
"2013-10-02 06:23","ReplicationWorker.java","9186","81645","90831","5","181662"
"2016-03-16 04:51","ReplicationWorker.java","62645","59097","121742","","243484"
"2016-09-10 21:01","ReplicationWorker.java","63532","68749","132281","","264562"
"2017-05-26 16:52","ReplicationWorker.java","64371","97191","161562","","323124"
"2012-12-18 12:00","ReplicationWorker.java","5596","36053","41649","2","83298"
"2015-04-21 09:17","ReplicationWorker.java","11927","108039","119966","","239932"
"2013-01-03 11:06","ReplicationWorker.java","6804","38457","45261","2","90522"
"2012-09-12 20:34","ReplicationWorker.java","873","8025","8898","2","17796"
"2013-12-06 07:39","ReplicationWorker.java","10221","86625","96846","6","193692"
"2014-04-24 10:43","ReplicationWorker.java","11028","92814","103842","7","207684"
"2014-09-06 07:58","ReplicationWorker.java","11614","104481","116095","","232190"
"2012-10-04 18:31","ReplicationWorker.java","3457","15260","18717","2","37434"
"2015-09-15 10:38","AbstractConfiguration.java","10517","81683","92200","","184400"
"2017-03-28 22:40","AbstractConfiguration.java","79516","80876","160392","","320784"
"2012-12-12 11:20","AbstractConfiguration.java","2056","3791","5847","2","11694"
"2017-08-02 00:49","AbstractConfiguration.java","84109","117414","201523","","403046"
"2013-06-12 18:41","AbstractConfiguration.java","6499","50936","57435","5","114870"
"2016-07-31 07:53","AbstractConfiguration.java","78163","53597","131760","","263520"
"2017-01-31 02:14","AbstractConfiguration.java","79355","70211","149566","","299132"
"2016-07-31 07:56","AbstractConfiguration.java","78163","53931","132094","","264188"
"2017-05-02 23:04","AbstractConfiguration.java","79817","82998","162815","","325630"
"2017-03-23 00:48","AbstractConfiguration.java","79445","76110","155555","","311110"
"2017-07-07 05:11","BookKeeperConstants.java","80807","97004","177811","","355622"
"2016-10-13 07:50","BookKeeperConstants.java","78883","61070","139953","","279906"
"2017-06-30 00:12","BookKeeperConstants.java","80727","93283","174010","","348020"
"2016-04-27 09:55","BookKeeperConstants.java","77648","51415","129063","","258126"
"2015-04-21 10:02","BookKeeperConstants.java","8300","78221","86521","","173042"
"2017-07-28 20:12","LedgerChecker.java","4229","19251","23480","","46960"
"2017-05-04 20:58","AbstractZkLedgerManager.java","112119","58016","170135","","340270"
"2017-06-01 23:58","AbstractZkLedgerManager.java","113520","64074","177594","","355188"
"2017-06-12 17:20","AbstractZkLedgerManager.java","113742","66073","179815","","359630"
"2017-03-28 22:40","AbstractZkLedgerManager.java","111633","55683","167316","","334632"
"2016-02-09 08:23","AbstractZkLedgerManager.java","3752","19853","23605","","47210"
"2015-09-15 10:38","AbstractZkLedgerManager.java","3534","17390","20924","","41848"
"2016-02-23 19:16","AbstractZkLedgerManager.java","3786","20225","24011","","48022"
"2017-05-15 19:52","BookKeeperClusterTestCase.java","112498","45453","157951","","315902"
"2016-04-05 08:45","BookKeeperClusterTestCase.java","105289","7118","112407","","224814"
"2017-08-01 08:34","BookKeeperClusterTestCase.java","117844","76848","194692","","389384"
"2017-11-08 12:27","BookKeeperClusterTestCase.java","132438","102058","234496","","468992"
"2017-07-04 06:27","BookKeeperClusterTestCase.java","114521","57904","172425","","344850"
"2017-06-30 00:12","BookKeeperClusterTestCase.java","114336","55758","170094","","340188"
"2016-04-27 09:55","BookKeeperClusterTestCase.java","105389","8022","113411","","226822"
"2014-08-02 20:02","Journal.java","4362","22764","27126","","54252"
"2014-03-07 13:14","Journal.java","3277","10670","13947","7","27894"
"2014-04-29 22:07","Journal.java","3504","13209","16713","7","33426"
"2013-12-06 07:39","Journal.java","1547","5492","7039","6","14078"
"2015-04-21 09:23","Journal.java","5264","28921","34185","","68370"
"2016-02-09 08:30","Journal.java","6106","33030","39136","","78272"
"2015-02-23 08:11","Journal.java","5252","28673","33925","","67850"
"2017-05-26 16:52","Journal.java","113714","74075","187789","","375578"
"2017-03-22 22:54","Journal.java","112688","62655","175343","","350686"
"2016-11-12 03:37","Journal.java","112549","49023","161572","","323144"
"2016-07-14 23:02","Journal.java","109876","38564","148440","","296880"
"2017-06-01 23:58","Journal.java","114449","75667","190116","","380232"
"2017-05-09 22:24","Journal.java","113204","69767","182971","","365942"
"2013-10-12 05:42","Journal.java","1114","2037","3151","6","6302"
"2017-05-16 00:31","Journal.java","113660","72103","185763","","371526"
"2017-05-15 19:52","LedgerHandle.java","40530","118015","158545","","317090"
"2017-05-02 22:07","LedgerHandle.java","40374","115505","155879","","311758"
"2017-03-23 15:55","LedgerHandle.java","40381","109886","150267","","300534"
"2012-12-28 12:32","LedgerHandle.java","17588","95466","113054","2","226108"
"2016-09-10 21:01","LedgerHandle.java","40323","92541","132864","","265728"
"2016-07-11 23:01","LedgerHandle.java","40318","88432","128750","","257500"
"2012-02-13 15:46","LedgerHandle.java","4621","16397","21018","1","42036"
"2012-01-17 16:52","LedgerHandle.java","4396","11890","16286","1","32572"
"2012-02-01 16:19","LedgerHandle.java","4456","13043","17499","1","34998"
"2012-02-13 11:19","LedgerHandle.java","4513","16209","20722","1","41444"
"2012-03-31 10:58","LedgerHandle.java","11836","31245","43081","1","86162"
"2011-11-29 23:55","LedgerHandle.java","4141","10329","14470","","28940"
"2013-04-26 18:38","LedgerHandle.java","18800","131589","150389","5","300778"
"2013-10-14 18:32","LedgerHandle.java","18992","139468","158460","6","316920"
"2014-02-05 22:43","LedgerHandle.java","19240","144892","164132","7","328264"
"2014-02-21 19:01","LedgerHandle.java","19272","146087","165359","7","330718"
"2017-05-17 08:57","LedgerHandle.java","40556","118518","159074","","318148"
"2017-05-25 14:23","LedgerHandle.java","40575","120342","160917","","321834"
"2017-06-21 19:50","LedgerHandle.java","40626","123324","163950","","327900"
"2017-06-21 21:00","LedgerHandle.java","40627","124108","164735","","329470"
"2017-06-01 23:58","LedgerHandle.java","40607","121285","161892","","323784"
"2012-06-29 18:43","LedgerHandle.java","12839","43384","56223","2","112446"
"2012-05-25 17:13","LedgerHandle.java","12568","35182","47750","1","95500"
"2012-05-10 14:47","LedgerHandle.java","12253","33613","45866","1","91732"
"2012-09-12 11:59","LedgerHandle.java","14602","68561","83163","2","166326"
"2012-06-19 12:39","LedgerHandle.java","12697","37707","50404","2","100808"
"2014-01-21 05:19","LedgerHandle.java","19076","143925","163001","6","326002"
"2012-06-27 15:35","LedgerHandle.java","12842","43057","55899","2","111798"
"2014-09-18 06:47","LedgerHandle.java","19492","159363","178855","","357710"
"2014-12-09 19:57","LedgerHandle.java","19499","160463","179962","","359924"
"2017-07-04 06:27","LedgerHandle.java","40647","128560","169207","","338414"
"2017-06-30 00:12","LedgerHandle.java","40622","126574","167196","","334392"
"2014-05-30 14:01","LedgerHandle.java","19299","150048","169347","7","338694"
"2014-05-30 15:07","LedgerHandle.java","19301","150089","169390","7","338780"
"2014-01-17 18:13","LedgerHandle.java","19060","143013","162073","6","324146"
"2013-01-07 12:25","LedgerHandle.java","17681","97362","115043","2","230086"
"2012-08-28 10:51","LedgerHandle.java","14509","64884","79393","2","158786"
"2011-11-28 19:25","LedgerHandle.java","3809","9952","13761","","27522"
"2012-09-14 11:53","LedgerHandle.java","14661","68855","83516","2","167032"
"2016-02-09 08:32","LedgerHandle.java","19563","165958","185521","","371042"
"2011-11-16 17:05","LedgerHandle.java","2702","4170","6872","","13744"
"2016-03-16 05:03","LedgerHandle.java","40283","83939","124222","","248444"
"2015-10-22 09:22","LedgerHandle.java","19563","164923","184486","","368972"
"2015-10-06 10:05","LedgerHandle.java","19558","163862","183420","","366840"
"2017-01-31 04:01","LedgerHandle.java","40386","109525","149911","","299822"
"2011-10-27 18:26","LedgerHandle.java","1132","1380","2512","","5024"
"2015-04-21 09:39","LedgerHandle.java","19520","162653","182173","","364346"
"2015-10-06 11:12","LedgerHandle.java","19559","164103","183662","","367324"
"2014-12-05 14:10","LedgerHandle.java","19494","160009","179503","","359006"
"2011-11-17 11:16","LedgerHandle.java","2939","5050","7989","","15978"
"2017-05-25 14:23","LedgerFragmentReplicator.java","71671","92401","164072","","328144"
"2014-02-05 22:43","LedgerFragmentReplicator.java","9255","75870","85125","7","170250"
"2014-02-21 19:01","LedgerFragmentReplicator.java","9360","77138","86498","7","172996"
"2016-09-10 21:01","LedgerFragmentReplicator.java","70731","63912","134643","","269286"
"2017-07-28 20:12","BKException.java","81538","100694","182232","","364464"
"2016-07-11 22:53","BKException.java","77880","51736","129616","","259232"
"2017-05-02 23:04","BKException.java","79619","82263","161882","","323764"
"2013-09-10 15:14","BKException.java","6212","52271","58483","5","116966"
"2014-02-21 19:01","BKException.java","8361","61825","70186","7","140372"
"2017-08-02 00:49","BKException.java","83924","116692","200616","","401232"
"2012-12-12 11:20","BKException.java","1481","2679","4160","2","8320"
"2015-09-15 10:38","BKException.java","10016","80645","90661","","181322"
"2017-01-31 04:01","BKException.java","79169","74957","154126","","308252"
"2015-10-06 10:48","BKException.java","10022","81201","91223","","182446"
"2015-10-22 09:22","BKException.java","10045","82054","92099","","184198"
"2017-07-04 06:27","LedgerCache.java","4948","36823","41771","","83542"
"2017-05-16 00:31","LedgerCache.java","2889","24754","27643","","55286"
"2017-08-16 03:41","RegionAwareEnsemblePlacementPolicy.java","6342","26811","33153","","66306"
"2014-08-02 20:02","ServerConfiguration.java","3699","21178","24877","","49754"
"2014-05-06 12:30","ServerConfiguration.java","2834","11663","14497","7","28994"
"2014-05-15 00:41","ServerConfiguration.java","2854","12597","15451","7","30902"
"2014-09-18 06:47","ServerConfiguration.java","4140","23628","27768","","55536"
"2017-07-04 06:27","ServerConfiguration.java","114520","82050","196570","","393140"
"2014-03-07 13:14","ServerConfiguration.java","2585","9055","11640","7","23280"
"2014-04-29 22:07","ServerConfiguration.java","2831","11613","14444","7","28888"
"2016-04-14 00:51","ServerConfiguration.java","109051","35319","144370","","288740"
"2015-01-16 15:57","ServerConfiguration.java","4594","27054","31648","","63296"
"2016-03-08 06:49","ServerConfiguration.java","5721","32615","38336","","76672"
"2016-01-26 22:11","ServerConfiguration.java","5442","31322","36764","","73528"
"2014-01-21 05:05","ServerConfiguration.java","1145","5265","6410","6","12820"
"2014-03-12 21:26","ServerConfiguration.java","2716","10988","13704","7","27408"
"2016-04-05 18:47","ServerConfiguration.java","109025","35243","144268","","288536"
"2016-04-27 09:55","ServerConfiguration.java","109102","35882","144984","","289968"
"2015-04-21 09:55","ServerConfiguration.java","4657","27558","32215","","64430"
"2015-01-12 15:18","ServerConfiguration.java","4591","26113","30704","","61408"
"2015-04-21 10:02","ServerConfiguration.java","4667","27601","32268","","64536"
"2017-05-15 19:52","ServerConfiguration.java","113068","70170","183238","","366476"
"2017-03-22 22:54","ServerConfiguration.java","112187","61231","173418","","346836"
"2017-03-23 00:48","ServerConfiguration.java","112192","61288","173480","","346960"
"2017-01-31 02:11","ServerConfiguration.java","112091","54766","166857","","333714"
"2016-04-05 08:45","ServerConfiguration.java","109017","34993","144010","","288020"
"2016-11-09 03:02","ServerConfiguration.java","112037","47540","159577","","319154"
"2016-11-30 00:02","ServerConfiguration.java","112062","48247","160309","","320618"
"2017-06-05 20:30","ServerConfiguration.java","114060","74713","188773","","377546"
"2016-09-10 20:27","ServerConfiguration.java","110567","42281","152848","","305696"
"2017-08-02 00:49","ServerConfiguration.java","117767","103503","221270","","442540"
"2017-10-03 12:31","ServerConfiguration.java","125074","100967","226041","","452082"
"2017-08-16 03:37","ServerConfiguration.java","119292","111661","230953","","461906"
"2013-12-02 18:45","ServerConfiguration.java","761","3631","4392","6","8784"
"2014-05-09 14:04","ServerConfiguration.java","2849","12272","15121","7","30242"
"2017-05-26 12:38","ServerConfiguration.java","113229","72647","185876","","371752"
"2014-01-15 15:58","ServerConfiguration.java","867","4081","4948","6","9896"
"2013-10-22 07:44","ServerConfiguration.java","244","617","861","6","1722"
"2017-07-07 08:19","ServerConfiguration.java","114509","84002","198511","","397022"
"2017-06-28 23:24","ServerConfiguration.java","114231","77928","192159","","384318"
"2017-11-08 12:27","ServerConfiguration.java","126655","120422","247077","","494154"
"2014-01-22 14:35","ServerConfiguration.java","1456","6591","8047","6","16094"
"2014-04-29 22:07","ClientUtil.java","19811","137496","157307","7","314614"
"2012-09-12 20:34","ClientUtil.java","13445","56118","69563","2","139126"
"2017-05-15 19:52","ClientUtil.java","45790","111795","157585","","315170"
"2017-05-25 14:23","ClientUtil.java","45867","114154","160021","","320042"
"2017-05-16 00:31","LedgerCacheImpl.java","2479","11243","13722","","27444"
"2017-06-01 23:58","LedgerCacheImpl.java","3520","15059","18579","","37158"
"2017-07-04 06:27","LedgerCacheImpl.java","4684","23458","28142","","56284"
"2014-07-24 01:41","TestFencing.java","15525","127388","142913","","285826"
"2012-06-19 12:39","TestFencing.java","2403","7866","10269","2","20538"
"2012-12-18 13:04","TestFencing.java","10871","69072","79943","2","159886"
"2014-02-05 22:43","TestFencing.java","15142","121247","136389","7","272778"
"2013-08-23 18:48","TestFencing.java","13749","113565","127314","5","254628"
"2016-11-30 00:19","SystemPropertiesConfigurationTest.java","5579","19339","24918","","49836"
"2014-08-02 20:02","DiskChecker.java","6190","64199","70389","","140778"
"2014-01-15 15:58","DiskChecker.java","4214","47958","52172","6","104344"
"2017-07-07 08:19","DiskChecker.java","82244","92267","174511","","349022"
"2017-06-05 20:30","DiskChecker.java","81835","83018","164853","","329706"
"2017-05-26 16:52","Journal.java","119","2037","2156","","4312"
"2017-06-01 23:58","Journal.java","1160","3935","5095","","10190"
"2012-05-25 17:13","UpgradeTest.java","9368","16055","25423","1","50846"
"2014-12-10 19:43","UpgradeTest.java","20772","145883","166655","","333310"
"2012-09-07 07:26","UpgradeTest.java","13104","50646","63750","2","127500"
"2017-05-15 19:52","UpgradeTest.java","46580","108138","154718","","309436"
"2012-11-23 11:49","UpgradeTest.java","16413","71172","87585","2","175170"
"2013-10-11 08:36","UpgradeTest.java","19320","123235","142555","6","285110"
"2013-10-12 05:42","UpgradeTest.java","19402","123858","143260","6","286520"
"2012-03-29 15:18","UpgradeTest.java","7834","10478","18312","1","36624"
"2017-08-16 03:41","CachedDNSToSwitchMapping.java","119164","114889","234053","","468106"
"2017-03-23 00:54","TestDiskChecker.java","112041","40495","152536","","305072"
"2014-02-05 22:43","TestReplicationWorker.java","9255","75870","85125","7","170250"
"2013-05-31 12:02","TestReplicationWorker.java","7143","61684","68827","5","137654"
"2013-06-15 19:05","TestReplicationWorker.java","7221","65862","73083","5","146166"
"2012-12-18 12:00","TestReplicationWorker.java","3468","21889","25357","2","50714"
"2013-01-14 16:59","TestReplicationWorker.java","5396","27276","32672","2","65344"
"2016-04-27 09:00","TestReplicationWorker.java","69599","57226","126825","","253650"
"2012-12-08 11:18","TestReplicationWorker.java","2902","17261","20163","2","40326"
"2015-07-10 22:48","TestReplicationWorker.java","10599","95240","105839","","211678"
"2014-07-24 01:41","TestReplicationWorker.java","9824","82197","92021","","184042"
"2017-07-07 08:19","LedgerDirsManagerTest.java","113867","72333","186200","","372400"
"2017-01-30 23:25","LedgerDirsManagerTest.java","110988","42578","153566","","307132"
"2017-06-05 20:30","LedgerDirsManagerTest.java","113227","62853","176080","","352160"
"2014-12-10 19:43","LedgerDirsManagerTest.java","1949","11577","13526","","27052"
"2014-07-24 01:41","TestEntryLog.java","15364","129403","144767","","289534"
"2012-05-09 10:39","TestEntryLog.java","1877","5580","7457","1","14914"
"2014-12-10 19:43","TestEntryLog.java","15750","139417","155167","","310334"
"2016-02-24 00:44","TestEntryLog.java","16098","145652","161750","","323500"
"2014-03-12 21:26","TestEntryLog.java","15061","126345","141406","7","282812"
"2012-10-18 16:40","TestEntryLog.java","10814","55645","66459","2","132918"
"2013-10-12 05:42","TestEntryLog.java","14370","117382","131752","6","263504"
"2017-05-16 00:31","TestEntryLog.java","47002","107534","154536","","309072"
"2017-07-07 08:19","TestEntryLog.java","47696","120201","167897","","335794"
"2012-03-21 06:13","TestEntryLog.java","967","1450","2417","1","4834"
"2017-05-15 19:52","TestRackawareEnsemblePlacementPolicy.java","2924","24826","27750","","55500"
"2017-03-28 22:35","TestRackawareEnsemblePlacementPolicy.java","1240","19388","20628","","41256"
"2017-08-16 03:41","TestRackawareEnsemblePlacementPolicy.java","12047","69440","81487","","162974"
"2012-08-17 11:58","Version.java","3885","20531","24416","2","48832"
"2014-07-24 01:41","TestEntryLog.java","15250","128806","144056","","288112"
"2012-05-09 10:39","TestEntryLog.java","1026","4246","5272","1","10544"
"2014-12-10 19:43","TestEntryLog.java","15639","138823","154462","","308924"
"2016-02-24 00:44","TestEntryLog.java","16078","145149","161227","","322454"
"2014-03-12 21:26","TestEntryLog.java","14947","125748","140695","7","281390"
"2012-10-18 16:40","TestEntryLog.java","10016","54364","64380","2","128760"
"2013-10-12 05:42","TestEntryLog.java","14232","116761","130993","6","261986"
"2017-05-16 00:31","TestEntryLog.java","47111","107160","154271","","308542"
"2017-07-07 08:19","TestEntryLog.java","47846","119868","167714","","335428"
"2017-05-15 19:52","LedgerHandle.java","112504","45445","157949","","315898"
"2017-05-02 22:07","LedgerHandle.java","111528","42115","153643","","307286"
"2017-03-23 15:55","LedgerHandle.java","111180","36141","147321","","294642"
"2016-09-10 21:01","LedgerHandle.java","109258","16932","126190","","252380"
"2016-07-11 23:01","LedgerHandle.java","105764","9334","115098","","230196"
"2017-05-17 08:57","LedgerHandle.java","112687","46105","158792","","317584"
"2017-05-25 14:23","LedgerHandle.java","112722","47945","160667","","321334"
"2017-06-21 19:50","LedgerHandle.java","114006","52160","166166","","332332"
"2017-06-21 21:00","LedgerHandle.java","114020","52957","166977","","333954"
"2017-06-01 23:58","LedgerHandle.java","113572","49706","163278","","326556"
"2017-07-04 06:27","LedgerHandle.java","114533","57902","172435","","344870"
"2017-06-30 00:12","LedgerHandle.java","114348","55756","170104","","340208"
"2016-02-09 08:32","LedgerHandle.java","259","2110","2369","","4738"
"2016-03-16 05:03","LedgerHandle.java","105203","4315","109518","","219036"
"2015-10-22 09:22","LedgerHandle.java","33","849","882","","1764"
"2017-01-31 04:01","LedgerHandle.java","111026","35621","146647","","293294"
"2014-06-06 15:29","CompactionTest.java","4166","22419","26585","7","53170"
"2013-10-30 16:23","CompactionTest.java","2256","11836","14092","6","28184"
"2014-01-17 18:13","CompactionTest.java","2386","13190","15576","6","31152"
"2016-03-08 06:49","CompactionTest.java","6272","40400","46672","","93344"
"2015-01-16 15:57","CompactionTest.java","5247","34941","40188","","80376"
"2014-12-10 19:43","CompactionTest.java","5240","33129","38369","","76738"
"2015-04-21 09:55","CompactionTest.java","5302","35437","40739","","81478"
"2016-05-04 15:55","CompactionTest.java","109386","43423","152809","","305618"
"2017-03-22 22:54","CompactionTest.java","111092","67370","178462","","356924"
"2017-06-21 21:07","CompactionTest.java","112970","83667","196637","","393274"
"2014-01-22 14:35","CompactionTest.java","2909","15278","18187","6","36374"
"2017-11-08 12:27","CompactionTest.java","124608","125609","250217","","500434"
"2017-05-16 00:31","CompactionTest.java","111989","76743","188732","","377464"
"2014-01-15 15:58","CompactionTest.java","2351","12799","15150","6","30300"
"2013-10-22 07:44","CompactionTest.java","2071","9678","11749","6","23498"
"2017-07-07 08:19","CompactionTest.java","113238","89965","203203","","406406"
"2016-04-27 09:00","TestReplicationWorker.java","105793","8779","114572","","229144"
"2017-05-15 19:52","BookKeeperClusterTestCase.java","113296","49743","163039","","326078"
"2016-04-05 08:45","BookKeeperClusterTestCase.java","106286","11607","117893","","235786"
"2017-08-01 08:34","BookKeeperClusterTestCase.java","118519","81015","199534","","399068"
"2017-11-08 12:27","BookKeeperClusterTestCase.java","131976","105088","237064","","474128"
"2017-07-04 06:27","BookKeeperClusterTestCase.java","115264","62139","177403","","354806"
"2017-06-30 00:12","BookKeeperClusterTestCase.java","115097","60011","175108","","350216"
"2016-04-27 09:55","BookKeeperClusterTestCase.java","106384","12509","118893","","237786"
"2015-10-06 10:48","BookKeeperClusterTestCase.java","1225","4717","5942","","11884"
"2017-07-07 08:19","CreateNewLogTest.java","80784","97165","177949","","355898"
"2013-10-12 05:42","CreateNewLogTest.java","5829","52717","58546","6","117092"
"2017-01-30 23:25","CreateNewLogTest.java","79006","68511","147517","","295034"
"2017-06-01 23:58","ZkLedgerIdGenerator.java","2460","7143","9603","","19206"
"2014-07-24 01:41","ConcurrentLedgerTest.java","3366","14393","17759","","35518"
"2014-12-10 19:43","ConcurrentLedgerTest.java","4587","25242","29829","","59658"
"2014-02-05 22:43","ConcurrentLedgerTest.java","2368","7637","10005","7","20010"
"2017-05-16 00:31","ConcurrentLedgerTest.java","113176","70696","183872","","367744"
"2017-10-03 12:31","IndexPersistenceMgrTest.java","30487","36887","67374","","134748"
"2017-06-30 00:12","PerChannelBookieClient.java","415","3559","3974","","7948"
"2017-07-04 06:27","PerChannelBookieClient.java","754","5859","6613","","13226"
"2017-07-28 20:12","PerChannelBookieClient.java","2438","12137","14575","","29150"
"2017-08-02 00:49","PerChannelBookieClient.java","5992","29303","35295","","70590"
"2017-06-01 23:58","EntryLogger.java","114353","51898","166251","","332502"
"2017-11-08 12:27","EntryLogger.java","132804","103821","236625","","473250"
"2017-01-31 02:11","EntryLogger.java","111894","31819","143713","","287426"
"2017-03-23 00:48","EntryLogger.java","112029","38375","150404","","300808"
"2016-07-14 23:02","EntryLogger.java","106733","11748","118481","","236962"
"2016-02-24 00:44","EntryLogger.java","1420","5212","6632","","13264"
"2016-07-11 23:01","BookieWriteLedgerTest.java","64576","62315","126891","","253782"
"2014-02-05 22:43","BookieWriteLedgerTest.java","11259","86536","97795","7","195590"
"2013-04-26 18:38","BookieWriteLedgerTest.java","8969","71383","80352","5","160704"
"2014-07-24 01:41","BookieWriteLedgerTest.java","11795","92830","104625","","209250"
"2015-10-22 09:22","BookieWriteLedgerTest.java","12725","107710","120435","","240870"
"2017-06-30 00:12","PerChannelBookieClient.java","925","6199","7124","","14248"
"2017-07-04 06:27","PerChannelBookieClient.java","1257","8492","9749","","19498"
"2017-07-28 20:12","PerChannelBookieClient.java","2875","14704","17579","","35158"
"2017-08-02 00:49","PerChannelBookieClient.java","6431","31872","38303","","76606"
"2017-06-21 19:58","PerChannelBookieClient.java","536","2666","3202","","6404"
"2012-05-25 17:13","UpgradeTest.java","9680","19969","29649","1","59298"
"2014-12-10 19:43","UpgradeTest.java","20263","148976","169239","","338478"
"2012-09-07 07:26","UpgradeTest.java","13250","54394","67644","2","135288"
"2017-05-15 19:52","UpgradeTest.java","45779","110939","156718","","313436"
"2012-11-23 11:49","UpgradeTest.java","16443","74804","91247","2","182494"
"2013-10-11 08:36","UpgradeTest.java","19067","126584","145651","6","291302"
"2013-10-12 05:42","UpgradeTest.java","19129","127187","146316","6","292632"
"2012-03-13 07:31","UpgradeTest.java","1005","4607","5612","1","11224"
"2012-03-29 15:18","UpgradeTest.java","8388","14634","23022","1","46044"
"2016-07-14 23:02","Value.java","77574","55262","132836","","265672"
"2017-05-26 16:52","Value.java","79577","88938","168515","","337030"
"2013-02-08 19:08","Value.java","5193","46363","51556","4","103112"
"2017-07-04 06:27","FileInfo.java","1257","8492","9749","","19498"
"2017-07-17 23:27","FileInfo.java","1585","11927","13512","","27024"
"2016-03-08 06:49","LedgerDeleteTest.java","3369","19236","22605","","45210"
"2014-04-29 22:07","BookieJournalTest.java","2953","12276","15229","7","30458"
"2014-12-10 19:43","BookieJournalTest.java","4693","25889","30582","","61164"
"2017-05-15 19:52","BookieJournalTest.java","113128","70771","183899","","367798"
"2017-05-16 00:31","BookieJournalTest.java","113235","71296","184531","","369062"
"2013-10-12 05:42","BookieJournalTest.java","214","755","969","6","1938"
"2012-12-18 12:00","ZkLedgerUnderreplicationManager.java","3363","21366","24729","2","49458"
"2016-04-27 21:11","ZkLedgerUnderreplicationManager.java","69639","57347","126986","","253972"
"2016-07-14 23:02","ZkLedgerUnderreplicationManager.java","69824","58517","128341","","256682"
"2017-07-07 05:11","ZkLedgerUnderreplicationManager.java","72677","102815","175492","","350984"
"2013-08-22 16:40","ZkLedgerUnderreplicationManager.java","7282","67195","74477","5","148954"
"2017-06-28 23:28","ZkLedgerUnderreplicationManager.java","72524","97641","170165","","340330"
"2013-06-15 19:05","ZkLedgerUnderreplicationManager.java","7117","65340","72457","5","144914"
"2017-06-01 23:58","ZkLedgerUnderreplicationManager.java","72448","93671","166119","","332238"
"2014-08-18 23:03","ZkLedgerUnderreplicationManager.java","9916","89791","99707","","199414"
"2013-01-04 11:32","ZkLedgerUnderreplicationManager.java","4711","24725","29436","2","58872"
"2014-06-03 12:35","ZkLedgerUnderreplicationManager.java","9457","81395","90852","7","181704"
"2014-06-02 11:54","ZkLedgerUnderreplicationManager.java","9443","80913","90356","7","180712"
"2017-03-28 22:40","ZkLedgerUnderreplicationManager.java","71180","85899","157079","","314158"
"2012-10-16 17:01","ZkLedgerUnderreplicationManager.java","5","172","177","2","354"
"2016-04-27 09:55","ZkLedgerUnderreplicationManager.java","69639","57347","126986","","253972"
"2012-12-14 20:26","ZkLedgerUnderreplicationManager.java","3115","20611","23726","2","47452"
"2012-12-14 11:18","ZkLedgerUnderreplicationManager.java","3106","20490","23596","2","47192"
"2012-12-08 11:42","ZkLedgerUnderreplicationManager.java","2791","16732","19523","2","39046"
"2014-04-29 22:07","BookieJournalTest.java","2831","11613","14444","7","28888"
"2014-12-10 19:43","BookieJournalTest.java","4587","25242","29829","","59658"
"2017-05-15 19:52","BookieJournalTest.java","113068","70170","183238","","366476"
"2017-05-16 00:31","BookieJournalTest.java","113176","70696","183872","","367744"
"2012-12-18 12:00","ZkLedgerUnderreplicationManager.java","3359","21195","24554","2","49108"
"2016-04-27 21:11","ZkLedgerUnderreplicationManager.java","69653","57194","126847","","253694"
"2016-07-14 23:02","ZkLedgerUnderreplicationManager.java","69838","58364","128202","","256404"
"2017-07-07 05:11","ZkLedgerUnderreplicationManager.java","72693","102664","175357","","350714"
"2013-08-22 16:40","ZkLedgerUnderreplicationManager.java","7293","67039","74332","5","148664"
"2017-06-28 23:28","ZkLedgerUnderreplicationManager.java","72540","97490","170030","","340060"
"2013-06-15 19:05","ZkLedgerUnderreplicationManager.java","7128","65184","72312","5","144624"
"2017-06-01 23:58","ZkLedgerUnderreplicationManager.java","72462","93518","165980","","331960"
"2014-08-18 23:03","ZkLedgerUnderreplicationManager.java","9928","89636","99564","","199128"
"2013-01-04 11:32","ZkLedgerUnderreplicationManager.java","4708","24555","29263","2","58526"
"2014-06-03 12:35","ZkLedgerUnderreplicationManager.java","9469","81240","90709","7","181418"
"2014-06-02 11:54","ZkLedgerUnderreplicationManager.java","9455","80758","90213","7","180426"
"2017-03-28 22:40","ZkLedgerUnderreplicationManager.java","71194","85746","156940","","313880"
"2016-04-27 09:55","ZkLedgerUnderreplicationManager.java","69653","57194","126847","","253694"
"2012-12-14 20:26","ZkLedgerUnderreplicationManager.java","3111","20440","23551","2","47102"
"2012-12-14 11:18","ZkLedgerUnderreplicationManager.java","3102","20319","23421","2","46842"
"2012-12-08 11:42","ZkLedgerUnderreplicationManager.java","2787","16561","19348","2","38696"
"2014-01-15 15:58","GarbageCollectorThread.java","132","1000","1132","6","2264"
"2017-05-09 23:06","GarbageCollectorThread.java","112241","65533","177774","","355548"
"2014-01-21 17:26","GarbageCollectorThread.java","584","2997","3581","6","7162"
"2017-11-08 12:27","GarbageCollectorThread.java","126610","118031","244641","","489282"
"2017-03-28 22:39","GarbageCollectorThread.java","111782","63018","174800","","349600"
"2017-01-30 23:25","GarbageCollectorThread.java","111604","51875","163479","","326958"
"2016-05-04 15:55","GarbageCollectorThread.java","108622","33079","141701","","283402"
"2016-03-08 06:49","GarbageCollectorThread.java","5177","29725","34902","","69804"
"2016-02-24 00:44","GarbageCollectorThread.java","5094","29290","34384","","68768"
"2015-04-21 09:55","GarbageCollectorThread.java","4082","24637","28719","","57438"
"2016-07-14 23:02","BenchThroughputLatency.java","110113","46631","156744","","313488"
"2013-10-29 05:14","BenchThroughputLatency.java","3763","13419","17182","6","34364"
"2013-10-14 16:43","BenchThroughputLatency.java","3517","12304","15821","6","31642"
"2014-07-15 09:09","BenchThroughputLatency.java","5386","25190","30576","","61152"
"2016-07-14 23:02","ZkLedgerUnderreplicationManager.java","498","1483","1981","","3962"
"2017-07-07 05:11","ZkLedgerUnderreplicationManager.java","10295","52725","63020","","126040"
"2017-06-28 23:28","ZkLedgerUnderreplicationManager.java","9792","47201","56993","","113986"
"2017-06-01 23:58","ZkLedgerUnderreplicationManager.java","9221","42736","51957","","103914"
"2017-03-28 22:40","ZkLedgerUnderreplicationManager.java","6785","33796","40581","","81162"
"2014-07-24 01:41","ConcurrentLedgerTest.java","1183","6941","8124","","16248"
"2014-12-10 19:43","ConcurrentLedgerTest.java","2838","18224","21062","","42124"
"2017-05-16 00:31","ConcurrentLedgerTest.java","111999","64250","176249","","352498"
"2017-03-22 22:54","Cookie.java","79121","75152","154273","","308546"
"2016-11-30 00:02","Cookie.java","79012","62184","141196","","282392"
"2014-02-05 22:43","Cookie.java","7029","59285","66314","7","132628"
"2014-05-09 14:04","Cookie.java","7219","63629","70848","7","141696"
"2014-09-23 17:53","Cookie.java","7960","74518","82478","","164956"
"2014-09-18 06:57","Cookie.java","7942","74444","82386","","164772"
"2014-12-06 08:03","Cookie.java","8011","75488","83499","","166998"
"2013-02-08 19:08","Cookie.java","3007","41241","44248","4","88496"
"2013-07-04 14:01","JournalChannel.java","13535","110895","124430","5","248860"
"2013-10-12 05:42","JournalChannel.java","14349","114082","128431","6","256862"
"2013-07-20 19:59","JournalChannel.java","13560","111157","124717","5","249434"
"2012-12-18 13:04","JournalChannel.java","10585","67683","78268","2","156536"
"2014-04-29 22:07","JournalChannel.java","15150","123665","138815","7","277630"
"2014-03-07 13:30","JournalChannel.java","15105","121308","136413","7","272826"
"2014-01-21 05:19","PerChannelBookieClient.java","551","4114","4665","6","9330"
"2014-01-09 07:30","PerChannelBookieClient.java","150","2281","2431","6","4862"
"2017-06-30 00:12","PerChannelBookieClient.java","113986","78652","192638","","385276"
"2014-05-27 13:56","PerChannelBookieClient.java","2318","11399","13717","7","27434"
"2017-07-04 06:27","PerChannelBookieClient.java","114120","80747","194867","","389734"
"2017-01-31 04:01","PerChannelBookieClient.java","111616","59469","171085","","342170"
"2015-10-06 10:05","PerChannelBookieClient.java","4815","27833","32648","","65296"
"2016-04-05 18:47","PerChannelBookieClient.java","108500","33815","142315","","284630"
"2017-04-15 13:58","PerChannelBookieClient.java","111850","65395","177245","","354490"
"2017-05-15 19:52","PerChannelBookieClient.java","112611","68810","181421","","362842"
"2016-04-05 08:45","PerChannelBookieClient.java","108492","33565","142057","","284114"
"2017-07-28 20:12","PerChannelBookieClient.java","114959","86180","201139","","402278"
"2017-01-31 02:14","PerChannelBookieClient.java","111607","53991","165598","","331196"
"2017-03-28 22:35","PerChannelBookieClient.java","111704","64149","175853","","351706"
"2017-03-23 00:48","PerChannelBookieClient.java","111708","59901","171609","","343218"
"2014-07-25 00:34","PerChannelBookieClient.java","3085","19031","22116","","44232"
"2017-08-02 00:49","PerChannelBookieClient.java","117487","102320","219807","","439614"
"2017-06-21 19:58","PerChannelBookieClient.java","113789","75311","189100","","378200"
"2017-06-01 23:58","PerChannelBookieClient.java","113530","72922","186452","","372904"
"2014-02-21 19:01","PerChannelBookieClient.java","1893","7422","9315","7","18630"
"2014-02-05 22:43","PerChannelBookieClient.java","1712","6078","7790","7","15580"
"2017-04-20 19:55","PerChannelBookieClient.java","111854","65420","177274","","354548"
"2013-08-21 13:19","BookKeeperAdmin.java","13314","111308","124622","5","249244"
"2017-10-17 09:32","BookKeeperAdmin.java","51796","134566","186362","","372724"
"2017-06-01 23:58","BookKeeperAdmin.java","48943","108261","157204","","314408"
"2017-04-11 20:19","BookKeeperAdmin.java","47854","100687","148541","","297082"
"2014-02-21 19:01","BookKeeperAdmin.java","14849","120304","135153","7","270306"
"2014-02-05 22:43","BookKeeperAdmin.java","14782","119074","133856","7","267712"
"2017-07-07 05:11","BookKeeperAdmin.java","49071","117304","166375","","332750"
"2013-02-26 04:12","BookKeeperAdmin.java","12624","102922","115546","4","231092"
"2016-11-09 03:05","BookKeeperAdmin.java","47724","82267","129991","","259982"
"2016-11-30 00:07","BookKeeperAdmin.java","47728","82935","130663","","261326"
"2016-09-10 21:01","BookKeeperAdmin.java","47650","78508","126158","","252316"
"2016-07-14 23:02","BookKeeperAdmin.java","47645","74433","122078","","244156"
"2016-10-13 09:27","BookKeeperAdmin.java","47724","81933","129657","","259314"
"2012-11-30 04:54","BookKeeperAdmin.java","9745","61199","70944","2","141888"
"2012-07-18 17:00","BookKeeperAdmin.java","4693","17258","21951","2","43902"
"2013-02-08 19:08","BookKeeperAdmin.java","11785","102055","113840","4","227680"
"2016-03-16 05:03","BookKeeperAdmin.java","47544","69840","117384","","234768"
"2016-03-08 07:18","BookKeeperAdmin.java","16081","142663","158744","","317488"
"2014-12-06 08:03","BookKeeperAdmin.java","15433","134946","150379","","300758"
"2012-09-03 18:54","BookKeeperAdmin.java","6053","36661","42714","2","85428"
"2014-04-24 10:43","BookKeeperAdmin.java","14860","122287","137147","7","274294"
"2012-10-05 16:24","BookKeeperAdmin.java","8522","46199","54721","2","109442"
"2012-09-07 07:04","BookKeeperAdmin.java","6130","38204","44334","2","88668"
"2014-09-06 07:51","BookKeeperAdmin.java","15358","133734","149092","","298184"
"2012-08-19 11:39","BookKeeperAdmin.java","5831","30580","36411","2","72822"
"2013-05-10 12:45","BookKeeperAdmin.java","13088","105207","118295","5","236590"
"2012-08-24 22:44","BookKeeperAdmin.java","5833","31474","37307","2","74614"
"2013-01-14 16:59","BookieServer.java","17784","98931","116715","2","233430"
"2013-01-09 17:18","BookieServer.java","17697","97780","115477","2","230954"
"2013-02-12 11:16","BookieServer.java","18566","130299","148865","4","297730"
"2013-04-02 17:38","BookieServer.java","18738","131474","150212","5","300424"
"2017-08-16 03:37","BookieServer.java","41618","154600","196218","","392436"
"2017-08-02 00:49","BookieServer.java","41168","147517","188685","","377370"
"2011-11-15 19:42","BookieServer.java","2654","3617","6271","","12542"
"2011-11-18 11:18","BookieServer.java","3592","7221","10813","","21626"
"2012-02-15 16:11","BookieServer.java","4626","16644","21270","1","42540"
"2012-03-08 19:24","BookieServer.java","4913","18813","23726","1","47452"
"2013-07-03 17:39","BookieServer.java","18833","137058","155891","5","311782"
"2013-07-24 16:55","BookieServer.java","18845","137938","156783","5","313566"
"2014-02-05 22:43","BookieServer.java","19159","145041","164200","7","328400"
"2017-06-28 23:24","BookieServer.java","40532","124842","165374","","330748"
"2013-06-15 19:05","BookieServer.java","18831","136739","155570","5","311140"
"2017-06-01 23:58","BookieServer.java","40516","121424","161940","","323880"
"2017-10-17 09:32","BookieServer.java","41959","146319","188278","","376556"
"2014-08-02 20:02","BookieServer.java","19397","157489","176886","","353772"
"2012-05-09 09:43","BookieServer.java","12016","33265","45281","1","90562"
"2013-12-06 07:39","BookieServer.java","18984","142619","161603","6","323206"
"2012-07-23 23:39","BookieServer.java","13991","48214","62205","2","124410"
"2012-07-09 04:09","BookieServer.java","12832","44146","56978","2","113956"
"2012-10-18 16:40","BookieServer.java","16852","79284","96136","2","192272"
"2011-11-17 11:16","BookieServer.java","2969","5310","8279","","16558"
"2012-02-01 12:58","BookieServer.java","4431","14239","18670","1","37340"
"2014-01-21 05:05","BookieServer.java","18987","143720","162707","6","325414"
"2017-03-23 00:48","ClientConfiguration.java","79519","73678","153197","","306394"
"2016-04-05 08:45","ClientConfiguration.java","77987","49026","127013","","254026"
"2017-03-28 22:35","ClientConfiguration.java","79513","77924","157437","","314874"
"2017-01-31 02:14","ClientConfiguration.java","79429","67779","147208","","294416"
"2017-04-15 13:58","ClientConfiguration.java","79633","79144","158777","","317554"
"2017-03-23 00:59","ClientConfiguration.java","79520","73691","153211","","306422"
"2017-05-15 19:52","ClientConfiguration.java","80125","82290","162415","","324830"
"2016-10-13 07:50","ClientConfiguration.java","79281","59544","138825","","277650"
"2017-06-21 19:58","ClientConfiguration.java","81055","88543","169598","","339196"
"2013-10-29 05:14","ClientConfiguration.java","6040","52006","58046","6","116092"
"2017-06-05 21:48","ClientConfiguration.java","80999","87099","168098","","336196"
"2017-06-21 19:50","ClientConfiguration.java","81053","88431","169484","","338968"
"2017-08-02 00:49","ClientConfiguration.java","84293","115092","199385","","398770"
"2017-08-01 08:34","ClientConfiguration.java","83791","112005","195796","","391592"
"2013-06-12 18:41","ClientConfiguration.java","4604","46535","51139","5","102278"
"2014-05-27 13:56","ClientConfiguration.java","7313","62360","69673","7","139346"
"2017-06-30 00:12","ClientConfiguration.java","81190","91822","173012","","346024"
"2014-09-18 06:47","ClientConfiguration.java","7960","72511","80471","","160942"
"2017-07-04 06:27","ClientConfiguration.java","81282","93875","175157","","350314"
"2017-01-31 04:01","ClientConfiguration.java","79442","73261","152703","","305406"
"2015-10-06 10:05","ClientConfiguration.java","8945","77929","86874","","173748"
"2015-10-06 10:48","ClientConfiguration.java","8948","78158","87106","","174212"
"2013-02-08 19:08","ClientConfiguration.java","2871","39181","42052","4","84104"
"2016-02-09 08:32","ClientConfiguration.java","9072","80147","89219","","178438"
"2014-12-06 07:54","ClientConfiguration.java","8070","73539","81609","","163218"
"2016-08-01 08:04","ClientConfiguration.java","78244","51737","129981","","259962"
"2017-05-15 19:52","TestRackawareEnsemblePlacementPolicy.java","113491","73103","186594","","373188"
"2017-03-28 22:35","TestRackawareEnsemblePlacementPolicy.java","112694","68552","181246","","362492"
"2017-08-16 03:41","TestRackawareEnsemblePlacementPolicy.java","119510","114613","234123","","468246"
"2016-10-13 07:50","TestRackawareEnsemblePlacementPolicy.java","112436","50146","162582","","325164"
"2014-02-05 22:43","TestRackawareEnsemblePlacementPolicy.java","3436","11215","14651","7","29302"
"2012-12-18 12:00","ZkLedgerUnderreplicationManager.java","256","763","1019","2","2038"
"2016-04-27 21:11","ZkLedgerUnderreplicationManager.java","78924","49136","128060","","256120"
"2016-07-14 23:02","ZkLedgerUnderreplicationManager.java","79113","50310","129423","","258846"
"2017-07-07 05:11","ZkLedgerUnderreplicationManager.java","82301","94943","177244","","354488"
"2013-08-22 16:40","ZkLedgerUnderreplicationManager.java","4815","47232","52047","5","104094"
"2017-06-28 23:28","ZkLedgerUnderreplicationManager.java","82118","89739","171857","","343714"
"2013-06-15 19:05","ZkLedgerUnderreplicationManager.java","4600","45327","49927","5","99854"
"2017-06-01 23:58","ZkLedgerUnderreplicationManager.java","81969","85696","167665","","335330"
"2014-08-18 23:03","ZkLedgerUnderreplicationManager.java","7882","70261","78143","","156286"
"2013-01-04 11:32","ZkLedgerUnderreplicationManager.java","1906","4424","6330","2","12660"
"2014-06-03 12:35","ZkLedgerUnderreplicationManager.java","7381","61823","69204","7","138408"
"2014-06-02 11:54","ZkLedgerUnderreplicationManager.java","7361","61335","68696","7","137392"
"2017-03-28 22:40","ZkLedgerUnderreplicationManager.java","80617","77840","158457","","316914"
"2016-04-27 09:55","ZkLedgerUnderreplicationManager.java","78924","49136","128060","","256120"
"2017-05-15 19:52","LedgerHandle.java","113674","50644","164318","","328636"
"2017-05-02 22:07","LedgerHandle.java","112748","47364","160112","","320224"
"2017-03-23 15:55","LedgerHandle.java","112428","41418","153846","","307692"
"2016-09-10 21:01","LedgerHandle.java","110553","22256","132809","","265618"
"2016-07-11 23:01","LedgerHandle.java","107060","14659","121719","","243438"
"2017-05-17 08:57","LedgerHandle.java","113851","51298","165149","","330298"
"2017-05-25 14:23","LedgerHandle.java","113886","53138","167024","","334048"
"2017-06-21 19:50","LedgerHandle.java","115127","57310","172437","","344874"
"2017-06-21 21:00","LedgerHandle.java","115141","58107","173248","","346496"
"2017-06-01 23:58","LedgerHandle.java","114707","54870","169577","","339154"
"2014-12-09 19:57","LedgerHandle.java","64","513","577","","1154"
"2017-07-04 06:27","LedgerHandle.java","115622","63020","178642","","357284"
"2017-06-30 00:12","LedgerHandle.java","115457","60894","176351","","352702"
"2016-02-09 08:32","LedgerHandle.java","1824","7704","9528","","19056"
"2016-03-16 05:03","LedgerHandle.java","106604","9745","116349","","232698"
"2015-10-22 09:22","LedgerHandle.java","1667","6512","8179","","16358"
"2015-10-06 10:05","LedgerHandle.java","1630","5419","7049","","14098"
"2017-01-31 04:01","LedgerHandle.java","112285","40909","153194","","306388"
"2015-04-21 09:39","LedgerHandle.java","592","3210","3802","","7604"
"2015-10-06 11:12","LedgerHandle.java","1636","5665","7301","","14602"
"2017-05-04 20:58","AbstractZkLedgerManager.java","112183","64251","176434","","352868"
"2017-06-01 23:58","AbstractZkLedgerManager.java","113501","70226","183727","","367454"
"2017-06-12 17:20","AbstractZkLedgerManager.java","113712","72214","185926","","371852"
"2017-03-28 22:40","AbstractZkLedgerManager.java","111746","61967","173713","","347426"
"2016-02-09 08:23","AbstractZkLedgerManager.java","4860","27132","31992","","63984"
"2015-09-15 10:38","AbstractZkLedgerManager.java","4673","24700","29373","","58746"
"2016-02-23 19:16","AbstractZkLedgerManager.java","4893","27503","32396","","64792"
"2014-05-12 08:10","AbstractZkLedgerManager.java","2009","8180","10189","7","20378"
"2014-05-09 14:04","CookieTest.java","15252","125361","140613","7","281226"
"2013-10-12 05:42","CookieTest.java","14460","115146","129606","6","259212"
"2016-11-30 00:02","CookieTest.java","47474","84345","131819","","263638"
"2012-11-23 11:49","CookieTest.java","10330","61319","71649","2","143298"
"2014-12-10 19:43","CookieTest.java","15926","137267","153193","","306386"
"2012-09-07 07:04","CookieTest.java","6890","40627","47517","2","95034"
"2014-09-23 17:53","CookieTest.java","15740","135997","151737","","303474"
"2014-09-18 06:57","CookieTest.java","15723","135924","151647","","303294"
"2012-12-18 12:00","ZkLedgerUnderreplicationManager.java","265","884","1149","2","2298"
"2016-04-27 21:11","ZkLedgerUnderreplicationManager.java","78914","49238","128152","","256304"
"2016-07-14 23:02","ZkLedgerUnderreplicationManager.java","79103","50412","129515","","259030"
"2017-07-07 05:11","ZkLedgerUnderreplicationManager.java","82287","95041","177328","","354656"
"2013-08-22 16:40","ZkLedgerUnderreplicationManager.java","4822","47351","52173","5","104346"
"2017-06-28 23:28","ZkLedgerUnderreplicationManager.java","82104","89837","171941","","343882"
"2013-06-15 19:05","ZkLedgerUnderreplicationManager.java","4607","45446","50053","5","100106"
"2017-06-01 23:58","ZkLedgerUnderreplicationManager.java","81955","85794","167749","","335498"
"2014-08-18 23:03","ZkLedgerUnderreplicationManager.java","7878","70369","78247","","156494"
"2013-01-04 11:32","ZkLedgerUnderreplicationManager.java","1915","4545","6460","2","12920"
"2014-06-03 12:35","ZkLedgerUnderreplicationManager.java","7377","61931","69308","7","138616"
"2014-06-02 11:54","ZkLedgerUnderreplicationManager.java","7362","61448","68810","7","137620"
"2017-03-28 22:40","ZkLedgerUnderreplicationManager.java","80607","77942","158549","","317098"
"2016-04-27 09:55","ZkLedgerUnderreplicationManager.java","78914","49238","128152","","256304"
"2017-08-16 03:37","BookieServer.java","119279","107528","226807","","453614"
"2017-08-02 00:49","BookieServer.java","117723","99339","217062","","434124"
"2014-02-05 22:43","BookieServer.java","1266","2415","3681","7","7362"
"2017-06-28 23:24","BookieServer.java","113933","73510","187443","","374886"
"2017-06-01 23:58","BookieServer.java","113635","69810","183445","","366890"
"2017-10-17 09:32","BookieServer.java","125729","105356","231085","","462170"
"2014-08-02 20:02","BookieServer.java","2950","16309","19259","","38518"
"2017-06-01 23:58","EntryLogger.java","49121","108725","157846","","315692"
"2014-01-21 17:26","EntryLogger.java","14668","118736","133404","6","266808"
"2013-10-02 06:23","EntryLogger.java","13630","112016","125646","5","251292"
"2014-01-22 14:35","EntryLogger.java","14763","119207","133970","6","267940"
"2017-11-08 12:27","EntryLogger.java","52342","145418","197760","","395520"
"2013-10-22 07:44","EntryLogger.java","14441","114123","128564","6","257128"
"2012-06-13 16:57","EntryLogger.java","1011","4181","5192","","10384"
"2013-05-04 14:22","EntryLogger.java","13341","105416","118757","5","237514"
"2017-01-31 02:11","EntryLogger.java","47924","89908","137832","","275664"
"2017-03-23 00:48","EntryLogger.java","47973","96378","144351","","288702"
"2016-07-14 23:02","EntryLogger.java","47820","74894","122714","","245428"
"2012-12-24 06:23","EntryLogger.java","10991","67995","78986","2","157972"
"2012-12-10 11:04","EntryLogger.java","10279","62700","72979","2","145958"
"2016-02-24 00:44","EntryLogger.java","16321","142172","158493","","316986"
"2015-04-21 10:02","EntryLogger.java","15886","138129","154015","","308030"
"2012-10-18 16:40","EntryLogger.java","9511","50639","60150","2","120300"
"2012-07-26 04:32","EntryLogger.java","5101","18031","23132","2","46264"
"2013-01-04 11:32","EntryLogger.java","11475","69870","81345","2","162690"
"2015-04-21 09:44","EntryLogger.java","15884","137943","153827","","307654"
"2012-05-10 14:47","EntryLogger.java","393","679","1072","1","2144"
"2012-05-17 19:07","EntryLogger.java","768","2109","2877","1","5754"
"2012-05-25 17:13","UpgradeTest.java","1654","5697","7351","1","14702"
"2014-12-10 19:43","UpgradeTest.java","15580","138047","153627","","307254"
"2012-09-07 07:26","UpgradeTest.java","6949","41847","48796","2","97592"
"2017-05-15 19:52","UpgradeTest.java","47623","106537","154160","","308320"
"2012-11-23 11:49","UpgradeTest.java","10379","62494","72873","2","145746"
"2013-10-11 08:36","UpgradeTest.java","14075","115346","129421","6","258842"
"2013-10-12 05:42","UpgradeTest.java","14164","115976","130140","6","260280"
"2012-12-24 05:50","LedgerManagerFactory.java","17146","88859","106005","2","212010"
"2017-06-01 23:58","LedgerManagerFactory.java","42667","117202","159869","","319738"
"2012-08-14 11:40","LedgerManagerFactory.java","13138","48608","61746","2","123492"
"2012-06-19 12:39","LedgerManagerFactory.java","10996","29863","40859","2","81718"
"2012-09-07 07:04","LedgerManagerFactory.java","13543","60834","74377","2","148754"
"2015-09-15 10:38","LedgerManagerFactory.java","20183","158020","178203","","356406"
"2017-05-15 19:52","LedgerHandle.java","40724","116098","156822","","313644"
"2017-05-02 22:07","LedgerHandle.java","40568","113588","154156","","308312"
"2017-03-23 15:55","LedgerHandle.java","40568","107962","148530","","297060"
"2012-12-28 12:32","LedgerHandle.java","16688","92455","109143","2","218286"
"2016-09-10 21:01","LedgerHandle.java","40469","90576","131045","","262090"
"2016-07-11 23:01","LedgerHandle.java","40464","86467","126931","","253862"
"2012-02-13 15:46","LedgerHandle.java","2237","11902","14139","1","28278"
"2012-01-17 16:52","LedgerHandle.java","1850","7233","9083","1","18166"
"2012-02-01 16:19","LedgerHandle.java","1915","8391","10306","1","20612"
"2012-02-13 11:19","LedgerHandle.java","2111","11696","13807","1","27614"
"2012-03-31 10:58","LedgerHandle.java","10025","27323","37348","1","74696"
"2011-11-29 23:55","LedgerHandle.java","1526","5603","7129","","14258"
"2013-04-26 18:38","LedgerHandle.java","18019","128697","146716","5","293432"
"2013-10-14 18:32","LedgerHandle.java","18368","136733","155101","6","310202"
"2014-02-05 22:43","LedgerHandle.java","18772","142313","161085","7","322170"
"2014-02-21 19:01","LedgerHandle.java","18808","143512","162320","7","324640"
"2017-05-17 08:57","LedgerHandle.java","40756","116607","157363","","314726"
"2017-05-25 14:23","LedgerHandle.java","40783","118439","159222","","318444"
"2017-06-21 19:50","LedgerHandle.java","40875","121462","162337","","324674"
"2017-06-21 21:00","LedgerHandle.java","40878","122248","163126","","326252"
"2017-06-01 23:58","LedgerHandle.java","40847","119414","160261","","320522"
"2012-06-29 18:43","LedgerHandle.java","11375","39809","51184","2","102368"
"2012-05-25 17:13","LedgerHandle.java","10978","31481","42459","1","84918"
"2012-05-10 14:47","LedgerHandle.java","10664","29913","40577","1","81154"
"2012-09-12 11:59","LedgerHandle.java","13601","65449","79050","2","158100"
"2012-06-19 12:39","LedgerHandle.java","11183","34082","45265","2","90530"
"2014-01-21 05:19","LedgerHandle.java","18492","141230","159722","6","319444"
"2012-06-27 15:35","LedgerHandle.java","11364","39468","50832","2","101664"
"2014-09-18 06:47","LedgerHandle.java","19181","156941","176122","","352244"
"2014-12-09 19:57","LedgerHandle.java","19188","158041","177229","","354458"
"2017-07-04 06:27","LedgerHandle.java","40913","126715","167628","","335256"
"2017-06-30 00:12","LedgerHandle.java","40883","124724","165607","","331214"
"2014-05-30 14:01","LedgerHandle.java","18844","147482","166326","7","332652"
"2014-05-30 15:07","LedgerHandle.java","18845","147522","166367","7","332734"
"2014-01-17 18:13","LedgerHandle.java","18452","140294","158746","6","317492"
"2013-01-07 12:25","LedgerHandle.java","16809","94379","111188","2","222376"
"2012-08-28 10:51","LedgerHandle.java","13486","61750","75236","2","150472"
"2011-11-28 19:25","LedgerHandle.java","1137","5169","6306","","12612"
"2012-09-14 11:53","LedgerHandle.java","13661","65744","79405","2","158810"
"2016-02-09 08:32","LedgerHandle.java","19296","163580","182876","","365752"
"2016-03-16 05:03","LedgerHandle.java","40428","81973","122401","","244802"
"2015-10-22 09:22","LedgerHandle.java","19296","162545","181841","","363682"
"2015-10-06 10:05","LedgerHandle.java","19285","161478","180763","","361526"
"2017-01-31 04:01","LedgerHandle.java","40577","107605","148182","","296364"
"2015-04-21 09:39","LedgerHandle.java","19209","160231","179440","","358880"
"2015-10-06 11:12","LedgerHandle.java","19287","161720","181007","","362014"
"2014-12-05 14:10","LedgerHandle.java","19183","157587","176770","","353540"
"2017-06-21 19:58","PendingReadOp.java","113940","71899","185839","","371678"
"2017-06-05 21:48","PendingReadOp.java","113779","70350","184129","","368258"
"2017-06-05 22:13","PendingReadOp.java","113786","70770","184556","","369112"
"2017-06-01 11:42","PendingReadOp.java","112959","68821","181780","","363560"
"2017-06-01 22:39","PendingReadOp.java","113604","69048","182652","","365304"
"2014-02-05 22:43","PendingReadOp.java","1184","1987","3171","7","6342"
"2017-05-15 19:52","PendingReadOp.java","112723","65359","178082","","356164"
"2015-04-21 09:17","PendingReadOp.java","4052","22316","26368","","52736"
"2016-02-09 08:39","PendingReadOp.java","5001","26604","31605","","63210"
"2016-02-09 08:32","PendingReadOp.java","5001","26547","31548","","63096"
"2017-07-04 06:27","PendingReadOp.java","114273","77337","191610","","383220"
"2013-01-14 16:59","BookieServer.java","15009","101675","116684","2","233368"
"2013-01-09 17:18","BookieServer.java","14932","100534","115466","2","230932"
"2013-02-12 11:16","BookieServer.java","15774","133026","148800","4","297600"
"2013-04-02 17:38","BookieServer.java","15928","134183","150111","5","300222"
"2017-08-16 03:37","BookieServer.java","37337","155838","193175","","386350"
"2017-08-02 00:49","BookieServer.java","36893","148761","185654","","371308"
"2011-11-15 19:42","BookieServer.java","6990","13472","20462","","40924"
"2011-11-18 11:18","BookieServer.java","7819","16967","24786","","49572"
"2012-02-15 16:11","BookieServer.java","8734","26271","35005","1","70010"
"2012-03-08 19:24","BookieServer.java","8982","28401","37383","1","74766"
"2013-07-03 17:39","BookieServer.java","16030","139774","155804","5","311608"
"2013-07-24 16:55","BookieServer.java","16042","140654","156696","5","313392"
"2014-02-05 22:43","BookieServer.java","16331","147732","164063","7","328126"
"2017-06-28 23:24","BookieServer.java","36297","126126","162423","","324846"
"2013-06-15 19:05","BookieServer.java","16026","139453","155479","5","310958"
"2017-06-01 23:58","BookieServer.java","36292","122719","159011","","318022"
"2017-10-17 09:32","BookieServer.java","37636","147515","185151","","370302"
"2014-08-02 20:02","BookieServer.java","16563","160174","176737","","353474"
"2012-05-09 09:43","BookieServer.java","9856","36624","46480","1","92960"
"2013-12-06 07:39","BookieServer.java","16163","145317","161480","6","322960"
"2012-07-23 23:39","BookieServer.java","11567","51309","62876","2","125752"
"2012-07-09 04:09","BookieServer.java","10469","47302","57771","2","115542"
"2012-10-18 16:40","BookieServer.java","14203","82154","96357","2","192714"
"2011-11-17 11:16","BookieServer.java","7264","15124","22388","","44776"
"2012-02-01 12:58","BookieServer.java","8582","23909","32491","1","64982"
"2011-09-05 19:38","BookieServer.java","4889","10408","15297","","30594"
"2014-01-21 05:05","BookieServer.java","16166","146418","162584","6","325168"
"2017-10-17 09:32","AuditorElector.java","92364","117025","209389","","418778"
"2013-08-21 13:19","AuditorElector.java","3188","43073","46261","5","92522"
"2016-07-14 23:02","AuditorElector.java","78895","47574","126469","","252938"
"2016-09-10 21:01","AuditorElector.java","80088","52837","132925","","265850"
"2013-03-05 18:45","AuditorElector.java","1978","34172","36150","4","72300"
"2017-03-28 22:40","AuditorElector.java","80400","75105","155505","","311010"
"2014-06-02 11:54","AuditorElector.java","6022","57478","63500","7","127000"
"2014-04-24 10:43","AuditorElector.java","5811","55129","60940","7","121880"
"2014-09-06 07:58","AuditorElector.java","6589","66988","73577","","147154"
"2016-03-16 04:43","BookieSocketAddress.java","107518","25290","132808","","265616"
"2016-04-05 18:47","BookieSocketAddress.java","107556","28505","136061","","272122"
"2017-05-15 19:52","BookieSocketAddress.java","111874","63707","175581","","351162"
"2016-10-13 07:50","BookieSocketAddress.java","110618","40549","151167","","302334"
"2012-12-18 12:00","ZkLedgerUnderreplicationManager.java","627","4689","5316","2","10632"
"2016-04-27 21:11","ZkLedgerUnderreplicationManager.java","77648","51415","129063","","258126"
"2016-07-14 23:02","ZkLedgerUnderreplicationManager.java","77837","52589","130426","","260852"
"2017-07-07 05:11","ZkLedgerUnderreplicationManager.java","80807","97004","177811","","355622"
"2013-08-22 16:40","ZkLedgerUnderreplicationManager.java","4943","50915","55858","5","111716"
"2017-06-28 23:28","ZkLedgerUnderreplicationManager.java","80653","91829","172482","","344964"
"2013-06-15 19:05","ZkLedgerUnderreplicationManager.java","4731","49013","53744","5","107488"
"2017-06-01 23:58","ZkLedgerUnderreplicationManager.java","80519","87801","168320","","336640"
"2014-08-18 23:03","ZkLedgerUnderreplicationManager.java","7836","73770","81606","","163212"
"2013-01-04 11:32","ZkLedgerUnderreplicationManager.java","2092","8165","10257","2","20514"
"2014-06-03 12:35","ZkLedgerUnderreplicationManager.java","7343","65340","72683","7","145366"
"2014-06-02 11:54","ZkLedgerUnderreplicationManager.java","7329","64858","72187","7","144374"
"2017-03-28 22:40","ZkLedgerUnderreplicationManager.java","79195","79973","159168","","318336"
"2016-04-27 09:55","ZkLedgerUnderreplicationManager.java","77648","51415","129063","","258126"
"2012-12-14 20:26","ZkLedgerUnderreplicationManager.java","377","3932","4309","2","8618"
"2012-12-14 11:18","ZkLedgerUnderreplicationManager.java","367","3810","4177","2","8354"
"2014-06-02 11:54","AuditorLedgerCheckerTest.java","797","6070","6867","7","13734"
"2014-07-24 01:41","AuditorLedgerCheckerTest.java","1183","6941","8124","","16248"
"2016-03-08 07:18","AuditorLedgerCheckerTest.java","4206","26496","30702","","61404"
"2016-12-17 02:44","AuditorLedgerCheckerTest.java","110800","47454","158254","","316508"
"2017-07-07 05:11","AuditorLedgerCheckerTest.java","113496","77437","190933","","381866"
"2017-10-17 09:32","AuditorLedgerCheckerTest.java","125165","103643","228808","","457616"
"2017-05-12 15:20","AuditorLedgerCheckerTest.java","111484","62512","173996","","347992"
"2017-06-01 23:58","EntryLogger.java","48789","108817","157606","","315212"
"2014-01-21 17:26","EntryLogger.java","14659","119151","133810","6","267620"
"2013-10-02 06:23","EntryLogger.java","13624","112434","126058","5","252116"
"2014-01-22 14:35","EntryLogger.java","14754","119622","134376","6","268752"
"2017-11-08 12:27","EntryLogger.java","51976","145476","197452","","394904"
"2013-10-22 07:44","EntryLogger.java","14432","114538","128970","6","257940"
"2012-06-13 16:57","EntryLogger.java","1054","4648","5702","","11404"
"2013-05-04 14:22","EntryLogger.java","13338","105837","119175","5","238350"
"2017-01-31 02:11","EntryLogger.java","47593","90001","137594","","275188"
"2017-03-23 00:48","EntryLogger.java","47642","96471","144113","","288226"
"2016-07-14 23:02","EntryLogger.java","47489","74987","122476","","244952"
"2012-12-24 06:23","EntryLogger.java","11023","68451","79474","2","158948"
"2012-12-10 11:04","EntryLogger.java","10312","63157","73469","2","146938"
"2016-02-24 00:44","EntryLogger.java","16295","142570","158865","","317730"
"2015-04-21 10:02","EntryLogger.java","15868","138535","154403","","308806"
"2012-10-18 16:40","EntryLogger.java","9546","51098","60644","2","121288"
"2012-07-26 04:32","EntryLogger.java","5139","18493","23632","2","47264"
"2013-01-04 11:32","EntryLogger.java","11503","70322","81825","2","163650"
"2015-04-21 09:44","EntryLogger.java","15866","138349","154215","","308430"
"2012-05-09 10:39","EntryLogger.java","41","465","506","1","1012"
"2012-05-10 14:47","EntryLogger.java","434","1144","1578","1","3156"
"2012-05-17 19:07","EntryLogger.java","809","2574","3383","1","6766"
"2017-06-01 23:58","EntryLogger.java","48943","108261","157204","","314408"
"2014-01-21 17:26","EntryLogger.java","14396","118178","132574","6","265148"
"2013-10-02 06:23","EntryLogger.java","13355","111455","124810","5","249620"
"2014-01-22 14:35","EntryLogger.java","14501","118659","133160","6","266320"
"2017-11-08 12:27","EntryLogger.java","52203","144993","197196","","394392"
"2013-10-22 07:44","EntryLogger.java","14169","113565","127734","6","255468"
"2012-06-13 16:57","EntryLogger.java","662","3546","4208","","8416"
"2013-05-04 14:22","EntryLogger.java","13066","104855","117921","5","235842"
"2017-01-31 02:11","EntryLogger.java","47749","89447","137196","","274392"
"2017-03-23 00:48","EntryLogger.java","47799","95918","143717","","287434"
"2016-07-14 23:02","EntryLogger.java","47645","74433","122078","","244156"
"2012-12-24 06:23","EntryLogger.java","10673","67391","78064","2","156128"
"2012-12-10 11:04","EntryLogger.java","9953","62088","72041","2","144082"
"2016-02-24 00:44","EntryLogger.java","16067","141632","157699","","315398"
"2015-04-21 10:02","EntryLogger.java","15631","137588","153219","","306438"
"2012-10-18 16:40","EntryLogger.java","9185","50027","59212","2","118424"
"2012-07-26 04:32","EntryLogger.java","4754","17398","22152","2","44304"
"2013-01-04 11:32","EntryLogger.java","11165","69274","80439","2","160878"
"2015-04-21 09:44","EntryLogger.java","15629","137402","153031","","306062"
"2012-05-17 19:07","EntryLogger.java","416","1471","1887","1","3774"
"2017-06-01 23:58","LedgerManagerFactory.java","113588","50286","163874","","327748"
"2016-12-21 01:48","EntryMemTable.java","111396","45316","156712","","313424"
"2014-08-02 20:02","EntryMemTable.java","1466","10673","12139","","24278"
"2014-01-21 05:19","PerChannelBookieClient.java","2340","9202","11542","6","23084"
"2013-10-22 07:35","PerChannelBookieClient.java","1591","4099","5690","6","11380"
"2014-01-09 07:30","PerChannelBookieClient.java","1951","7381","9332","6","18664"
"2017-06-30 00:12","PerChannelBookieClient.java","114779","82744","197523","","395046"
"2014-05-27 13:56","PerChannelBookieClient.java","3888","16268","20156","7","40312"
"2017-07-04 06:27","PerChannelBookieClient.java","114888","84814","199702","","399404"
"2017-01-31 04:01","PerChannelBookieClient.java","112606","63758","176364","","352728"
"2015-10-06 10:05","PerChannelBookieClient.java","6202","32519","38721","","77442"
"2016-04-05 18:47","PerChannelBookieClient.java","109549","38163","147712","","295424"
"2017-04-15 13:58","PerChannelBookieClient.java","112802","69646","182448","","364896"
"2017-05-15 19:52","PerChannelBookieClient.java","113510","73008","186518","","373036"
"2016-04-05 08:45","PerChannelBookieClient.java","109547","37919","147466","","294932"
"2017-07-28 20:12","PerChannelBookieClient.java","115560","90080","205640","","411280"
"2017-01-31 02:14","PerChannelBookieClient.java","112599","58282","170881","","341762"
"2017-03-28 22:35","PerChannelBookieClient.java","112688","68432","181120","","362240"
"2017-03-23 00:48","PerChannelBookieClient.java","112693","64185","176878","","353756"
"2014-07-25 00:34","PerChannelBookieClient.java","4603","23848","28451","","56902"
"2017-08-02 00:49","PerChannelBookieClient.java","118001","106133","224134","","448268"
"2017-06-21 19:58","PerChannelBookieClient.java","114595","79416","194011","","388022"
"2017-06-01 23:58","PerChannelBookieClient.java","114388","77079","191467","","382934"
"2013-10-29 05:14","PerChannelBookieClient.java","1893","5192","7085","6","14170"
"2014-02-21 19:01","PerChannelBookieClient.java","3598","12426","16024","7","32048"
"2014-02-05 22:43","PerChannelBookieClient.java","3424","11089","14513","7","29026"
"2017-04-20 19:55","PerChannelBookieClient.java","112804","69669","182473","","364946"
"2013-09-11 00:34","PerChannelBookieClient.java","414","1876","2290","5","4580"
"2013-08-20 12:51","PerChannelBookieClient.java","250","1425","1675","5","3350"
"2017-05-16 00:31","InterleavedLedgerStorage.java","2479","11243","13722","","27444"
"2017-07-04 06:27","InterleavedLedgerStorage.java","4684","23458","28142","","56284"
"2017-03-28 22:37","InterleavedLedgerStorage.java","375","5182","5557","","11114"
"2014-06-02 11:54","AuditorLedgerCheckerTest.java","3800","15371","19171","7","38342"
"2014-07-24 01:41","AuditorLedgerCheckerTest.java","4139","16195","20334","","40668"
"2016-03-08 07:18","AuditorLedgerCheckerTest.java","6344","34932","41276","","82552"
"2016-12-17 02:44","AuditorLedgerCheckerTest.java","112654","55606","168260","","336520"
"2017-07-07 05:11","AuditorLedgerCheckerTest.java","114996","85235","200231","","400462"
"2014-02-05 22:43","AuditorLedgerCheckerTest.java","3185","9483","12668","7","25336"
"2017-10-17 09:32","AuditorLedgerCheckerTest.java","125918","110694","236612","","473224"
"2017-05-12 15:20","AuditorLedgerCheckerTest.java","113286","70612","183898","","367796"
"2017-07-07 08:19","DiskChecker.java","1234","10074","11308","","22616"
"2017-06-01 23:58","TGTRefreshThread.java","1148","2055","3203","","6406"
"2017-07-07 08:19","LedgerDirsMonitor.java","1234","10074","11308","","22616"
"2017-07-04 06:27","FileInfo.java","2419","12429","14848","","29696"
"2017-06-01 23:58","FileInfo.java","1160","3935","5095","","10190"
"2017-07-17 23:27","FileInfo.java","2727","15844","18571","","37142"
"2017-06-30 00:12","PerChannelBookieClient.java","113438","72575","186013","","372026"
"2014-05-27 13:56","PerChannelBookieClient.java","516","4068","4584","7","9168"
"2017-07-04 06:27","PerChannelBookieClient.java","113576","74674","188250","","376500"
"2017-01-31 04:01","PerChannelBookieClient.java","110821","53145","163966","","327932"
"2015-10-06 10:05","PerChannelBookieClient.java","3721","21210","24931","","49862"
"2016-04-05 18:47","PerChannelBookieClient.java","107536","27322","134858","","269716"
"2017-04-15 13:58","PerChannelBookieClient.java","111119","59135","170254","","340508"
"2017-05-15 19:52","PerChannelBookieClient.java","111919","62589","174508","","349016"
"2016-04-05 08:45","PerChannelBookieClient.java","107526","27070","134596","","269192"
"2017-07-28 20:12","PerChannelBookieClient.java","114568","80260","194828","","389656"
"2017-01-31 02:14","PerChannelBookieClient.java","110815","47670","158485","","316970"
"2017-03-28 22:35","PerChannelBookieClient.java","110925","57841","168766","","337532"
"2017-03-23 00:48","PerChannelBookieClient.java","110918","53582","164500","","329000"
"2014-07-25 00:34","PerChannelBookieClient.java","1566","11983","13549","","27098"
"2017-08-02 00:49","PerChannelBookieClient.java","117144","96448","213592","","427184"
"2017-06-21 19:58","PerChannelBookieClient.java","113164","69157","182321","","364642"
"2017-06-01 23:58","PerChannelBookieClient.java","112883","66746","179629","","359258"
"2017-04-20 19:55","PerChannelBookieClient.java","111123","59160","170283","","340566"
"2017-07-07 05:11","AuditorLedgerCheckerTest.java","3720","16633","20353","","40706"
"2017-10-17 09:32","AuditorLedgerCheckerTest.java","35223","62673","97896","","195792"
"2017-05-15 19:52","TestRackawareEnsemblePlacementPolicy.java","111874","63707","175581","","351162"
"2017-03-28 22:35","TestRackawareEnsemblePlacementPolicy.java","110928","59007","169935","","339870"
"2017-08-16 03:41","TestRackawareEnsemblePlacementPolicy.java","118642","105966","224608","","449216"
"2016-10-13 07:50","TestRackawareEnsemblePlacementPolicy.java","110618","40549","151167","","302334"
"2017-07-04 06:27","FileInfo.java","114075","80838","194913","","389826"
"2014-12-04 12:28","FileInfo.java","3615","22971","26586","","53172"
"2017-01-31 04:01","FileInfo.java","111574","59563","171137","","342274"
"2017-03-23 15:55","FileInfo.java","111673","60028","171701","","343402"
"2016-11-18 00:18","FileInfo.java","111510","46398","157908","","315816"
"2017-06-01 23:58","FileInfo.java","113485","73013","186498","","372996"
"2017-07-17 23:27","FileInfo.java","114207","84077","198284","","396568"
"2017-05-16 00:31","FileInfo.java","112683","69436","182119","","364238"
"2012-12-18 12:00","TestLedgerUnderreplicationManager.java","627","4689","5316","2","10632"
"2013-05-31 12:02","TestLedgerUnderreplicationManager.java","4631","44813","49444","5","98888"
"2013-10-12 05:42","TestLedgerUnderreplicationManager.java","5877","52864","58741","6","117482"
"2015-07-10 22:48","TestLedgerUnderreplicationManager.java","8490","78772","87262","","174524"
"2017-06-30 00:12","PendingAddOp.java","2341","10808","13149","","26298"
"2017-08-02 00:49","PendingAddOp.java","7739","36373","44112","","88224"
"2017-07-28 20:12","AsyncCallback.java","1802","6396","8198","","16396"
"2017-07-04 06:27","FileInfo.java","114576","82647","197223","","394446"
"2014-12-04 12:28","FileInfo.java","4338","25002","29340","","58680"
"2017-01-31 04:01","FileInfo.java","112168","61465","173633","","347266"
"2017-03-23 15:55","FileInfo.java","112266","61929","174195","","348390"
"2016-11-18 00:18","FileInfo.java","112105","48301","160406","","320812"
"2017-06-01 23:58","FileInfo.java","114026","74862","188888","","377776"
"2017-07-17 23:27","FileInfo.java","114677","85855","200532","","401064"
"2017-05-16 00:31","FileInfo.java","113235","71296","184531","","369062"
"2013-10-22 16:21","FileInfo.java","878","2186","3064","6","6128"
"2017-06-01 23:58","EntryLogger.java","49304","107567","156871","","313742"
"2014-01-21 17:26","EntryLogger.java","14107","116834","130941","6","261882"
"2013-10-02 06:23","EntryLogger.java","13066","110111","123177","5","246354"
"2014-01-22 14:35","EntryLogger.java","14212","117315","131527","6","263054"
"2017-11-08 12:27","EntryLogger.java","52892","144627","197519","","395038"
"2013-10-22 07:44","EntryLogger.java","13880","112221","126101","6","252202"
"2012-06-13 16:57","EntryLogger.java","247","2076","2323","","4646"
"2013-05-04 14:22","EntryLogger.java","12776","103510","116286","5","232572"
"2017-01-31 02:11","EntryLogger.java","48110","88753","136863","","273726"
"2017-03-23 00:48","EntryLogger.java","48160","95224","143384","","286768"
"2016-07-14 23:02","EntryLogger.java","48006","73739","121745","","243490"
"2012-12-24 06:23","EntryLogger.java","10372","66035","76407","2","152814"
"2012-12-10 11:04","EntryLogger.java","9650","60730","70380","2","140760"
"2016-02-24 00:44","EntryLogger.java","15784","140294","156078","","312156"
"2015-04-21 10:02","EntryLogger.java","15348","136250","151598","","303196"
"2012-10-18 16:40","EntryLogger.java","8874","48661","57535","2","115070"
"2012-07-26 04:32","EntryLogger.java","4348","15937","20285","2","40570"
"2013-01-04 11:32","EntryLogger.java","10861","67915","78776","2","157552"
"2015-04-21 09:44","EntryLogger.java","15346","136064","151410","","302820"
"2017-06-01 23:58","ReadEntryProcessor.java","1160","3935","5095","","10190"
"2017-05-16 00:31","TestPerChannelBookieClient.java","263","681","944","","1888"
"2016-12-21 01:48","SortedLedgerStorage.java","111875","31133","143008","","286016"
"2017-05-12 16:39","SortedLedgerStorage.java","112773","46131","158904","","317808"
"2017-05-16 00:31","SortedLedgerStorage.java","113463","48049","161512","","323024"
"2016-03-08 06:49","SortedLedgerStorage.java","1542","5502","7044","","14088"
"2017-06-30 00:12","BookieRecoveryTest.java","114888","81762","196650","","393300"
"2014-07-24 01:41","BookieRecoveryTest.java","4166","16498","20664","","41328"
"2017-04-11 20:15","BookieRecoveryTest.java","112882","67995","180877","","361754"
"2017-05-15 19:52","BookieRecoveryTest.java","113605","72012","185617","","371234"
"2014-02-05 22:43","BookieRecoveryTest.java","3224","9798","13022","7","26044"
"2015-07-10 22:48","ZooKeeperUtil.java","20861","148612","169473","","338946"
"2014-08-18 23:00","ZooKeeperUtil.java","20548","143959","164507","","329014"
"2012-04-28 11:11","ZooKeeperUtil.java","8531","13171","21702","1","43404"
"2012-06-05 08:00","ZooKeeperUtil.java","9460","16562","26022","1","52044"
"2014-12-10 19:43","ZooKeeperUtil.java","20772","145883","166655","","333310"
"2013-03-25 06:27","ZooKeeperUtil.java","18903","115059","133962","4","267924"
"2016-04-05 21:52","ZooKeeperUtil.java","45925","76602","122527","","245054"
"2012-11-21 12:24","ZooKeeperUtil.java","16282","70818","87100","2","174200"
"2017-06-30 00:12","PerChannelBookieClient.java","113338","73638","186976","","373952"
"2014-05-27 13:56","PerChannelBookieClient.java","695","5410","6105","7","12210"
"2017-07-04 06:27","PerChannelBookieClient.java","113475","75736","189211","","378422"
"2017-01-31 04:01","PerChannelBookieClient.java","110826","54313","165139","","330278"
"2015-10-06 10:05","PerChannelBookieClient.java","3740","22392","26132","","52264"
"2016-04-05 18:47","PerChannelBookieClient.java","107556","28505","136061","","272122"
"2017-04-15 13:58","PerChannelBookieClient.java","111080","60259","171339","","342678"
"2017-05-15 19:52","PerChannelBookieClient.java","111874","63707","175581","","351162"
"2016-04-05 08:45","PerChannelBookieClient.java","107546","28253","135799","","271598"
"2017-07-28 20:12","PerChannelBookieClient.java","114467","81322","195789","","391578"
"2017-01-31 02:14","PerChannelBookieClient.java","110820","48838","159658","","319316"
"2017-03-28 22:35","PerChannelBookieClient.java","110928","59007","169935","","339870"
"2017-03-23 00:48","PerChannelBookieClient.java","110923","54750","165673","","331346"
"2014-07-25 00:34","PerChannelBookieClient.java","1736","13316","15052","","30104"
"2017-08-02 00:49","PerChannelBookieClient.java","117040","97507","214547","","429094"
"2017-06-21 19:58","PerChannelBookieClient.java","113106","70262","183368","","366736"
"2017-06-01 23:58","PerChannelBookieClient.java","112825","67851","180676","","361352"
"2014-02-21 19:01","PerChannelBookieClient.java","201","1364","1565","7","3130"
"2017-04-20 19:55","PerChannelBookieClient.java","111084","60284","171368","","342736"
"2016-03-16 04:51","AutoRecoveryMain.java","108444","28492","136936","","273872"
"2014-03-10 03:14","AutoRecoveryMain.java","1933","6067","8000","7","16000"
"2014-04-24 10:43","AutoRecoveryMain.java","2010","7392","9402","7","18804"
"2014-09-06 07:58","AutoRecoveryMain.java","3460","19923","23383","","46766"
"2016-11-18 00:18","InterleavedLedgerStorage.java","110603","19364","129967","","259934"
"2017-05-16 00:31","InterleavedLedgerStorage.java","112289","42915","155204","","310408"
"2017-07-04 06:27","InterleavedLedgerStorage.java","114212","54848","169060","","338120"
"2017-01-31 04:01","InterleavedLedgerStorage.java","110707","32569","143276","","286552"
"2017-03-28 22:37","InterleavedLedgerStorage.java","110849","37518","148367","","296734"
"2012-05-09 13:20","BenchReadThroughputLatency.java","9134","15399","24533","1","49066"
"2013-02-08 19:08","BenchReadThroughputLatency.java","18130","114732","132862","4","265724"
"2016-02-09 08:12","BenchReadThroughputLatency.java","21100","152294","173394","","346788"
"2016-07-14 23:02","BenchReadThroughputLatency.java","45986","79106","125092","","250184"
"2013-10-29 05:14","BenchReadThroughputLatency.java","19717","125975","145692","6","291384"
"2013-10-14 16:43","BenchReadThroughputLatency.java","19589","124978","144567","6","289134"
"2017-05-16 00:31","InterleavedLedgerStorage.java","2203","6160","8363","","16726"
"2017-07-04 06:27","InterleavedLedgerStorage.java","4475","18442","22917","","45834"
"2017-10-03 12:31","BookKeeperServerStats.java","24086","7386","31472","","62944"
"2017-05-15 19:52","BookieSocketAddress.java","2924","24826","27750","","55500"
"2015-04-21 10:19","TestLedgerChecker.java","2128","14050","16178","","32356"
"2014-06-02 11:54","AuditorLedgerCheckerTest.java","3994","17241","21235","7","42470"
"2014-07-24 01:41","AuditorLedgerCheckerTest.java","4324","18056","22380","","44760"
"2016-03-08 07:18","AuditorLedgerCheckerTest.java","6481","36745","43226","","86452"
"2016-12-17 02:44","AuditorLedgerCheckerTest.java","112564","57192","169756","","339512"
"2017-07-07 05:11","AuditorLedgerCheckerTest.java","114830","86745","201575","","403150"
"2014-02-05 22:43","AuditorLedgerCheckerTest.java","3442","11416","14858","7","29716"
"2013-08-21 13:19","AuditorLedgerCheckerTest.java","349","2025","2374","5","4748"
"2017-10-17 09:32","AuditorLedgerCheckerTest.java","125588","112040","237628","","475256"
"2017-05-12 15:20","AuditorLedgerCheckerTest.java","113175","72177","185352","","370704"
"2017-06-01 23:58","BookieShell.java","3370","14621","17991","","35982"
"2017-07-07 05:11","BookieShell.java","4587","24753","29340","","58680"
"2017-03-28 22:35","BookieShell.java","174","4478","4652","","9304"
"2017-06-30 00:12","BookKeeper.java","2341","10808","13149","","26298"
"2017-06-21 21:00","BookKeeper.java","1949","7945","9894","","19788"
"2017-07-28 20:12","BookKeeper.java","4229","19251","23480","","46960"
"2017-06-05 22:25","BookkeeperInternalCallbacks.java","3728","12124","15852","","31704"
"2017-08-02 00:49","BookkeeperInternalCallbacks.java","9396","41784","51180","","102360"
"2017-06-21 21:00","BookkeeperInternalCallbacks.java","3820","13570","17390","","34780"
"2017-06-05 22:13","BookkeeperInternalCallbacks.java","3485","11587","15072","","30144"
"2017-05-15 19:52","BookkeeperInternalCallbacks.java","2005","5759","7764","","15528"
"2014-06-02 11:54","AuditorLedgerCheckerTest.java","3981","21328","25309","7","50618"
"2014-07-24 01:41","AuditorLedgerCheckerTest.java","4302","22134","26436","","52872"
"2016-03-08 07:18","AuditorLedgerCheckerTest.java","6098","40462","46560","","93120"
"2016-12-17 02:44","AuditorLedgerCheckerTest.java","110831","59559","170390","","340780"
"2017-07-07 05:11","AuditorLedgerCheckerTest.java","113091","89106","202197","","404394"
"2014-02-05 22:43","AuditorLedgerCheckerTest.java","3429","15503","18932","7","37864"
"2013-08-21 13:19","AuditorLedgerCheckerTest.java","489","6265","6754","5","13508"
"2017-10-17 09:32","AuditorLedgerCheckerTest.java","123551","114103","237654","","475308"
"2017-05-12 15:20","AuditorLedgerCheckerTest.java","111441","74543","185984","","371968"
"2013-06-15 19:05","AuditorLedgerCheckerTest.java","154","4254","4408","5","8816"
"2017-06-30 00:12","PerChannelBookieClient.java","3822","14922","18744","","37488"
"2017-07-04 06:27","PerChannelBookieClient.java","4114","17175","21289","","42578"
"2017-05-15 19:52","PerChannelBookieClient.java","1585","4218","5803","","11606"
"2017-07-28 20:12","PerChannelBookieClient.java","5676","23331","29007","","58014"
"2017-08-02 00:49","PerChannelBookieClient.java","9104","40371","49475","","98950"
"2017-06-21 19:58","PerChannelBookieClient.java","3423","11379","14802","","29604"
"2017-06-01 23:58","PerChannelBookieClient.java","2913","8739","11652","","23304"
"2017-01-31 04:01","Bookie.java","79989","71272","151261","","302522"
"2017-03-28 22:37","Bookie.java","80079","76169","156248","","312496"
"2016-01-26 22:11","Bookie.java","8302","76709","85011","","170022"
"2015-03-18 07:38","Bookie.java","7601","72756","80357","","160714"
"2015-04-21 09:17","Bookie.java","7603","72860","80463","","160926"
"2013-06-21 19:26","Bookie.java","3713","43662","47375","5","94750"
"2014-09-23 17:53","Bookie.java","7262","69360","76622","","153244"
"2017-07-04 06:27","Bookie.java","81993","92050","174043","","348086"
"2017-06-05 22:25","Bookie.java","81703","85974","167677","","335354"
"2014-02-06 09:25","Bookie.java","6182","53986","60168","7","120336"
"2014-04-29 22:07","Bookie.java","6452","57761","64213","7","128426"
"2013-12-06 07:39","Bookie.java","5206","50755","55961","6","111922"
"2014-08-02 20:02","Bookie.java","7127","67133","74260","","148520"
"2013-10-02 07:01","Bookie.java","4040","45834","49874","5","99748"
"2017-06-28 23:24","Bookie.java","81762","87986","169748","","339496"
"2017-07-07 08:19","Bookie.java","81993","94013","176006","","352012"
"2013-09-11 00:34","Bookie.java","4001","45594","49595","5","99190"
"2014-01-21 17:26","Bookie.java","5464","52750","58214","6","116428"
"2013-10-12 05:42","Bookie.java","4958","47485","52443","6","104886"
"2013-10-22 16:21","Bookie.java","5137","48431","53568","6","107136"
"2017-05-16 00:31","Bookie.java","80826","80873","161699","","323398"
"2013-07-24 16:55","Bookie.java","3816","44823","48639","5","97278"
"2014-02-05 22:43","Bookie.java","6180","53976","60156","7","120312"
"2014-08-18 23:03","Bookie.java","7140","68614","75754","","151508"
"2014-05-09 14:04","Bookie.java","6469","58419","64888","7","129776"
"2013-06-15 19:05","Bookie.java","3696","43518","47214","5","94428"
"2017-06-01 23:58","Bookie.java","81562","84384","165946","","331892"
"2017-08-02 00:49","Bookie.java","85056","113319","198375","","396750"
"2013-12-02 18:45","Bookie.java","5192","50589","55781","6","111562"
"2013-05-04 14:22","Bookie.java","3430","38723","42153","5","84306"
"2016-11-18 00:18","Bookie.java","79935","58117","138052","","276104"
"2017-03-28 22:35","Bookie.java","80061","75936","155997","","311994"
"2016-07-14 23:02","Bookie.java","78637","48929","127566","","255132"
"2017-06-05 20:30","Bookie.java","81614","84794","166408","","332816"
"2016-11-30 00:02","Bookie.java","79953","58665","138618","","277236"
"2017-03-22 22:54","Bookie.java","80063","71634","151697","","303394"
"2016-04-27 09:00","TestReplicationWorker.java","107675","22929","130604","","261208"
"2015-07-10 22:48","TestReplicationWorker.java","2416","14684","17100","","34200"
"2015-09-15 10:38","BookKeeper.java","5967","30537","36504","","73008"
"2015-10-22 09:22","BookKeeper.java","6002","31952","37954","","75908"
"2017-01-31 04:01","BookKeeper.java","112613","62342","174955","","349910"
"2015-07-10 22:48","BookKeeper.java","5546","29814","35360","","70720"
"2017-06-30 00:12","BookKeeper.java","114830","81372","196202","","392404"
"2014-02-06 09:21","BookKeeper.java","3096","9342","12438","7","24876"
"2014-01-21 05:19","BookKeeper.java","1983","7422","9405","6","18810"
"2013-10-02 06:40","BookKeeper.java","73","207","280","5","560"
"2014-02-21 19:01","BookKeeper.java","3271","10676","13947","7","27894"
"2016-10-13 07:50","BookKeeper.java","112432","48605","161037","","322074"
"2017-06-21 21:00","BookKeeper.java","114647","78718","193365","","386730"
"2017-03-28 22:35","BookKeeper.java","112695","67016","179711","","359422"
"2016-07-11 23:01","BookKeeper.java","109817","38521","148338","","296676"
"2016-10-13 09:27","BookKeeper.java","112552","48711","161263","","322526"
"2017-07-28 20:12","BookKeeper.java","115620","88717","204337","","408674"
"2017-05-15 19:52","BookKeeper.java","113545","71620","185165","","370330"
"2017-03-22 22:54","Cookie.java","111544","69341","180885","","361770"
"2016-11-30 00:02","Cookie.java","111433","56371","167804","","335608"
"2014-02-05 22:43","Cookie.java","4847","18869","23716","7","47432"
"2014-05-09 14:04","Cookie.java","5206","23382","28588","7","57176"
"2014-09-23 17:53","Cookie.java","6023","34347","40370","","80740"
"2014-09-18 06:57","Cookie.java","6005","34273","40278","","80556"
"2014-12-06 08:03","Cookie.java","6089","35332","41421","","82842"
"2015-10-06 10:05","TestPerChannelBookieClient.java","10538","81862","92400","","184800"
"2014-07-24 01:41","TestPerChannelBookieClient.java","9382","67812","77194","","154388"
"2014-05-27 13:56","TestPerChannelBookieClient.java","9010","66397","75407","7","150814"
"2014-02-05 22:43","TestPerChannelBookieClient.java","8785","61457","70242","7","140484"
"2017-05-16 00:31","TestPerChannelBookieClient.java","80225","85148","165373","","330746"
"2013-08-20 12:51","TestPerChannelBookieClient.java","6657","52839","59496","5","118992"
"2013-06-15 19:05","TestPerChannelBookieClient.java","6514","51212","57726","5","115452"
"2013-06-28 17:27","TestPerChannelBookieClient.java","6557","51564","58121","5","116242"
"2017-01-31 02:14","TestPerChannelBookieClient.java","79459","70149","149608","","299216"
"2016-04-05 08:45","TestPerChannelBookieClient.java","78018","51397","129415","","258830"
"2017-05-15 19:52","TestPerChannelBookieClient.java","80147","84652","164799","","329598"
"2012-12-08 16:14","TestPerChannelBookieClient.java","1973","2376","4349","2","8698"
"2017-07-07 05:11","BookKeeperConstants.java","115351","61627","176978","","353956"
"2016-10-13 07:50","BookKeeperConstants.java","111626","23892","135518","","271036"
"2017-06-30 00:12","BookKeeperConstants.java","115134","57769","172903","","345806"
"2016-04-27 09:55","BookKeeperConstants.java","106305","10151","116456","","232912"
"2013-08-21 13:19","BookKeeperAdmin.java","613","6488","7101","5","14202"
"2017-10-17 09:32","BookKeeperAdmin.java","123655","114306","237961","","475922"
"2017-06-01 23:58","BookKeeperAdmin.java","112720","79919","192639","","385278"
"2017-04-11 20:19","BookKeeperAdmin.java","111157","71871","183028","","366056"
"2014-02-21 19:01","BookKeeperAdmin.java","3714","17050","20764","7","41528"
"2014-02-05 22:43","BookKeeperAdmin.java","3544","15717","19261","7","38522"
"2017-07-07 05:11","BookKeeperAdmin.java","113197","89311","202508","","405016"
"2016-11-09 03:05","BookKeeperAdmin.java","110917","53341","164258","","328516"
"2016-11-30 00:07","BookKeeperAdmin.java","110935","54023","164958","","329916"
"2016-09-10 21:01","BookKeeperAdmin.java","110799","49538","160337","","320674"
"2016-07-14 23:02","BookKeeperAdmin.java","109581","44250","153831","","307662"
"2016-10-13 09:27","BookKeeperAdmin.java","110914","53004","163918","","327836"
"2016-03-16 05:03","BookKeeperAdmin.java","109246","39423","148669","","297338"
"2016-03-08 07:18","BookKeeperAdmin.java","6207","40670","46877","","93754"
"2014-12-06 08:03","BookKeeperAdmin.java","4929","32323","37252","","74504"
"2014-04-24 10:43","BookKeeperAdmin.java","3869","19177","23046","7","46092"
"2014-09-06 07:51","BookKeeperAdmin.java","4737","30994","35731","","71462"
"2014-01-21 05:19","PerChannelBookieClient.java","1962","7362","9324","6","18648"
"2013-10-22 07:35","PerChannelBookieClient.java","1235","2281","3516","6","7032"
"2014-01-09 07:30","PerChannelBookieClient.java","1575","5543","7118","6","14236"
"2017-06-30 00:12","PerChannelBookieClient.java","114845","81348","196193","","392386"
"2014-05-27 13:56","PerChannelBookieClient.java","3593","14511","18104","7","36208"
"2017-07-04 06:27","PerChannelBookieClient.java","114955","83419","198374","","396748"
"2017-01-31 04:01","PerChannelBookieClient.java","112605","62295","174900","","349800"
"2015-10-06 10:05","PerChannelBookieClient.java","5961","30816","36777","","73554"
"2016-04-05 18:47","PerChannelBookieClient.java","109547","36699","146246","","292492"
"2017-04-15 13:58","PerChannelBookieClient.java","112811","68193","181004","","362008"
"2017-05-15 19:52","PerChannelBookieClient.java","113551","71587","185138","","370276"
"2016-04-05 08:45","PerChannelBookieClient.java","109545","36455","146000","","292000"
"2017-07-28 20:12","PerChannelBookieClient.java","115635","88693","204328","","408656"
"2017-01-31 02:14","PerChannelBookieClient.java","112597","56818","169415","","338830"
"2017-03-28 22:35","PerChannelBookieClient.java","112687","66969","179656","","359312"
"2017-03-23 00:48","PerChannelBookieClient.java","112692","62722","175414","","350828"
"2014-07-25 00:34","PerChannelBookieClient.java","4340","22123","26463","","52926"
"2017-08-02 00:49","PerChannelBookieClient.java","118141","104811","222952","","445904"
"2017-06-21 19:58","PerChannelBookieClient.java","114654","78013","192667","","385334"
"2017-06-01 23:58","PerChannelBookieClient.java","114447","75676","190123","","380246"
"2013-10-29 05:14","PerChannelBookieClient.java","1516","3353","4869","6","9738"
"2014-02-21 19:01","PerChannelBookieClient.java","3253","10619","13872","7","27744"
"2014-02-05 22:43","PerChannelBookieClient.java","3076","9279","12355","7","24710"
"2017-04-20 19:55","PerChannelBookieClient.java","112813","68216","181029","","362058"
"2016-11-12 03:35","PacketProcessorBaseV3.java","112787","30834","143621","","287242"
"2017-05-15 19:52","PacketProcessorBaseV3.java","114187","53810","167997","","335994"
"2015-10-06 10:05","PacketProcessorBaseV3.java","2272","8714","10986","","21972"
"2015-04-21 09:17","PacketProcessorBaseV3.java","1381","6632","8013","","16026"
"2017-06-05 22:25","PacketProcessorBaseV3.java","115521","59786","175307","","350614"
"2016-02-23 19:16","LedgerMetadataImpl.java","12601","125239","137840","","275680"
"2012-09-12 11:59","LedgerMetadataImpl.java","1877","21911","23788","2","47576"
"2013-08-13 14:32","LedgerMetadataImpl.java","9568","94721","104289","5","208578"
"2017-06-01 23:58","LedgerMetadataImpl.java","55242","101995","157237","","314474"
"2013-03-25 18:02","LedgerMetadataImpl.java","9112","87613","96725","4","193450"
"2013-04-26 18:38","LedgerMetadataImpl.java","9145","88009","97154","5","194308"
"2017-07-28 20:12","LedgerMetadataImpl.java","55973","114555","170528","","341056"
"2016-07-11 23:01","LedgerMetadataImpl.java","53432","67621","121053","","242106"
"2016-11-18 00:18","InterleavedLedgerStorage.java","111832","24757","136589","","273178"
"2017-05-16 00:31","InterleavedLedgerStorage.java","113474","48264","161738","","323476"
"2017-07-04 06:27","InterleavedLedgerStorage.java","115326","60126","175452","","350904"
"2017-01-31 04:01","InterleavedLedgerStorage.java","111910","37936","149846","","299692"
"2016-03-08 06:49","InterleavedLedgerStorage.java","1582","5746","7328","","14656"
"2017-03-28 22:37","InterleavedLedgerStorage.java","112142","42975","155117","","310234"
"2017-06-01 23:58","LedgerLayout.java","8899","41429","50328","","100656"
"2017-03-28 22:37","Bookie.java","215","4734","4949","","9898"
"2017-07-04 06:27","Bookie.java","4542","23028","27570","","55140"
"2017-06-05 22:25","Bookie.java","3794","16494","20288","","40576"
"2017-06-28 23:24","Bookie.java","3944","18597","22541","","45082"
"2017-07-07 08:19","Bookie.java","4606","25055","29661","","59322"
"2017-05-16 00:31","Bookie.java","2320","10796","13116","","26232"
"2017-06-01 23:58","Bookie.java","3370","14621","17991","","35982"
"2017-08-02 00:49","Bookie.java","9194","45886","55080","","110160"
"2017-03-28 22:35","Bookie.java","174","4478","4652","","9304"
"2017-06-05 20:30","Bookie.java","3538","15147","18685","","37370"
"2012-12-18 12:00","TestLedgerUnderreplicationManager.java","3359","21195","24554","2","49108"
"2013-05-31 12:02","TestLedgerUnderreplicationManager.java","7049","61005","68054","5","136108"
"2013-10-12 05:42","TestLedgerUnderreplicationManager.java","8136","68897","77033","6","154066"
"2015-07-10 22:48","TestLedgerUnderreplicationManager.java","10513","94569","105082","","210164"
"2012-12-08 11:42","TestLedgerUnderreplicationManager.java","2787","16561","19348","2","38696"
"2017-06-30 00:12","BookieRecoveryTest.java","113338","73638","186976","","373952"
"2014-07-24 01:41","BookieRecoveryTest.java","1183","6941","8124","","16248"
"2017-04-11 20:15","BookieRecoveryTest.java","111077","59616","170693","","341386"
"2017-05-15 19:52","BookieRecoveryTest.java","111874","63707","175581","","351162"
"2017-01-31 04:01","Bookie.java","80117","71178","151295","","302590"
"2017-03-28 22:37","Bookie.java","80207","76075","156282","","312564"
"2016-01-26 22:11","Bookie.java","8246","76431","84677","","169354"
"2015-03-18 07:38","Bookie.java","7544","72477","80021","","160042"
"2015-04-21 09:17","Bookie.java","7546","72581","80127","","160254"
"2013-06-21 19:26","Bookie.java","3639","43366","47005","5","94010"
"2014-09-23 17:53","Bookie.java","7199","69075","76274","","152548"
"2017-07-04 06:27","Bookie.java","82123","91958","174081","","348162"
"2017-06-05 22:25","Bookie.java","81833","85882","167715","","335430"
"2014-02-06 09:25","Bookie.java","6115","53697","59812","7","119624"
"2014-04-29 22:07","Bookie.java","6386","57473","63859","7","127718"
"2013-12-06 07:39","Bookie.java","5134","50461","55595","6","111190"
"2014-08-02 20:02","Bookie.java","7063","66847","73910","","147820"
"2013-10-02 07:01","Bookie.java","3966","45538","49504","5","99008"
"2017-06-28 23:24","Bookie.java","81892","87894","169786","","339572"
"2017-07-07 08:19","Bookie.java","82123","93921","176044","","352088"
"2013-09-11 00:34","Bookie.java","3927","45298","49225","5","98450"
"2014-01-21 17:26","Bookie.java","5392","52456","57848","6","115696"
"2013-10-12 05:42","Bookie.java","4886","47191","52077","6","104154"
"2013-10-22 16:21","Bookie.java","5065","48137","53202","6","106404"
"2017-05-16 00:31","Bookie.java","80956","80781","161737","","323474"
"2013-07-24 16:55","Bookie.java","3742","44527","48269","5","96538"
"2014-02-05 22:43","Bookie.java","6113","53687","59800","7","119600"
"2014-08-18 23:03","Bookie.java","7076","68328","75404","","150808"
"2014-05-09 14:04","Bookie.java","6403","58131","64534","7","129068"
"2013-06-15 19:05","Bookie.java","3622","43222","46844","5","93688"
"2017-06-01 23:58","Bookie.java","81692","84292","165984","","331968"
"2017-08-02 00:49","Bookie.java","85189","113230","198419","","396838"
"2013-12-02 18:45","Bookie.java","5120","50295","55415","6","110830"
"2013-05-04 14:22","Bookie.java","3356","38427","41783","5","83566"
"2016-11-18 00:18","Bookie.java","80063","58023","138086","","276172"
"2017-03-28 22:35","Bookie.java","80189","75842","156031","","312062"
"2016-07-14 23:02","Bookie.java","78765","48835","127600","","255200"
"2017-06-05 20:30","Bookie.java","81744","84702","166446","","332892"
"2016-11-30 00:02","Bookie.java","80081","58571","138652","","277304"
"2017-03-22 22:54","Bookie.java","80191","71540","151731","","303462"
"2015-10-06 10:05","TestPerChannelBookieClient.java","8770","79691","88461","","176922"
"2014-07-24 01:41","TestPerChannelBookieClient.java","7594","65621","73215","","146430"
"2014-05-27 13:56","TestPerChannelBookieClient.java","7219","64203","71422","7","142844"
"2014-02-05 22:43","TestPerChannelBookieClient.java","6986","59255","66241","7","132482"
"2017-05-16 00:31","TestPerChannelBookieClient.java","79772","84292","164064","","328128"
"2013-08-20 12:51","TestPerChannelBookieClient.java","4838","50617","55455","5","110910"
"2013-06-15 19:05","TestPerChannelBookieClient.java","4690","48985","53675","5","107350"
"2013-06-28 17:27","TestPerChannelBookieClient.java","4733","49337","54070","5","108140"
"2017-01-31 02:14","TestPerChannelBookieClient.java","78997","69284","148281","","296562"
"2016-04-05 08:45","TestPerChannelBookieClient.java","77555","50531","128086","","256172"
"2017-05-15 19:52","TestPerChannelBookieClient.java","79692","83794","163486","","326972"
"2014-01-21 05:19","PerChannelBookieClient.java","2124","7811","9935","6","19870"
"2013-10-22 07:35","PerChannelBookieClient.java","1399","2732","4131","6","8262"
"2014-01-09 07:30","PerChannelBookieClient.java","1739","5994","7733","6","15466"
"2017-06-30 00:12","PerChannelBookieClient.java","114909","81699","196608","","393216"
"2014-05-27 13:56","PerChannelBookieClient.java","3737","14942","18679","7","37358"
"2017-07-04 06:27","PerChannelBookieClient.java","115019","83770","198789","","397578"
"2017-01-31 04:01","PerChannelBookieClient.java","112700","62677","175377","","350754"
"2015-10-06 10:05","PerChannelBookieClient.java","6076","31218","37294","","74588"
"2016-04-05 18:47","PerChannelBookieClient.java","109652","37091","146743","","293486"
"2017-04-15 13:58","PerChannelBookieClient.java","112897","68566","181463","","362926"
"2017-05-15 19:52","PerChannelBookieClient.java","113623","71946","185569","","371138"
"2016-04-05 08:45","PerChannelBookieClient.java","109650","36847","146497","","292994"
"2017-07-28 20:12","PerChannelBookieClient.java","115695","89040","204735","","409470"
"2017-01-31 02:14","PerChannelBookieClient.java","112693","57201","169894","","339788"
"2017-03-28 22:35","PerChannelBookieClient.java","112782","67351","180133","","360266"
"2017-03-23 00:48","PerChannelBookieClient.java","112787","63104","175891","","351782"
"2014-07-25 00:34","PerChannelBookieClient.java","4473","22543","27016","","54032"
"2017-08-02 00:49","PerChannelBookieClient.java","118201","105158","223359","","446718"
"2017-06-21 19:58","PerChannelBookieClient.java","114721","78367","193088","","386176"
"2017-06-01 23:58","PerChannelBookieClient.java","114514","76030","190544","","381088"
"2013-10-29 05:14","PerChannelBookieClient.java","1680","3804","5484","6","10968"
"2014-02-21 19:01","PerChannelBookieClient.java","3399","11052","14451","7","28902"
"2014-02-05 22:43","PerChannelBookieClient.java","3224","9714","12938","7","25876"
"2017-04-20 19:55","PerChannelBookieClient.java","112899","68589","181488","","362976"
"2013-09-11 00:34","PerChannelBookieClient.java","170","457","627","5","1254"
"2016-11-12 03:35","PacketProcessorBase.java","112787","30834","143621","","287242"
"2017-05-15 19:52","PacketProcessorBase.java","114187","53810","167997","","335994"
"2015-04-21 09:17","PacketProcessorBase.java","1381","6632","8013","","16026"
"2016-10-13 07:50","ScriptBasedMapping.java","112110","50442","162552","","325104"
"2017-08-16 03:41","ScriptBasedMapping.java","119164","114889","234053","","468106"
"2014-06-06 15:29","CompactionTest.java","20159","137935","158094","7","316188"
"2013-10-30 16:23","CompactionTest.java","19589","128692","148281","6","296562"
"2014-01-17 18:13","CompactionTest.java","19634","129961","149595","6","299190"
"2016-03-08 06:49","CompactionTest.java","20886","154537","175423","","350846"
"2015-01-16 15:57","CompactionTest.java","20640","149857","170497","","340994"
"2014-12-10 19:43","CompactionTest.java","20639","148051","168690","","337380"
"2015-04-21 09:55","CompactionTest.java","20659","150317","170976","","341952"
"2016-05-04 15:55","CompactionTest.java","45693","79253","124946","","249892"
"2017-03-22 22:54","CompactionTest.java","45856","101657","147513","","295026"
"2012-11-26 16:42","CompactionTest.java","16550","73584","90134","2","180268"
"2017-06-21 21:07","CompactionTest.java","46945","117165","164110","","328220"
"2014-01-22 14:35","CompactionTest.java","19789","131681","151470","6","302940"
"2017-11-08 12:27","CompactionTest.java","49703","150227","199930","","399860"
"2017-05-16 00:31","CompactionTest.java","46334","110611","156945","","313890"
"2014-01-15 15:58","CompactionTest.java","19608","129579","149187","6","298374"
"2013-10-22 07:44","CompactionTest.java","19501","126631","146132","6","292264"
"2017-07-07 08:19","CompactionTest.java","47003","123253","170256","","340512"
"2012-03-15 10:37","CompactionTest.java","7119","10755","17874","1","35748"
"2013-05-04 14:22","CompactionTest.java","19039","118562","137601","5","275202"
"2013-08-21 13:19","BookKeeperAdmin.java","9137","81490","90627","5","181254"
"2017-10-17 09:32","BookKeeperAdmin.java","71674","128803","200477","","400954"
"2017-06-01 23:58","BookKeeperAdmin.java","64953","98630","163583","","327166"
"2017-04-11 20:19","BookKeeperAdmin.java","63791","90983","154774","","309548"
"2014-02-21 19:01","BookKeeperAdmin.java","11006","90820","101826","7","203652"
"2014-02-05 22:43","BookKeeperAdmin.java","10911","89562","100473","7","200946"
"2017-07-07 05:11","BookKeeperAdmin.java","65127","107719","172846","","345692"
"2013-02-26 04:12","BookKeeperAdmin.java","8367","73024","81391","4","162782"
"2016-11-09 03:05","BookKeeperAdmin.java","63640","72542","136182","","272364"
"2016-11-30 00:07","BookKeeperAdmin.java","63644","73210","136854","","273708"
"2016-09-10 21:01","BookKeeperAdmin.java","63532","68749","132281","","264562"
"2016-07-14 23:02","BookKeeperAdmin.java","62846","63993","126839","","253678"
"2016-10-13 09:27","BookKeeperAdmin.java","63640","72208","135848","","271696"
"2012-11-30 04:54","BookKeeperAdmin.java","5061","30874","35935","2","71870"
"2013-02-08 19:08","BookKeeperAdmin.java","7514","72143","79657","4","159314"
"2016-03-16 05:03","BookKeeperAdmin.java","62651","59306","121957","","243914"
"2016-03-08 07:18","BookKeeperAdmin.java","12518","113459","125977","","251954"
"2014-12-06 08:03","BookKeeperAdmin.java","11699","105571","117270","","234540"
"2012-09-03 18:54","BookKeeperAdmin.java","437","5404","5841","2","11682"
"2014-04-24 10:43","BookKeeperAdmin.java","11028","92814","103842","7","207684"
"2012-10-05 16:24","BookKeeperAdmin.java","3549","15585","19134","2","38268"
"2012-09-07 07:04","BookKeeperAdmin.java","609","7042","7651","2","15302"
"2014-09-06 07:51","BookKeeperAdmin.java","11592","104327","115919","","231838"
"2013-05-10 12:45","BookKeeperAdmin.java","8883","75361","84244","5","168488"
